instant,dteday,season,yr,mnth,hr,holiday,weekday,workingday,weathersit,temp,atemp,hum,windspeed,casual,registered,check_out,check in
1,1/1/2011,1,0,1,0,0,6,0,1,0.24,0.2879,0.81,0,3,13,16,13
2,1/1/2011,1,0,1,1,0,6,0,1,0.22,0.2727,0.8,0,8,32,40,32
3,1/1/2011,1,0,1,2,0,6,0,1,0.22,0.2727,0.8,0,5,27,32,27
4,1/1/2011,1,0,1,3,0,6,0,1,0.24,0.2879,0.75,0,3,10,13,10
5,1/1/2011,1,0,1,4,0,6,0,1,0.24,0.2879,0.75,0,0,1,1,1
6,1/1/2011,1,0,1,5,0,6,0,2,0.24,0.2576,0.75,0.0896,0,1,1,1
7,1/1/2011,1,0,1,6,0,6,0,1,0.22,0.2727,0.8,0,2,0,2,0
8,1/1/2011,1,0,1,7,0,6,0,1,0.2,0.2576,0.86,0,1,2,3,2
9,1/1/2011,1,0,1,8,0,6,0,1,0.24,0.2879,0.75,0,1,7,8,7
10,1/1/2011,1,0,1,9,0,6,0,1,0.32,0.3485,0.76,0,8,6,14,6
11,1/1/2011,1,0,1,10,0,6,0,1,0.38,0.3939,0.76,0.2537,12,24,36,24
12,1/1/2011,1,0,1,11,0,6,0,1,0.36,0.3333,0.81,0.2836,26,30,56,30
13,1/1/2011,1,0,1,12,0,6,0,1,0.42,0.4242,0.77,0.2836,29,55,84,55
14,1/1/2011,1,0,1,13,0,6,0,2,0.46,0.4545,0.72,0.2985,47,47,94,47
15,1/1/2011,1,0,1,14,0,6,0,2,0.46,0.4545,0.72,0.2836,35,71,106,71
16,1/1/2011,1,0,1,15,0,6,0,2,0.44,0.4394,0.77,0.2985,40,70,110,70
17,1/1/2011,1,0,1,16,0,6,0,2,0.42,0.4242,0.82,0.2985,41,52,93,52
18,1/1/2011,1,0,1,17,0,6,0,2,0.44,0.4394,0.82,0.2836,15,52,67,52
19,1/1/2011,1,0,1,18,0,6,0,3,0.42,0.4242,0.88,0.2537,9,26,35,26
20,1/1/2011,1,0,1,19,0,6,0,3,0.42,0.4242,0.88,0.2537,6,31,37,31
21,1/1/2011,1,0,1,20,0,6,0,2,0.4,0.4091,0.87,0.2537,11,25,36,25
22,1/1/2011,1,0,1,21,0,6,0,2,0.4,0.4091,0.87,0.194,3,31,34,31
23,1/1/2011,1,0,1,22,0,6,0,2,0.4,0.4091,0.94,0.2239,11,17,28,17
24,1/1/2011,1,0,1,23,0,6,0,2,0.46,0.4545,0.88,0.2985,15,24,39,24
25,1/2/2011,1,0,1,0,0,0,0,2,0.46,0.4545,0.88,0.2985,4,13,17,13
26,1/2/2011,1,0,1,1,0,0,0,2,0.44,0.4394,0.94,0.2537,1,16,17,16
27,1/2/2011,1,0,1,2,0,0,0,2,0.42,0.4242,1,0.2836,1,8,9,8
28,1/2/2011,1,0,1,3,0,0,0,2,0.46,0.4545,0.94,0.194,2,4,6,4
29,1/2/2011,1,0,1,4,0,0,0,2,0.46,0.4545,0.94,0.194,2,1,3,1
30,1/2/2011,1,0,1,6,0,0,0,3,0.42,0.4242,0.77,0.2985,0,2,2,2
31,1/2/2011,1,0,1,7,0,0,0,2,0.4,0.4091,0.76,0.194,0,1,1,1
32,1/2/2011,1,0,1,8,0,0,0,3,0.4,0.4091,0.71,0.2239,0,8,8,8
33,1/2/2011,1,0,1,9,0,0,0,2,0.38,0.3939,0.76,0.2239,1,19,20,19
34,1/2/2011,1,0,1,10,0,0,0,2,0.36,0.3485,0.81,0.2239,7,46,53,46
35,1/2/2011,1,0,1,11,0,0,0,2,0.36,0.3333,0.71,0.2537,16,54,70,54
36,1/2/2011,1,0,1,12,0,0,0,2,0.36,0.3333,0.66,0.2985,20,73,93,73
37,1/2/2011,1,0,1,13,0,0,0,2,0.36,0.3485,0.66,0.1343,11,64,75,64
38,1/2/2011,1,0,1,14,0,0,0,3,0.36,0.3485,0.76,0.194,4,55,59,55
39,1/2/2011,1,0,1,15,0,0,0,3,0.34,0.3333,0.81,0.1642,19,55,74,55
40,1/2/2011,1,0,1,16,0,0,0,3,0.34,0.3333,0.71,0.1642,9,67,76,67
41,1/2/2011,1,0,1,17,0,0,0,1,0.34,0.3333,0.57,0.194,7,58,65,58
42,1/2/2011,1,0,1,18,0,0,0,2,0.36,0.3333,0.46,0.3284,10,43,53,43
43,1/2/2011,1,0,1,19,0,0,0,1,0.32,0.2879,0.42,0.4478,1,29,30,29
44,1/2/2011,1,0,1,20,0,0,0,1,0.3,0.2727,0.39,0.3582,5,17,22,17
45,1/2/2011,1,0,1,21,0,0,0,1,0.26,0.2273,0.44,0.3284,11,20,31,20
46,1/2/2011,1,0,1,22,0,0,0,1,0.24,0.2121,0.44,0.2985,0,9,9,9
47,1/2/2011,1,0,1,23,0,0,0,1,0.22,0.2273,0.47,0.1642,0,8,8,8
48,1/3/2011,1,0,1,0,0,1,1,1,0.22,0.197,0.44,0.3582,0,5,5,5
49,1/3/2011,1,0,1,1,0,1,1,1,0.2,0.1667,0.44,0.4179,0,2,2,2
50,1/3/2011,1,0,1,4,0,1,1,1,0.16,0.1364,0.47,0.3881,0,1,1,1
51,1/3/2011,1,0,1,5,0,1,1,1,0.16,0.1364,0.47,0.2836,0,3,3,3
52,1/3/2011,1,0,1,6,0,1,1,1,0.14,0.1061,0.5,0.3881,0,30,30,30
53,1/3/2011,1,0,1,7,0,1,1,1,0.14,0.1364,0.5,0.194,1,63,64,63
54,1/3/2011,1,0,1,8,0,1,1,1,0.14,0.1212,0.5,0.2836,1,153,154,153
55,1/3/2011,1,0,1,9,0,1,1,1,0.16,0.1364,0.43,0.3881,7,81,88,81
56,1/3/2011,1,0,1,10,0,1,1,1,0.18,0.1667,0.43,0.2537,11,33,44,33
57,1/3/2011,1,0,1,11,0,1,1,1,0.2,0.1818,0.4,0.3284,10,41,51,41
58,1/3/2011,1,0,1,12,0,1,1,1,0.22,0.2121,0.35,0.2985,13,48,61,48
59,1/3/2011,1,0,1,13,0,1,1,1,0.24,0.2121,0.35,0.2836,8,53,61,53
60,1/3/2011,1,0,1,14,0,1,1,1,0.26,0.2424,0.3,0.2836,11,66,77,66
61,1/3/2011,1,0,1,15,0,1,1,1,0.26,0.2424,0.3,0.2537,14,58,72,58
62,1/3/2011,1,0,1,16,0,1,1,1,0.26,0.2424,0.3,0.2537,9,67,76,67
63,1/3/2011,1,0,1,17,0,1,1,1,0.24,0.2273,0.3,0.2239,11,146,157,146
64,1/3/2011,1,0,1,18,0,1,1,1,0.24,0.2576,0.32,0.1045,9,148,157,148
65,1/3/2011,1,0,1,19,0,1,1,1,0.2,0.2576,0.47,0,8,102,110,102
66,1/3/2011,1,0,1,20,0,1,1,1,0.2,0.2273,0.47,0.1045,3,49,52,49
67,1/3/2011,1,0,1,21,0,1,1,1,0.18,0.197,0.64,0.1343,3,49,52,49
68,1/3/2011,1,0,1,22,0,1,1,1,0.14,0.1515,0.69,0.1343,0,20,20,20
69,1/3/2011,1,0,1,23,0,1,1,1,0.18,0.2121,0.55,0.1045,1,11,12,11
70,1/4/2011,1,0,1,0,0,2,1,1,0.16,0.1818,0.55,0.1045,0,5,5,5
71,1/4/2011,1,0,1,1,0,2,1,1,0.16,0.1818,0.59,0.1045,0,2,2,2
72,1/4/2011,1,0,1,2,0,2,1,1,0.14,0.1515,0.63,0.1343,0,1,1,1
73,1/4/2011,1,0,1,4,0,2,1,1,0.14,0.1818,0.63,0.0896,0,2,2,2
74,1/4/2011,1,0,1,5,0,2,1,1,0.12,0.1515,0.68,0.1045,0,4,4,4
75,1/4/2011,1,0,1,6,0,2,1,1,0.12,0.1515,0.74,0.1045,0,36,36,36
76,1/4/2011,1,0,1,7,0,2,1,1,0.12,0.1515,0.74,0.1343,2,92,94,92
77,1/4/2011,1,0,1,8,0,2,1,1,0.14,0.1515,0.69,0.1642,2,177,179,177
78,1/4/2011,1,0,1,9,0,2,1,1,0.16,0.1515,0.64,0.2239,2,98,100,98
79,1/4/2011,1,0,1,10,0,2,1,2,0.16,0.1364,0.69,0.3284,5,37,42,37
80,1/4/2011,1,0,1,11,0,2,1,1,0.22,0.2121,0.51,0.2985,7,50,57,50
81,1/4/2011,1,0,1,12,0,2,1,1,0.22,0.2273,0.51,0.1642,12,66,78,66
82,1/4/2011,1,0,1,13,0,2,1,1,0.24,0.2273,0.56,0.194,18,79,97,79
83,1/4/2011,1,0,1,14,0,2,1,1,0.26,0.2576,0.52,0.2239,9,54,63,54
84,1/4/2011,1,0,1,15,0,2,1,1,0.28,0.2727,0.52,0.2537,17,48,65,48
85,1/4/2011,1,0,1,16,0,2,1,1,0.3,0.2879,0.49,0.2537,15,68,83,68
86,1/4/2011,1,0,1,17,0,2,1,1,0.28,0.2727,0.48,0.2239,10,202,212,202
87,1/4/2011,1,0,1,18,0,2,1,1,0.26,0.2576,0.48,0.194,3,179,182,179
88,1/4/2011,1,0,1,19,0,2,1,1,0.24,0.2576,0.48,0.1045,2,110,112,110
89,1/4/2011,1,0,1,20,0,2,1,1,0.24,0.2576,0.48,0.1045,1,53,54,53
90,1/4/2011,1,0,1,21,0,2,1,1,0.22,0.2727,0.64,0,0,48,48,48
91,1/4/2011,1,0,1,22,0,2,1,1,0.22,0.2576,0.64,0.0896,1,34,35,34
92,1/4/2011,1,0,1,23,0,2,1,1,0.2,0.2273,0.69,0.0896,2,9,11,9
93,1/5/2011,1,0,1,0,0,3,1,1,0.2,0.2576,0.64,0,0,6,6,6
94,1/5/2011,1,0,1,1,0,3,1,1,0.16,0.197,0.74,0.0896,0,6,6,6
95,1/5/2011,1,0,1,2,0,3,1,1,0.16,0.197,0.74,0.0896,0,2,2,2
96,1/5/2011,1,0,1,4,0,3,1,1,0.24,0.2273,0.48,0.2239,0,2,2,2
97,1/5/2011,1,0,1,5,0,3,1,1,0.22,0.2273,0.47,0.1642,0,3,3,3
98,1/5/2011,1,0,1,6,0,3,1,1,0.2,0.197,0.47,0.2239,0,33,33,33
99,1/5/2011,1,0,1,7,0,3,1,1,0.18,0.1818,0.43,0.194,1,87,88,87
100,1/5/2011,1,0,1,8,0,3,1,1,0.2,0.1818,0.4,0.2985,3,192,195,192
101,1/5/2011,1,0,1,9,0,3,1,1,0.22,0.197,0.37,0.3284,6,109,115,109
102,1/5/2011,1,0,1,10,0,3,1,1,0.22,0.197,0.37,0.3284,4,53,57,53
103,1/5/2011,1,0,1,11,0,3,1,1,0.26,0.2273,0.33,0.3284,12,34,46,34
104,1/5/2011,1,0,1,12,0,3,1,1,0.26,0.2273,0.33,0.3284,5,74,79,74
105,1/5/2011,1,0,1,13,0,3,1,1,0.28,0.2576,0.3,0.2985,6,65,71,65
106,1/5/2011,1,0,1,14,0,3,1,1,0.3,0.2879,0.28,0.194,10,52,62,52
107,1/5/2011,1,0,1,15,0,3,1,1,0.3,0.2879,0.28,0.194,7,55,62,55
108,1/5/2011,1,0,1,16,0,3,1,1,0.3,0.3182,0.28,0.0896,4,85,89,85
109,1/5/2011,1,0,1,17,0,3,1,1,0.24,0.2273,0.38,0.194,4,186,190,186
110,1/5/2011,1,0,1,18,0,3,1,1,0.24,0.2424,0.38,0.1343,3,166,169,166
111,1/5/2011,1,0,1,19,0,3,1,1,0.24,0.2576,0.38,0.1045,5,127,132,127
112,1/5/2011,1,0,1,20,0,3,1,1,0.22,0.2273,0.47,0.1642,7,82,89,82
113,1/5/2011,1,0,1,21,0,3,1,1,0.2,0.197,0.51,0.194,3,40,43,40
114,1/5/2011,1,0,1,22,0,3,1,1,0.18,0.197,0.55,0.1343,1,41,42,41
115,1/5/2011,1,0,1,23,0,3,1,1,0.2,0.2576,0.47,0,1,18,19,18
116,1/6/2011,1,0,1,0,0,4,1,1,0.18,0.2424,0.55,0,0,11,11,11
117,1/6/2011,1,0,1,1,0,4,1,1,0.16,0.2273,0.64,0,0,4,4,4
118,1/6/2011,1,0,1,2,0,4,1,1,0.16,0.2273,0.64,0,0,2,2,2
119,1/6/2011,1,0,1,4,0,4,1,2,0.16,0.197,0.64,0.0896,0,1,1,1
120,1/6/2011,1,0,1,5,0,4,1,2,0.14,0.1818,0.69,0.0896,0,4,4,4
121,1/6/2011,1,0,1,6,0,4,1,2,0.14,0.1667,0.63,0.1045,0,36,36,36
122,1/6/2011,1,0,1,7,0,4,1,2,0.16,0.2273,0.59,0,0,95,95,95
123,1/6/2011,1,0,1,8,0,4,1,1,0.16,0.2273,0.59,0,3,216,219,216
124,1/6/2011,1,0,1,9,0,4,1,2,0.18,0.2424,0.51,0,6,116,122,116
125,1/6/2011,1,0,1,10,0,4,1,1,0.2,0.2576,0.47,0,3,42,45,42
126,1/6/2011,1,0,1,11,0,4,1,1,0.22,0.2576,0.44,0.0896,2,57,59,57
127,1/6/2011,1,0,1,12,0,4,1,1,0.26,0.2879,0.35,0,6,78,84,78
128,1/6/2011,1,0,1,13,0,4,1,1,0.26,0.2727,0.35,0.1045,12,55,67,55
129,1/6/2011,1,0,1,14,0,4,1,1,0.28,0.2727,0.36,0.1642,11,59,70,59
130,1/6/2011,1,0,1,15,0,4,1,1,0.28,0.2727,0.36,0,8,54,62,54
131,1/6/2011,1,0,1,16,0,4,1,1,0.26,0.2576,0.38,0.1642,12,74,86,74
132,1/6/2011,1,0,1,17,0,4,1,1,0.22,0.2273,0.51,0.1642,9,163,172,163
133,1/6/2011,1,0,1,18,0,4,1,1,0.22,0.2273,0.51,0.1343,5,158,163,158
134,1/6/2011,1,0,1,19,0,4,1,1,0.22,0.2576,0.55,0.0896,3,109,112,109
135,1/6/2011,1,0,1,20,0,4,1,1,0.2,0.2121,0.51,0.1642,3,66,69,66
136,1/6/2011,1,0,1,21,0,4,1,2,0.22,0.2121,0.55,0.2239,0,48,48,48
137,1/6/2011,1,0,1,22,0,4,1,2,0.22,0.2121,0.51,0.2836,1,51,52,51
138,1/6/2011,1,0,1,23,0,4,1,2,0.2,0.197,0.59,0.194,4,19,23,19
139,1/7/2011,1,0,1,0,0,5,1,2,0.2,0.197,0.64,0.194,4,13,17,13
140,1/7/2011,1,0,1,1,0,5,1,2,0.2,0.197,0.69,0.2239,2,5,7,5
141,1/7/2011,1,0,1,2,0,5,1,2,0.2,0.197,0.69,0.2239,0,1,1,1
142,1/7/2011,1,0,1,4,0,5,1,2,0.2,0.2121,0.69,0.1343,0,1,1,1
143,1/7/2011,1,0,1,5,0,5,1,3,0.22,0.2727,0.55,0,0,5,5,5
144,1/7/2011,1,0,1,6,0,5,1,2,0.2,0.2576,0.69,0,8,26,34,26
145,1/7/2011,1,0,1,7,0,5,1,1,0.2,0.2121,0.69,0.1343,8,76,84,76
146,1/7/2011,1,0,1,8,0,5,1,1,0.2,0.197,0.51,0.2537,20,190,210,190
147,1/7/2011,1,0,1,9,0,5,1,1,0.2,0.1818,0.47,0.2985,9,125,134,125
148,1/7/2011,1,0,1,10,0,5,1,1,0.22,0.197,0.37,0.3284,16,47,63,47
149,1/7/2011,1,0,1,11,0,5,1,2,0.2,0.197,0.4,0.2239,19,48,67,48
150,1/7/2011,1,0,1,12,0,5,1,2,0.2,0.197,0.37,0.2537,9,50,59,50
151,1/7/2011,1,0,1,13,0,5,1,2,0.2,0.1818,0.37,0.2836,9,64,73,64
152,1/7/2011,1,0,1,14,0,5,1,2,0.2,0.197,0.4,0.2537,7,43,50,43
153,1/7/2011,1,0,1,15,0,5,1,2,0.2,0.2121,0.37,0.1642,9,63,72,63
154,1/7/2011,1,0,1,16,0,5,1,2,0.2,0.2121,0.37,0.1642,5,82,87,82
155,1/7/2011,1,0,1,17,0,5,1,2,0.2,0.2576,0.37,0,9,178,187,178
156,1/7/2011,1,0,1,18,0,5,1,1,0.2,0.2273,0.4,0.0896,7,116,123,116
157,1/7/2011,1,0,1,19,0,5,1,1,0.16,0.197,0.55,0.0896,3,92,95,92
158,1/7/2011,1,0,1,20,0,5,1,1,0.18,0.2121,0.47,0.1045,1,50,51,50
159,1/7/2011,1,0,1,21,0,5,1,1,0.18,0.197,0.47,0.1343,0,39,39,39
160,1/7/2011,1,0,1,22,0,5,1,2,0.18,0.197,0.43,0.1642,2,34,36,34
161,1/7/2011,1,0,1,23,0,5,1,2,0.18,0.197,0.51,0.1642,1,14,15,14
162,1/8/2011,1,0,1,0,0,6,0,2,0.18,0.197,0.51,0.1642,1,24,25,24
163,1/8/2011,1,0,1,1,0,6,0,2,0.18,0.2121,0.55,0.0896,1,15,16,15
164,1/8/2011,1,0,1,2,0,6,0,2,0.18,0.2424,0.55,0,3,13,16,13
165,1/8/2011,1,0,1,3,0,6,0,3,0.18,0.197,0.55,0.1642,0,7,7,7
166,1/8/2011,1,0,1,4,0,6,0,3,0.18,0.197,0.55,0.1642,0,1,1,1
167,1/8/2011,1,0,1,5,0,6,0,2,0.16,0.1667,0.74,0.1642,0,5,5,5
168,1/8/2011,1,0,1,6,0,6,0,2,0.16,0.1667,0.74,0.1642,0,2,2,2
169,1/8/2011,1,0,1,7,0,6,0,2,0.16,0.1818,0.74,0.1045,1,8,9,8
170,1/8/2011,1,0,1,8,0,6,0,3,0.16,0.1818,0.93,0.1045,0,15,15,15
171,1/8/2011,1,0,1,9,0,6,0,3,0.16,0.1818,0.93,0.1045,0,20,20,20
172,1/8/2011,1,0,1,10,0,6,0,2,0.18,0.197,0.8,0.1642,5,56,61,56
173,1/8/2011,1,0,1,11,0,6,0,2,0.2,0.1818,0.69,0.3881,2,60,62,60
174,1/8/2011,1,0,1,12,0,6,0,2,0.2,0.1818,0.59,0.3582,8,90,98,90
175,1/8/2011,1,0,1,13,0,6,0,1,0.2,0.1818,0.44,0.3284,7,95,102,95
176,1/8/2011,1,0,1,14,0,6,0,1,0.2,0.1667,0.32,0.4925,12,83,95,83
177,1/8/2011,1,0,1,15,0,6,0,1,0.2,0.1667,0.32,0.4478,5,69,74,69
178,1/8/2011,1,0,1,16,0,6,0,1,0.18,0.1364,0.29,0.4478,8,68,76,68
179,1/8/2011,1,0,1,17,0,6,0,1,0.16,0.1212,0.37,0.5522,5,64,69,64
180,1/8/2011,1,0,1,18,0,6,0,1,0.14,0.1212,0.39,0.2985,3,52,55,52
181,1/8/2011,1,0,1,19,0,6,0,1,0.14,0.1212,0.36,0.2537,4,26,30,26
182,1/8/2011,1,0,1,20,0,6,0,1,0.12,0.1212,0.36,0.2537,0,28,28,28
183,1/8/2011,1,0,1,21,0,6,0,1,0.12,0.1061,0.39,0.3582,2,35,37,35
184,1/8/2011,1,0,1,22,0,6,0,1,0.12,0.1061,0.36,0.3881,1,33,34,33
185,1/8/2011,1,0,1,23,0,6,0,1,0.1,0.0606,0.39,0.4478,0,22,22,22
186,1/9/2011,1,0,1,0,0,0,0,1,0.1,0.0758,0.42,0.3881,1,24,25,24
187,1/9/2011,1,0,1,1,0,0,0,1,0.1,0.0606,0.42,0.4627,0,12,12,12
188,1/9/2011,1,0,1,2,0,0,0,1,0.1,0.0606,0.46,0.4627,0,11,11,11
189,1/9/2011,1,0,1,3,0,0,0,1,0.1,0.0758,0.46,0.4179,0,4,4,4
190,1/9/2011,1,0,1,4,0,0,0,1,0.08,0.0909,0.53,0.194,0,1,1,1
191,1/9/2011,1,0,1,5,0,0,0,1,0.08,0.0909,0.53,0.194,0,1,1,1
192,1/9/2011,1,0,1,6,0,0,0,1,0.1,0.0909,0.49,0.2836,0,1,1,1
193,1/9/2011,1,0,1,7,0,0,0,1,0.08,0.0909,0.53,0.194,1,5,6,5
194,1/9/2011,1,0,1,8,0,0,0,1,0.1,0.0909,0.49,0.2836,0,10,10,10
195,1/9/2011,1,0,1,9,0,0,0,1,0.12,0.0758,0.46,0.5224,0,19,19,19
196,1/9/2011,1,0,1,10,0,0,0,1,0.14,0.1061,0.43,0.3881,0,49,49,49
197,1/9/2011,1,0,1,11,0,0,0,1,0.16,0.1212,0.4,0.5224,2,47,49,47
198,1/9/2011,1,0,1,12,0,0,0,1,0.18,0.1364,0.37,0.4478,4,79,83,79
199,1/9/2011,1,0,1,13,0,0,0,1,0.2,0.1667,0.34,0.4478,6,69,75,69
200,1/9/2011,1,0,1,14,0,0,0,1,0.22,0.1818,0.32,0.4627,8,64,72,64
201,1/9/2011,1,0,1,15,0,0,0,1,0.22,0.197,0.35,0.3582,5,77,82,77
202,1/9/2011,1,0,1,16,0,0,0,1,0.2,0.1667,0.34,0.4478,13,79,92,79
203,1/9/2011,1,0,1,17,0,0,0,1,0.18,0.1515,0.37,0.3881,3,59,62,59
204,1/9/2011,1,0,1,18,0,0,0,1,0.16,0.1364,0.4,0.3284,4,44,48,44
205,1/9/2011,1,0,1,19,0,0,0,1,0.16,0.1364,0.43,0.3284,1,40,41,40
206,1/9/2011,1,0,1,20,0,0,0,1,0.14,0.1212,0.46,0.2537,0,38,38,38
207,1/9/2011,1,0,1,21,0,0,0,1,0.14,0.1061,0.46,0.4179,1,19,20,19
208,1/9/2011,1,0,1,22,0,0,0,1,0.14,0.1212,0.46,0.2985,5,10,15,10
209,1/9/2011,1,0,1,23,0,0,0,1,0.12,0.1364,0.5,0.194,0,6,6,6
210,1/10/2011,1,0,1,0,0,1,1,1,0.12,0.1212,0.5,0.2836,2,3,5,3
211,1/10/2011,1,0,1,1,0,1,1,1,0.12,0.1212,0.5,0.2836,1,0,1,0
212,1/10/2011,1,0,1,2,0,1,1,1,0.12,0.1212,0.5,0.2239,0,3,3,3
213,1/10/2011,1,0,1,3,0,1,1,1,0.12,0.1212,0.5,0.2239,0,1,1,1
214,1/10/2011,1,0,1,4,0,1,1,1,0.1,0.1212,0.54,0.1343,1,2,3,2
215,1/10/2011,1,0,1,5,0,1,1,1,0.1,0.1061,0.54,0.2537,0,3,3,3
216,1/10/2011,1,0,1,6,0,1,1,1,0.12,0.1212,0.5,0.2836,0,31,31,31
217,1/10/2011,1,0,1,7,0,1,1,1,0.12,0.1212,0.5,0.2239,2,75,77,75
218,1/10/2011,1,0,1,8,0,1,1,2,0.12,0.1212,0.5,0.2836,4,184,188,184
219,1/10/2011,1,0,1,9,0,1,1,2,0.14,0.1212,0.5,0.2537,2,92,94,92
220,1/10/2011,1,0,1,10,0,1,1,2,0.14,0.1212,0.5,0.2985,0,31,31,31
221,1/10/2011,1,0,1,11,0,1,1,2,0.16,0.1364,0.47,0.2836,2,28,30,28
222,1/10/2011,1,0,1,12,0,1,1,2,0.2,0.1818,0.4,0.2836,5,47,52,47
223,1/10/2011,1,0,1,13,0,1,1,2,0.2,0.1818,0.4,0.2836,4,50,54,50
224,1/10/2011,1,0,1,14,0,1,1,2,0.2,0.197,0.4,0.2239,0,47,47,47
225,1/10/2011,1,0,1,15,0,1,1,2,0.2,0.197,0.4,0.2239,2,43,45,43
226,1/10/2011,1,0,1,16,0,1,1,1,0.2,0.2121,0.4,0.1343,4,70,74,70
227,1/10/2011,1,0,1,17,0,1,1,1,0.2,0.2273,0.4,0.1045,4,174,178,174
228,1/10/2011,1,0,1,18,0,1,1,1,0.2,0.197,0.4,0.2239,1,154,155,154
229,1/10/2011,1,0,1,19,0,1,1,1,0.16,0.1667,0.47,0.1642,3,92,95,92
230,1/10/2011,1,0,1,20,0,1,1,1,0.16,0.1667,0.5,0.1642,1,73,74,73
231,1/10/2011,1,0,1,21,0,1,1,1,0.14,0.1364,0.59,0.194,1,37,38,37
232,1/10/2011,1,0,1,22,0,1,1,1,0.14,0.1515,0.59,0.1642,2,22,24,22
233,1/10/2011,1,0,1,23,0,1,1,1,0.14,0.1515,0.59,0.1642,0,18,18,18
234,1/11/2011,1,0,1,0,0,2,1,1,0.14,0.1667,0.59,0.1045,2,10,12,10
235,1/11/2011,1,0,1,1,0,2,1,1,0.14,0.1515,0.59,0.1642,0,3,3,3
236,1/11/2011,1,0,1,2,0,2,1,2,0.16,0.1515,0.55,0.194,0,3,3,3
237,1/11/2011,1,0,1,5,0,2,1,2,0.16,0.1818,0.55,0.1343,0,6,6,6
238,1/11/2011,1,0,1,6,0,2,1,2,0.16,0.1818,0.55,0.1343,0,27,27,27
239,1/11/2011,1,0,1,7,0,2,1,2,0.16,0.2273,0.55,0,2,97,99,97
240,1/11/2011,1,0,1,8,0,2,1,2,0.18,0.2121,0.51,0.0896,3,214,217,214
241,1/11/2011,1,0,1,9,0,2,1,2,0.18,0.197,0.51,0.1642,3,127,130,127
242,1/11/2011,1,0,1,10,0,2,1,2,0.2,0.2121,0.51,0.1642,3,51,54,51
243,1/11/2011,1,0,1,11,0,2,1,2,0.2,0.2121,0.47,0.1343,4,31,35,31
244,1/11/2011,1,0,1,12,0,2,1,2,0.2,0.2273,0.51,0.1045,2,55,57,55
245,1/11/2011,1,0,1,13,0,2,1,2,0.2,0.2273,0.59,0.0896,6,46,52,46
246,1/11/2011,1,0,1,14,0,2,1,2,0.2,0.2273,0.59,0.0896,3,60,63,60
247,1/11/2011,1,0,1,15,0,2,1,2,0.16,0.197,0.8,0.0896,2,45,47,45
248,1/11/2011,1,0,1,16,0,2,1,2,0.16,0.1515,0.86,0.2239,4,72,76,72
249,1/11/2011,1,0,1,17,0,2,1,2,0.16,0.1515,0.86,0.2239,6,130,136,130
250,1/11/2011,1,0,1,18,0,2,1,3,0.16,0.1818,0.93,0.1045,1,94,95,94
251,1/11/2011,1,0,1,19,0,2,1,3,0.16,0.2273,0.93,0,0,51,51,51
252,1/11/2011,1,0,1,20,0,2,1,3,0.16,0.1515,0.93,0.194,0,32,32,32
253,1/11/2011,1,0,1,21,0,2,1,3,0.16,0.197,0.86,0.0896,0,20,20,20
254,1/11/2011,1,0,1,22,0,2,1,3,0.16,0.1818,0.93,0.1045,1,28,29,28
255,1/11/2011,1,0,1,23,0,2,1,3,0.16,0.197,0.93,0.0896,1,18,19,18
256,1/12/2011,1,0,1,0,0,3,1,2,0.16,0.197,0.86,0.0896,0,7,7,7
257,1/12/2011,1,0,1,1,0,3,1,2,0.16,0.1818,0.86,0.1045,0,6,6,6
258,1/12/2011,1,0,1,2,0,3,1,1,0.14,0.1515,0.86,0.1343,0,1,1,1
259,1/12/2011,1,0,1,5,0,3,1,1,0.14,0.1515,0.86,0.1642,0,5,5,5
260,1/12/2011,1,0,1,6,0,3,1,1,0.12,0.1515,0.93,0.1343,0,16,16,16
261,1/12/2011,1,0,1,7,0,3,1,1,0.14,0.1515,0.69,0.1343,0,54,54,54
262,1/12/2011,1,0,1,8,0,3,1,1,0.16,0.1667,0.59,0.1642,3,125,128,125
263,1/12/2011,1,0,1,9,0,3,1,1,0.16,0.1364,0.59,0.3284,3,78,81,78
264,1/12/2011,1,0,1,10,0,3,1,1,0.18,0.1818,0.55,0.2239,0,39,39,39
265,1/12/2011,1,0,1,11,0,3,1,1,0.2,0.1818,0.51,0.3881,3,32,35,32
266,1/12/2011,1,0,1,12,0,3,1,1,0.2,0.1515,0.47,0.5821,3,52,55,52
267,1/12/2011,1,0,1,13,0,3,1,1,0.22,0.197,0.44,0.3582,0,49,49,49
268,1/12/2011,1,0,1,14,0,3,1,1,0.2,0.1818,0.47,0.3284,0,44,44,44
269,1/12/2011,1,0,1,15,0,3,1,1,0.2,0.1667,0.47,0.4179,1,48,49,48
270,1/12/2011,1,0,1,16,0,3,1,1,0.22,0.197,0.44,0.3284,5,63,68,63
271,1/12/2011,1,0,1,17,0,3,1,1,0.2,0.1818,0.47,0.3582,0,139,139,139
272,1/12/2011,1,0,1,18,0,3,1,1,0.2,0.1515,0.47,0.5224,2,135,137,135
273,1/12/2011,1,0,1,19,0,3,1,1,0.18,0.1515,0.47,0.4179,1,82,83,82
274,1/12/2011,1,0,1,20,0,3,1,1,0.16,0.1364,0.5,0.3284,2,54,56,54
275,1/12/2011,1,0,1,21,0,3,1,1,0.16,0.1364,0.55,0.3284,0,57,57,57
276,1/12/2011,1,0,1,22,0,3,1,1,0.16,0.1212,0.55,0.4478,1,32,33,32
277,1/12/2011,1,0,1,23,0,3,1,1,0.14,0.1061,0.59,0.4179,1,19,20,19
278,1/13/2011,1,0,1,0,0,4,1,1,0.14,0.1212,0.59,0.2836,1,6,7,6
279,1/13/2011,1,0,1,1,0,4,1,1,0.14,0.1212,0.5,0.2836,0,2,2,2
280,1/13/2011,1,0,1,2,0,4,1,1,0.14,0.1212,0.5,0.3582,0,2,2,2
281,1/13/2011,1,0,1,3,0,4,1,1,0.14,0.1212,0.5,0.3284,0,3,3,3
282,1/13/2011,1,0,1,4,0,4,1,1,0.14,0.1212,0.5,0.2537,0,4,4,4
283,1/13/2011,1,0,1,5,0,4,1,1,0.14,0.1212,0.5,0.2985,0,3,3,3
284,1/13/2011,1,0,1,6,0,4,1,1,0.12,0.1515,0.54,0.1343,0,28,28,28
285,1/13/2011,1,0,1,7,0,4,1,1,0.12,0.1515,0.54,0.1343,0,72,72,72
286,1/13/2011,1,0,1,8,0,4,1,1,0.14,0.1364,0.5,0.194,5,197,202,197
287,1/13/2011,1,0,1,9,0,4,1,1,0.14,0.1212,0.5,0.3284,2,137,139,137
288,1/13/2011,1,0,1,10,0,4,1,2,0.16,0.1364,0.5,0.3582,2,36,38,36
289,1/13/2011,1,0,1,11,0,4,1,2,0.2,0.1667,0.44,0.4478,4,33,37,33
290,1/13/2011,1,0,1,12,0,4,1,1,0.2,0.1667,0.44,0.4179,3,49,52,49
291,1/13/2011,1,0,1,13,0,4,1,1,0.22,0.197,0.41,0.4478,2,81,83,81
292,1/13/2011,1,0,1,14,0,4,1,1,0.22,0.197,0.41,0.3881,3,39,42,39
293,1/13/2011,1,0,1,15,0,4,1,1,0.24,0.2121,0.38,0.2985,5,55,60,55
294,1/13/2011,1,0,1,16,0,4,1,1,0.24,0.2121,0.38,0.3582,2,76,78,76
295,1/13/2011,1,0,1,17,0,4,1,1,0.2,0.1818,0.4,0.2836,4,158,162,158
296,1/13/2011,1,0,1,18,0,4,1,1,0.2,0.1818,0.4,0.3284,3,141,144,141
297,1/13/2011,1,0,1,19,0,4,1,1,0.16,0.1515,0.47,0.2537,1,98,99,98
298,1/13/2011,1,0,1,20,0,4,1,1,0.16,0.1515,0.47,0.2239,0,64,64,64
299,1/13/2011,1,0,1,21,0,4,1,1,0.14,0.1212,0.46,0.2985,0,40,40,40
300,1/13/2011,1,0,1,22,0,4,1,1,0.14,0.1212,0.46,0.3284,0,30,30,30
301,1/13/2011,1,0,1,23,0,4,1,1,0.12,0.1364,0.5,0.194,1,14,15,14
302,1/14/2011,1,0,1,0,0,5,1,1,0.12,0.1364,0.5,0.194,0,14,14,14
303,1/14/2011,1,0,1,1,0,5,1,1,0.1,0.1212,0.54,0.1642,0,5,5,5
304,1/14/2011,1,0,1,2,0,5,1,1,0.1,0.1212,0.54,0.1343,0,1,1,1
305,1/14/2011,1,0,1,3,0,5,1,1,0.1,0.1364,0.54,0.1045,0,1,1,1
306,1/14/2011,1,0,1,5,0,5,1,1,0.1,0.1364,0.54,0.0896,0,8,8,8
307,1/14/2011,1,0,1,6,0,5,1,1,0.1,0.1818,0.54,0,0,17,17,17
308,1/14/2011,1,0,1,7,0,5,1,1,0.1,0.1212,0.74,0.1642,0,70,70,70
309,1/14/2011,1,0,1,8,0,5,1,1,0.12,0.1667,0.68,0,2,156,158,156
310,1/14/2011,1,0,1,9,0,5,1,1,0.14,0.1515,0.69,0.1343,0,117,117,117
311,1/14/2011,1,0,1,10,0,5,1,1,0.18,0.1818,0.55,0.194,4,40,44,40
312,1/14/2011,1,0,1,11,0,5,1,1,0.18,0.1667,0.51,0.2836,6,47,53,47
313,1/14/2011,1,0,1,12,0,5,1,1,0.2,0.197,0.44,0.2537,2,59,61,59
314,1/14/2011,1,0,1,13,0,5,1,1,0.22,0.197,0.37,0.3881,4,73,77,73
315,1/14/2011,1,0,1,14,0,5,1,1,0.22,0.2121,0.41,0.2836,5,59,64,59
316,1/14/2011,1,0,1,15,0,5,1,1,0.24,0.2424,0.38,0.1642,9,59,68,59
317,1/14/2011,1,0,1,16,0,5,1,1,0.22,0.2424,0.41,0.1045,3,87,90,87
318,1/14/2011,1,0,1,17,0,5,1,1,0.22,0.2273,0.41,0.1642,4,155,159,155
319,1/14/2011,1,0,1,18,0,5,1,1,0.2,0.2576,0.47,0,5,134,139,134
320,1/14/2011,1,0,1,19,0,5,1,1,0.16,0.197,0.59,0.0896,3,89,92,89
321,1/14/2011,1,0,1,20,0,5,1,1,0.18,0.2424,0.59,0,0,68,68,68
322,1/14/2011,1,0,1,21,0,5,1,1,0.16,0.2273,0.69,0,4,48,52,48
323,1/14/2011,1,0,1,22,0,5,1,2,0.16,0.2273,0.69,0,2,34,36,34
324,1/14/2011,1,0,1,23,0,5,1,2,0.18,0.2424,0.55,0,1,26,27,26
325,1/15/2011,1,0,1,0,0,6,0,1,0.18,0.2424,0.55,0,3,25,28,25
326,1/15/2011,1,0,1,1,0,6,0,2,0.16,0.197,0.59,0.0896,2,18,20,18
327,1/15/2011,1,0,1,2,0,6,0,2,0.16,0.197,0.59,0.0896,0,12,12,12
328,1/15/2011,1,0,1,3,0,6,0,2,0.16,0.2273,0.59,0,1,7,8,7
329,1/15/2011,1,0,1,4,0,6,0,2,0.16,0.2273,0.59,0,0,5,5,5
330,1/15/2011,1,0,1,5,0,6,0,1,0.16,0.2273,0.59,0,0,1,1,1
331,1/15/2011,1,0,1,6,0,6,0,1,0.14,0.1667,0.63,0.1045,1,2,3,2
332,1/15/2011,1,0,1,7,0,6,0,1,0.14,0.2121,0.63,0,1,9,10,9
333,1/15/2011,1,0,1,8,0,6,0,1,0.14,0.1515,0.63,0.1343,1,22,23,22
334,1/15/2011,1,0,1,9,0,6,0,1,0.16,0.1818,0.64,0.1343,2,31,33,31
335,1/15/2011,1,0,1,10,0,6,0,1,0.18,0.197,0.59,0.1642,2,57,59,57
336,1/15/2011,1,0,1,11,0,6,0,1,0.2,0.197,0.55,0.2239,18,54,72,54
337,1/15/2011,1,0,1,12,0,6,0,1,0.24,0.2273,0.48,0.2239,15,74,89,74
338,1/15/2011,1,0,1,13,0,6,0,1,0.28,0.2576,0.38,0.2985,21,80,101,80
339,1/15/2011,1,0,1,14,0,6,0,1,0.3,0.2879,0.39,0.2836,26,92,118,92
340,1/15/2011,1,0,1,15,0,6,0,2,0.32,0.3182,0.36,0.194,21,108,129,108
341,1/15/2011,1,0,1,16,0,6,0,2,0.34,0.3333,0.34,0.194,33,95,128,95
342,1/15/2011,1,0,1,17,0,6,0,2,0.32,0.303,0.36,0.2836,29,54,83,54
343,1/15/2011,1,0,1,18,0,6,0,2,0.3,0.2879,0.45,0.2537,15,69,84,69
344,1/15/2011,1,0,1,19,0,6,0,2,0.32,0.303,0.39,0.2537,14,60,74,60
345,1/15/2011,1,0,1,20,0,6,0,2,0.32,0.303,0.39,0.2537,6,35,41,35
346,1/15/2011,1,0,1,21,0,6,0,2,0.32,0.303,0.39,0.2239,6,51,57,51
347,1/15/2011,1,0,1,22,0,6,0,2,0.3,0.3182,0.42,0.1045,0,26,26,26
348,1/15/2011,1,0,1,23,0,6,0,1,0.3,0.2879,0.45,0.2836,5,39,44,39
349,1/16/2011,1,0,1,0,0,0,0,1,0.26,0.303,0.56,0,6,33,39,33
350,1/16/2011,1,0,1,1,0,0,0,1,0.26,0.2727,0.56,0.1343,4,19,23,19
351,1/16/2011,1,0,1,2,0,0,0,1,0.26,0.2879,0.56,0.0896,3,13,16,13
352,1/16/2011,1,0,1,3,0,0,0,1,0.22,0.2727,0.69,0,9,6,15,6
353,1/16/2011,1,0,1,4,0,0,0,1,0.26,0.2576,0.56,0.1642,0,1,1,1
354,1/16/2011,1,0,1,5,0,0,0,2,0.26,0.2576,0.56,0.1642,1,1,2,1
355,1/16/2011,1,0,1,6,0,0,0,2,0.26,0.2576,0.56,0.1642,0,1,1,1
356,1/16/2011,1,0,1,7,0,0,0,2,0.24,0.2121,0.56,0.2985,0,3,3,3
357,1/16/2011,1,0,1,8,0,0,0,1,0.22,0.2121,0.55,0.2836,0,18,18,18
358,1/16/2011,1,0,1,9,0,0,0,1,0.22,0.2121,0.51,0.2537,3,29,32,29
359,1/16/2011,1,0,1,10,0,0,0,1,0.22,0.2121,0.51,0.2836,8,71,79,71
360,1/16/2011,1,0,1,11,0,0,0,1,0.24,0.2273,0.44,0.2537,23,70,93,70
361,1/16/2011,1,0,1,12,0,0,0,1,0.24,0.2121,0.41,0.2836,29,75,104,75
362,1/16/2011,1,0,1,13,0,0,0,1,0.26,0.2273,0.35,0.2985,23,95,118,95
363,1/16/2011,1,0,1,14,0,0,0,1,0.28,0.2727,0.36,0.2537,22,69,91,69
364,1/16/2011,1,0,1,15,0,0,0,1,0.26,0.2424,0.38,0.2537,35,78,113,78
365,1/16/2011,1,0,1,16,0,0,0,1,0.24,0.2273,0.38,0.2239,22,77,99,77
366,1/16/2011,1,0,1,17,0,0,0,1,0.22,0.2121,0.37,0.2537,23,82,105,82
367,1/16/2011,1,0,1,18,0,0,0,1,0.2,0.2121,0.4,0.1642,11,56,67,56
368,1/16/2011,1,0,1,19,0,0,0,1,0.18,0.197,0.47,0.1343,14,47,61,47
369,1/16/2011,1,0,1,20,0,0,0,1,0.18,0.197,0.47,0.1642,7,50,57,50
370,1/16/2011,1,0,1,21,0,0,0,1,0.18,0.197,0.51,0.1642,6,22,28,22
371,1/16/2011,1,0,1,22,0,0,0,2,0.2,0.2121,0.49,0.1343,2,19,21,19
372,1/16/2011,1,0,1,23,0,0,0,2,0.2,0.2273,0.4,0.1045,0,18,18,18
373,1/17/2011,1,0,1,0,1,1,0,2,0.2,0.197,0.47,0.2239,1,16,17,16
374,1/17/2011,1,0,1,1,1,1,0,2,0.2,0.197,0.44,0.194,1,15,16,15
375,1/17/2011,1,0,1,2,1,1,0,2,0.18,0.1667,0.43,0.2537,0,8,8,8
376,1/17/2011,1,0,1,3,1,1,0,2,0.18,0.1818,0.43,0.194,0,2,2,2
377,1/17/2011,1,0,1,4,1,1,0,2,0.18,0.197,0.43,0.1343,1,2,3,2
378,1/17/2011,1,0,1,5,1,1,0,2,0.18,0.197,0.43,0.1642,0,1,1,1
379,1/17/2011,1,0,1,6,1,1,0,2,0.18,0.1818,0.43,0.194,0,5,5,5
380,1/17/2011,1,0,1,7,1,1,0,2,0.16,0.1818,0.5,0.1343,4,9,13,9
381,1/17/2011,1,0,1,8,1,1,0,2,0.16,0.1515,0.47,0.2239,3,30,33,30
382,1/17/2011,1,0,1,9,1,1,0,2,0.16,0.1515,0.47,0.2239,8,39,47,39
383,1/17/2011,1,0,1,10,1,1,0,2,0.16,0.1515,0.5,0.2537,7,50,57,50
384,1/17/2011,1,0,1,11,1,1,0,2,0.16,0.1515,0.55,0.194,9,55,64,55
385,1/17/2011,1,0,1,12,1,1,0,2,0.18,0.197,0.47,0.1343,10,70,80,70
386,1/17/2011,1,0,1,13,1,1,0,2,0.18,0.197,0.47,0.1343,13,80,93,80
387,1/17/2011,1,0,1,14,1,1,0,2,0.18,0.2121,0.43,0.1045,12,74,86,74
388,1/17/2011,1,0,1,15,1,1,0,2,0.2,0.2121,0.47,0.1642,21,72,93,72
389,1/17/2011,1,0,1,16,1,1,0,2,0.2,0.2121,0.47,0.1642,6,76,82,76
390,1/17/2011,1,0,1,17,1,1,0,1,0.2,0.197,0.51,0.194,4,67,71,67
391,1/17/2011,1,0,1,18,1,1,0,2,0.18,0.1667,0.55,0.2537,7,85,92,85
392,1/17/2011,1,0,1,19,1,1,0,3,0.18,0.1818,0.59,0.194,2,58,60,58
393,1/17/2011,1,0,1,20,1,1,0,3,0.16,0.1515,0.8,0.194,4,29,33,29
394,1/17/2011,1,0,1,21,1,1,0,3,0.16,0.1515,0.8,0.194,3,24,27,24
395,1/17/2011,1,0,1,22,1,1,0,3,0.14,0.1212,0.93,0.2537,0,13,13,13
396,1/17/2011,1,0,1,23,1,1,0,3,0.16,0.1364,0.86,0.2836,1,3,4,3
397,1/18/2011,1,0,1,12,0,2,1,2,0.2,0.1818,0.86,0.3284,0,3,3,3
398,1/18/2011,1,0,1,13,0,2,1,2,0.2,0.197,0.86,0.2239,0,22,22,22
399,1/18/2011,1,0,1,14,0,2,1,2,0.22,0.2273,0.8,0.1642,2,26,28,26
400,1/18/2011,1,0,1,15,0,2,1,2,0.22,0.2273,0.87,0.1642,3,32,35,32
401,1/18/2011,1,0,1,16,0,2,1,2,0.22,0.2273,0.87,0.194,0,61,61,61
402,1/18/2011,1,0,1,17,0,2,1,2,0.22,0.2273,0.82,0.194,1,124,125,124
403,1/18/2011,1,0,1,18,0,2,1,2,0.22,0.2273,0.8,0.1642,1,132,133,132
404,1/18/2011,1,0,1,19,0,2,1,2,0.22,0.2273,0.8,0.1343,1,98,99,98
405,1/18/2011,1,0,1,20,0,2,1,2,0.22,0.2727,0.87,0,0,83,83,83
406,1/18/2011,1,0,1,21,0,2,1,2,0.22,0.2424,0.93,0.1045,0,41,41,41
407,1/18/2011,1,0,1,22,0,2,1,2,0.22,0.2576,0.93,0.0896,0,33,33,33
408,1/18/2011,1,0,1,23,0,2,1,2,0.22,0.2727,0.93,0,1,19,20,19
409,1/19/2011,1,0,1,0,0,3,1,2,0.22,0.2727,0.93,0,0,3,3,3
410,1/19/2011,1,0,1,1,0,3,1,3,0.22,0.2273,0.93,0.1343,1,6,7,6
411,1/19/2011,1,0,1,2,0,3,1,3,0.22,0.2273,0.93,0.1343,0,3,3,3
412,1/19/2011,1,0,1,4,0,3,1,3,0.22,0.2273,0.93,0.1343,1,1,2,1
413,1/19/2011,1,0,1,5,0,3,1,2,0.22,0.2576,0.93,0.0896,0,7,7,7
414,1/19/2011,1,0,1,6,0,3,1,2,0.22,0.2576,0.93,0.0896,0,32,32,32
415,1/19/2011,1,0,1,7,0,3,1,2,0.24,0.2576,0.92,0.1045,1,89,90,89
416,1/19/2011,1,0,1,8,0,3,1,2,0.24,0.2576,0.93,0.1045,1,196,197,196
417,1/19/2011,1,0,1,9,0,3,1,2,0.24,0.2576,0.93,0.1045,2,107,109,107
418,1/19/2011,1,0,1,10,0,3,1,2,0.26,0.2727,0.93,0.1343,1,46,47,46
419,1/19/2011,1,0,1,11,0,3,1,2,0.28,0.303,0.87,0.0896,5,47,52,47
420,1/19/2011,1,0,1,12,0,3,1,2,0.3,0.3182,0.81,0.0896,5,65,70,65
421,1/19/2011,1,0,1,13,0,3,1,1,0.4,0.4091,0.62,0.2836,11,67,78,67
422,1/19/2011,1,0,1,14,0,3,1,1,0.4,0.4091,0.58,0.2537,7,68,75,68
423,1/19/2011,1,0,1,15,0,3,1,1,0.4,0.4091,0.54,0.2836,4,78,82,78
424,1/19/2011,1,0,1,16,0,3,1,1,0.38,0.3939,0.58,0.3881,10,94,104,94
425,1/19/2011,1,0,1,17,0,3,1,1,0.36,0.3333,0.57,0.3284,7,190,197,190
426,1/19/2011,1,0,1,18,0,3,1,1,0.34,0.3182,0.61,0.2836,5,156,161,156
427,1/19/2011,1,0,1,19,0,3,1,1,0.32,0.2879,0.57,0.4179,4,108,112,108
428,1/19/2011,1,0,1,20,0,3,1,1,0.32,0.303,0.49,0.2985,2,74,76,74
429,1/19/2011,1,0,1,21,0,3,1,1,0.32,0.2879,0.49,0.4179,4,55,59,55
430,1/19/2011,1,0,1,22,0,3,1,1,0.3,0.303,0.52,0.1642,6,53,59,53
431,1/19/2011,1,0,1,23,0,3,1,1,0.3,0.2727,0.52,0.4627,1,27,28,27
432,1/20/2011,1,0,1,0,0,4,1,1,0.26,0.2273,0.56,0.3881,5,8,13,8
433,1/20/2011,1,0,1,1,0,4,1,1,0.26,0.2727,0.56,0,2,3,5,3
434,1/20/2011,1,0,1,2,0,4,1,1,0.26,0.2727,0.56,0,0,2,2,2
435,1/20/2011,1,0,1,3,0,4,1,1,0.26,0.2576,0.56,0.1642,0,1,1,1
436,1/20/2011,1,0,1,4,0,4,1,1,0.26,0.2576,0.56,0.1642,0,1,1,1
437,1/20/2011,1,0,1,5,0,4,1,1,0.24,0.2273,0.6,0.2239,0,6,6,6
438,1/20/2011,1,0,1,6,0,4,1,1,0.22,0.2121,0.6,0.2239,0,35,35,35
439,1/20/2011,1,0,1,7,0,4,1,1,0.22,0.2121,0.55,0.2239,1,100,101,100
440,1/20/2011,1,0,1,8,0,4,1,1,0.22,0.2121,0.55,0.2836,2,247,249,247
441,1/20/2011,1,0,1,9,0,4,1,2,0.24,0.2273,0.52,0.2239,3,140,143,140
442,1/20/2011,1,0,1,10,0,4,1,1,0.26,0.2273,0.48,0.2985,1,56,57,56
443,1/20/2011,1,0,1,11,0,4,1,2,0.28,0.2727,0.45,0.1642,5,63,68,63
444,1/20/2011,1,0,1,12,0,4,1,2,0.3,0.3333,0.42,0,7,77,84,77
445,1/20/2011,1,0,1,13,0,4,1,2,0.28,0.2879,0.45,0.1045,12,86,98,86
446,1/20/2011,1,0,1,14,0,4,1,2,0.3,0.303,0.45,0.1343,6,75,81,75
447,1/20/2011,1,0,1,15,0,4,1,2,0.32,0.3182,0.45,0.194,8,62,70,62
448,1/20/2011,1,0,1,16,0,4,1,2,0.3,0.303,0.49,0.1343,8,83,91,83
449,1/20/2011,1,0,1,17,0,4,1,2,0.3,0.3182,0.49,0.1045,8,207,215,207
450,1/20/2011,1,0,1,18,0,4,1,2,0.26,0.2576,0.56,0.194,1,184,185,184
451,1/20/2011,1,0,1,19,0,4,1,1,0.26,0.2273,0.56,0.3284,6,146,152,146
452,1/20/2011,1,0,1,20,0,4,1,2,0.26,0.2424,0.6,0.2836,2,124,126,124
453,1/20/2011,1,0,1,21,0,4,1,2,0.24,0.2273,0.6,0.2537,3,54,57,54
454,1/20/2011,1,0,1,22,0,4,1,2,0.24,0.2121,0.65,0.2836,0,56,56,56
455,1/20/2011,1,0,1,23,0,4,1,2,0.24,0.2121,0.65,0.3284,3,28,31,28
456,1/21/2011,1,0,1,0,0,5,1,2,0.24,0.2273,0.7,0.2537,1,20,21,20
457,1/21/2011,1,0,1,1,0,5,1,2,0.24,0.2273,0.7,0.2537,0,6,6,6
458,1/21/2011,1,0,1,2,0,5,1,3,0.24,0.2424,0.75,0.1642,0,2,2,2
459,1/21/2011,1,0,1,3,0,5,1,3,0.22,0.2121,0.8,0.2985,0,1,1,1
460,1/21/2011,1,0,1,4,0,5,1,2,0.22,0.2576,0.87,0.0896,0,1,1,1
461,1/21/2011,1,0,1,5,0,5,1,1,0.24,0.197,0.6,0.4179,1,4,5,4
462,1/21/2011,1,0,1,6,0,5,1,1,0.22,0.2121,0.55,0.2537,0,27,27,27
463,1/21/2011,1,0,1,7,0,5,1,1,0.2,0.1818,0.51,0.2836,2,66,68,66
464,1/21/2011,1,0,1,8,0,5,1,1,0.2,0.1818,0.47,0.3284,7,210,217,210
465,1/21/2011,1,0,1,9,0,5,1,1,0.2,0.1818,0.51,0.3582,7,159,166,159
466,1/21/2011,1,0,1,10,0,5,1,1,0.2,0.1667,0.47,0.4627,6,57,63,57
467,1/21/2011,1,0,1,11,0,5,1,1,0.22,0.1818,0.41,0.4627,6,53,59,53
468,1/21/2011,1,0,1,12,0,5,1,1,0.22,0.1818,0.27,0.5821,11,67,78,67
469,1/21/2011,1,0,1,13,0,5,1,1,0.2,0.1515,0.21,0.5821,8,65,73,65
470,1/21/2011,1,0,1,14,0,5,1,1,0.2,0.1515,0.25,0.5224,6,56,62,56
471,1/21/2011,1,0,1,15,0,5,1,1,0.16,0.1212,0.26,0.4478,4,61,65,61
472,1/21/2011,1,0,1,16,0,5,1,1,0.16,0.1364,0.26,0.3582,0,97,97,97
473,1/21/2011,1,0,1,17,0,5,1,1,0.14,0.1212,0.28,0.3582,10,151,161,151
474,1/21/2011,1,0,1,18,0,5,1,1,0.12,0.1212,0.3,0.2537,1,119,120,119
475,1/21/2011,1,0,1,19,0,5,1,1,0.12,0.1061,0.3,0.3284,3,93,96,93
476,1/21/2011,1,0,1,20,0,5,1,1,0.1,0.0758,0.33,0.4179,1,52,53,52
477,1/21/2011,1,0,1,21,0,5,1,1,0.08,0.0758,0.38,0.2836,0,41,41,41
478,1/21/2011,1,0,1,22,0,5,1,1,0.06,0.0303,0.41,0.3881,1,33,34,33
479,1/21/2011,1,0,1,23,0,5,1,1,0.06,0.0455,0.38,0.3284,0,27,27,27
480,1/22/2011,1,0,1,0,0,6,0,1,0.04,0.0303,0.45,0.2537,0,13,13,13
481,1/22/2011,1,0,1,1,0,6,0,2,0.04,0,0.41,0.3881,3,9,12,9
482,1/22/2011,1,0,1,2,0,6,0,2,0.04,0.0303,0.41,0.2537,0,11,11,11
483,1/22/2011,1,0,1,3,0,6,0,2,0.04,0.0303,0.41,0.2836,1,6,7,6
484,1/22/2011,1,0,1,4,0,6,0,2,0.02,0.0152,0.48,0.2985,0,3,3,3
485,1/22/2011,1,0,1,6,0,6,0,2,0.02,0.0303,0.44,0.2239,0,2,2,2
486,1/22/2011,1,0,1,7,0,6,0,1,0.02,0.0152,0.44,0.2836,0,8,8,8
487,1/22/2011,1,0,1,8,0,6,0,1,0.02,0,0.44,0.3284,1,26,27,26
488,1/22/2011,1,0,1,9,0,6,0,1,0.04,0.0303,0.41,0.2537,3,37,40,37
489,1/22/2011,1,0,1,10,0,6,0,2,0.04,0.0606,0.41,0.1642,3,50,53,50
490,1/22/2011,1,0,1,11,0,6,0,2,0.06,0.0758,0.38,0.1343,4,59,63,59
491,1/22/2011,1,0,1,12,0,6,0,2,0.06,0.1061,0.38,0.1045,10,60,70,60
492,1/22/2011,1,0,1,13,0,6,0,1,0.08,0.1667,0.35,0,12,72,84,72
493,1/22/2011,1,0,1,14,0,6,0,1,0.1,0.1364,0.33,0.1045,11,64,75,64
494,1/22/2011,1,0,1,15,0,6,0,1,0.12,0.1515,0.28,0,10,93,103,93
495,1/22/2011,1,0,1,16,0,6,0,1,0.12,0.1364,0.28,0.194,11,72,83,72
496,1/22/2011,1,0,1,17,0,6,0,1,0.12,0.197,0.28,0,8,59,67,59
497,1/22/2011,1,0,1,18,0,6,0,1,0.08,0.0909,0.35,0.194,0,54,54,54
498,1/22/2011,1,0,1,19,0,6,0,1,0.08,0.1061,0.35,0.1343,6,53,59,53
499,1/22/2011,1,0,1,20,0,6,0,1,0.06,0.0758,0.45,0.1642,1,44,45,44
500,1/22/2011,1,0,1,21,0,6,0,1,0.06,0.1061,0.41,0.0896,0,39,39,39
501,1/22/2011,1,0,1,22,0,6,0,1,0.06,0.1515,0.49,0,7,23,30,23
502,1/22/2011,1,0,1,23,0,6,0,1,0.04,0.0758,0.57,0.1045,2,31,33,31
503,1/23/2011,1,0,1,0,0,0,0,1,0.04,0.0758,0.57,0.1045,2,20,22,20
504,1/23/2011,1,0,1,1,0,0,0,1,0.04,0.0758,0.57,0.1045,1,12,13,12
505,1/23/2011,1,0,1,2,0,0,0,1,0.02,0.0606,0.62,0.1343,3,15,18,15
506,1/23/2011,1,0,1,3,0,0,0,1,0.02,0.0606,0.62,0.1343,1,4,5,4
507,1/23/2011,1,0,1,5,0,0,0,2,0.04,0.0758,0.57,0.1045,0,3,3,3
508,1/23/2011,1,0,1,6,0,0,0,2,0.04,0.0758,0.57,0.1045,0,1,1,1
509,1/23/2011,1,0,1,7,0,0,0,1,0.08,0.1061,0.58,0.1642,1,1,2,1
510,1/23/2011,1,0,1,8,0,0,0,1,0.06,0.0758,0.62,0.1642,2,17,19,17
511,1/23/2011,1,0,1,9,0,0,0,1,0.1,0.0758,0.54,0.3582,3,25,28,25
512,1/23/2011,1,0,1,10,0,0,0,1,0.14,0.1061,0.46,0.3881,7,51,58,51
513,1/23/2011,1,0,1,11,0,0,0,1,0.14,0.1364,0.43,0.2239,22,77,99,77
514,1/23/2011,1,0,1,12,0,0,0,1,0.16,0.1212,0.37,0.4627,24,92,116,92
515,1/23/2011,1,0,1,13,0,0,0,1,0.14,0.1061,0.33,0.3881,12,75,87,75
516,1/23/2011,1,0,1,14,0,0,0,1,0.16,0.1364,0.28,0.3582,17,93,110,93
517,1/23/2011,1,0,1,15,0,0,0,1,0.16,0.1364,0.28,0.3582,13,64,77,64
518,1/23/2011,1,0,1,16,0,0,0,1,0.16,0.1364,0.26,0.3284,9,56,65,56
519,1/23/2011,1,0,1,17,0,0,0,1,0.14,0.1061,0.26,0.3881,5,50,55,50
520,1/23/2011,1,0,1,18,0,0,0,1,0.12,0.1212,0.3,0.2537,5,44,49,44
521,1/23/2011,1,0,1,19,0,0,0,1,0.12,0.1212,0.3,0.2836,5,45,50,45
522,1/23/2011,1,0,1,20,0,0,0,1,0.1,0.1061,0.36,0.2537,4,31,35,31
523,1/23/2011,1,0,1,21,0,0,0,1,0.1,0.1061,0.36,0.194,5,20,25,20
524,1/23/2011,1,0,1,22,0,0,0,1,0.08,0.0909,0.38,0.194,5,23,28,23
525,1/23/2011,1,0,1,23,0,0,0,1,0.06,0.0606,0.41,0.2239,4,17,21,17
526,1/24/2011,1,0,1,0,0,1,1,1,0.06,0.0606,0.41,0.194,0,7,7,7
527,1/24/2011,1,0,1,1,0,1,1,1,0.04,0.0455,0.45,0.194,0,1,1,1
528,1/24/2011,1,0,1,3,0,1,1,1,0.04,0.0303,0.45,0.2537,0,1,1,1
529,1/24/2011,1,0,1,4,0,1,1,1,0.02,0.0606,0.48,0.1343,0,1,1,1
530,1/24/2011,1,0,1,5,0,1,1,1,0.02,0.0606,0.48,0.1343,0,5,5,5
531,1/24/2011,1,0,1,6,0,1,1,1,0.02,0.0758,0.48,0.0896,0,15,15,15
532,1/24/2011,1,0,1,7,0,1,1,1,0.02,0.1212,0.48,0,5,79,84,79
533,1/24/2011,1,0,1,8,0,1,1,1,0.04,0.1364,0.49,0,6,171,177,171
534,1/24/2011,1,0,1,9,0,1,1,1,0.06,0.1515,0.41,0,4,98,102,98
535,1/24/2011,1,0,1,10,0,1,1,1,0.1,0.1364,0.42,0,6,34,40,34
536,1/24/2011,1,0,1,11,0,1,1,1,0.1,0.1212,0.46,0.1343,3,43,46,43
537,1/24/2011,1,0,1,12,0,1,1,2,0.12,0.1364,0.42,0.194,11,52,63,52
538,1/24/2011,1,0,1,13,0,1,1,2,0.14,0.1364,0.43,0.2239,6,54,60,54
539,1/24/2011,1,0,1,14,0,1,1,2,0.14,0.1364,0.46,0.2239,2,43,45,43
540,1/24/2011,1,0,1,15,0,1,1,1,0.16,0.1667,0.4,0.1642,7,50,57,50
541,1/24/2011,1,0,1,16,0,1,1,1,0.16,0.1515,0.47,0.2537,4,66,70,66
542,1/24/2011,1,0,1,17,0,1,1,1,0.14,0.1212,0.5,0.2537,6,178,184,178
543,1/24/2011,1,0,1,18,0,1,1,1,0.14,0.1364,0.59,0.194,8,145,153,145
544,1/24/2011,1,0,1,19,0,1,1,1,0.14,0.1515,0.54,0.1642,5,101,106,101
545,1/24/2011,1,0,1,20,0,1,1,1,0.14,0.1364,0.59,0.194,1,80,81,80
546,1/24/2011,1,0,1,21,0,1,1,1,0.14,0.1515,0.63,0.1642,6,53,59,53
547,1/24/2011,1,0,1,22,0,1,1,2,0.14,0.1364,0.63,0.2239,3,32,35,32
548,1/24/2011,1,0,1,23,0,1,1,2,0.16,0.1515,0.64,0.2537,3,21,24,21
549,1/25/2011,1,0,1,0,0,2,1,2,0.16,0.1364,0.69,0.2836,3,6,9,6
550,1/25/2011,1,0,1,1,0,2,1,2,0.16,0.1667,0.69,0.1642,0,5,5,5
551,1/25/2011,1,0,1,2,0,2,1,1,0.16,0.1515,0.69,0.2239,0,2,2,2
552,1/25/2011,1,0,1,4,0,2,1,1,0.14,0.1667,0.74,0.1045,0,1,1,1
553,1/25/2011,1,0,1,5,0,2,1,1,0.14,0.1364,0.74,0.2239,0,9,9,9
554,1/25/2011,1,0,1,6,0,2,1,1,0.16,0.1818,0.74,0.1045,1,35,36,35
555,1/25/2011,1,0,1,7,0,2,1,1,0.16,0.1515,0.74,0.2239,5,103,108,103
556,1/25/2011,1,0,1,8,0,2,1,2,0.16,0.1818,0.74,0.1343,5,233,238,233
557,1/25/2011,1,0,1,9,0,2,1,2,0.2,0.2273,0.64,0.0896,10,134,144,134
558,1/25/2011,1,0,1,10,0,2,1,2,0.22,0.2424,0.6,0.1045,6,49,55,49
559,1/25/2011,1,0,1,11,0,2,1,2,0.24,0.2424,0.6,0.1343,6,55,61,55
560,1/25/2011,1,0,1,12,0,2,1,2,0.26,0.2879,0.56,0.0896,21,85,106,85
561,1/25/2011,1,0,1,13,0,2,1,2,0.26,0.2727,0.56,0.1343,21,72,93,72
562,1/25/2011,1,0,1,14,0,2,1,2,0.3,0.3333,0.45,0,11,57,68,57
563,1/25/2011,1,0,1,15,0,2,1,2,0.32,0.3485,0.42,0,21,63,84,63
564,1/25/2011,1,0,1,16,0,2,1,2,0.32,0.3485,0.42,0,14,102,116,102
565,1/25/2011,1,0,1,17,0,2,1,1,0.3,0.3333,0.45,0,14,208,222,208
566,1/25/2011,1,0,1,18,0,2,1,2,0.3,0.3182,0.49,0.0896,7,218,225,218
567,1/25/2011,1,0,1,19,0,2,1,2,0.26,0.2576,0.65,0.1642,13,133,146,133
568,1/25/2011,1,0,1,20,0,2,1,1,0.24,0.2273,0.65,0.194,16,103,119,103
569,1/25/2011,1,0,1,21,0,2,1,1,0.24,0.2273,0.65,0.194,5,40,45,40
570,1/25/2011,1,0,1,22,0,2,1,1,0.22,0.2273,0.64,0.1642,4,49,53,49
571,1/25/2011,1,0,1,23,0,2,1,2,0.22,0.2273,0.64,0.1642,3,37,40,37
572,1/26/2011,1,0,1,0,0,3,1,2,0.22,0.2273,0.69,0.1343,3,14,17,14
573,1/26/2011,1,0,1,1,0,3,1,2,0.24,0.2424,0.65,0.1343,0,5,5,5
574,1/26/2011,1,0,1,2,0,3,1,3,0.22,0.2273,0.69,0.194,3,7,10,7
575,1/26/2011,1,0,1,5,0,3,1,3,0.2,0.1818,0.86,0.2836,0,1,1,1
576,1/26/2011,1,0,1,6,0,3,1,3,0.2,0.1818,0.86,0.2836,0,8,8,8
577,1/26/2011,1,0,1,7,0,3,1,3,0.22,0.2121,0.87,0.2985,1,29,30,29
578,1/26/2011,1,0,1,8,0,3,1,3,0.22,0.2121,0.87,0.2985,3,69,72,69
579,1/26/2011,1,0,1,9,0,3,1,3,0.22,0.2121,0.87,0.2985,3,55,58,55
580,1/26/2011,1,0,1,10,0,3,1,3,0.22,0.2121,0.93,0.2836,2,26,28,26
581,1/26/2011,1,0,1,11,0,3,1,3,0.22,0.197,0.93,0.3284,6,35,41,35
582,1/26/2011,1,0,1,12,0,3,1,3,0.22,0.197,0.93,0.3284,7,41,48,41
583,1/26/2011,1,0,1,13,0,3,1,3,0.22,0.197,0.93,0.3284,4,43,47,43
584,1/26/2011,1,0,1,14,0,3,1,3,0.22,0.197,0.93,0.3582,0,36,36,36
585,1/26/2011,1,0,1,15,0,3,1,3,0.22,0.1818,0.93,0.4627,1,42,43,42
586,1/26/2011,1,0,1,16,0,3,1,4,0.22,0.197,0.93,0.3284,1,35,36,35
587,1/26/2011,1,0,1,17,0,3,1,3,0.2,0.1818,0.93,0.3582,0,26,26,26
588,1/27/2011,1,0,1,16,0,4,1,1,0.22,0.2273,0.55,0.194,1,23,24,23
589,1/27/2011,1,0,1,17,0,4,1,1,0.22,0.2424,0.55,0.1045,2,82,84,82
590,1/27/2011,1,0,1,18,0,4,1,1,0.2,0.2273,0.69,0.0896,3,101,104,101
591,1/27/2011,1,0,1,19,0,4,1,1,0.2,0.2273,0.69,0.0896,3,76,79,76
592,1/27/2011,1,0,1,20,0,4,1,1,0.18,0.2121,0.74,0.0896,4,55,59,55
593,1/27/2011,1,0,1,21,0,4,1,1,0.18,0.2121,0.74,0.0896,2,36,38,36
594,1/27/2011,1,0,1,22,0,4,1,1,0.18,0.2121,0.74,0.0896,0,27,27,27
595,1/27/2011,1,0,1,23,0,4,1,1,0.18,0.197,0.8,0.1642,0,16,16,16
596,1/28/2011,1,0,1,0,0,5,1,2,0.2,0.2121,0.75,0.1343,0,9,9,9
597,1/28/2011,1,0,1,1,0,5,1,2,0.2,0.2121,0.75,0.1343,1,2,3,2
598,1/28/2011,1,0,1,2,0,5,1,2,0.2,0.2121,0.75,0.1642,0,2,2,2
599,1/28/2011,1,0,1,3,0,5,1,2,0.2,0.2273,0.75,0.1045,1,0,1,0
600,1/28/2011,1,0,1,5,0,5,1,2,0.18,0.2121,0.8,0.1045,0,4,4,4
601,1/28/2011,1,0,1,6,0,5,1,2,0.18,0.197,0.8,0.1343,0,16,16,16
602,1/28/2011,1,0,1,7,0,5,1,2,0.16,0.197,0.86,0.0896,2,58,60,58
603,1/28/2011,1,0,1,8,0,5,1,2,0.16,0.197,0.86,0.0896,2,155,157,155
604,1/28/2011,1,0,1,9,0,5,1,3,0.18,0.2121,0.86,0.0896,6,95,101,95
605,1/28/2011,1,0,1,10,0,5,1,3,0.18,0.2121,0.86,0.1045,0,49,49,49
606,1/28/2011,1,0,1,11,0,5,1,3,0.18,0.2121,0.93,0.1045,0,30,30,30
607,1/28/2011,1,0,1,12,0,5,1,3,0.18,0.2121,0.93,0.1045,1,28,29,28
608,1/28/2011,1,0,1,13,0,5,1,3,0.18,0.2121,0.93,0.1045,0,31,31,31
609,1/28/2011,1,0,1,14,0,5,1,3,0.22,0.2727,0.8,0,2,36,38,36
610,1/28/2011,1,0,1,15,0,5,1,2,0.2,0.2576,0.86,0,1,40,41,40
611,1/28/2011,1,0,1,16,0,5,1,1,0.22,0.2727,0.8,0,10,70,80,70
612,1/28/2011,1,0,1,17,0,5,1,1,0.24,0.2424,0.75,0.1343,2,147,149,147
613,1/28/2011,1,0,1,18,0,5,1,1,0.24,0.2273,0.75,0.194,2,107,109,107
614,1/28/2011,1,0,1,19,0,5,1,2,0.24,0.2424,0.75,0.1343,5,84,89,84
615,1/28/2011,1,0,1,20,0,5,1,2,0.24,0.2273,0.7,0.194,1,61,62,61
616,1/28/2011,1,0,1,21,0,5,1,2,0.22,0.2273,0.75,0.1343,1,57,58,57
617,1/28/2011,1,0,1,22,0,5,1,1,0.24,0.2121,0.65,0.3582,0,26,26,26
618,1/28/2011,1,0,1,23,0,5,1,1,0.24,0.2273,0.6,0.2239,1,22,23,22
619,1/29/2011,1,0,1,0,0,6,0,1,0.22,0.197,0.64,0.3582,2,26,28,26
620,1/29/2011,1,0,1,1,0,6,0,1,0.22,0.2273,0.64,0.194,0,20,20,20
621,1/29/2011,1,0,1,2,0,6,0,1,0.22,0.2273,0.64,0.1642,0,15,15,15
622,1/29/2011,1,0,1,3,0,6,0,1,0.2,0.2121,0.64,0.1343,3,5,8,5
623,1/29/2011,1,0,1,4,0,6,0,1,0.16,0.1818,0.69,0.1045,1,2,3,2
624,1/29/2011,1,0,1,6,0,6,0,1,0.16,0.1818,0.64,0.1343,0,2,2,2
625,1/29/2011,1,0,1,7,0,6,0,1,0.16,0.1818,0.59,0.1045,1,4,5,4
626,1/29/2011,1,0,1,8,0,6,0,1,0.18,0.197,0.55,0.1642,3,31,34,31
627,1/29/2011,1,0,1,9,0,6,0,1,0.18,0.2121,0.59,0.0896,0,34,34,34
628,1/29/2011,1,0,1,10,0,6,0,2,0.18,0.2121,0.64,0.1045,4,51,55,51
629,1/29/2011,1,0,1,11,0,6,0,2,0.18,0.197,0.64,0.1343,4,60,64,60
630,1/29/2011,1,0,1,12,0,6,0,2,0.2,0.197,0.59,0.194,12,66,78,66
631,1/29/2011,1,0,1,13,0,6,0,2,0.22,0.2273,0.55,0.1642,9,56,65,56
632,1/29/2011,1,0,1,14,0,6,0,2,0.22,0.2273,0.6,0.1343,10,89,99,89
633,1/29/2011,1,0,1,15,0,6,0,1,0.22,0.2121,0.69,0.2537,22,98,120,98
634,1/29/2011,1,0,1,16,0,6,0,1,0.24,0.2424,0.6,0.1642,19,88,107,88
635,1/29/2011,1,0,1,17,0,6,0,1,0.24,0.2879,0.6,0,9,82,91,82
636,1/29/2011,1,0,1,18,0,6,0,1,0.22,0.2273,0.69,0.1343,9,59,68,59
637,1/29/2011,1,0,1,19,0,6,0,2,0.22,0.2121,0.69,0.2537,6,52,58,52
638,1/29/2011,1,0,1,20,0,6,0,1,0.18,0.2121,0.74,0.0896,1,42,43,42
639,1/29/2011,1,0,1,21,0,6,0,1,0.18,0.2121,0.74,0.0896,1,35,36,35
640,1/29/2011,1,0,1,22,0,6,0,1,0.16,0.197,0.8,0.0896,4,28,32,28
641,1/29/2011,1,0,1,23,0,6,0,1,0.16,0.197,0.8,0.0896,3,30,33,30
642,1/30/2011,1,0,1,0,0,0,0,1,0.16,0.1818,0.8,0.1045,0,33,33,33
643,1/30/2011,1,0,1,1,0,0,0,1,0.14,0.2121,0.8,0,7,22,29,22
644,1/30/2011,1,0,1,2,0,0,0,1,0.16,0.2273,0.8,0,1,10,11,10
645,1/30/2011,1,0,1,3,0,0,0,1,0.14,0.2121,0.93,0,1,7,8,7
646,1/30/2011,1,0,1,4,0,0,0,1,0.14,0.2121,0.93,0,0,1,1,1
647,1/30/2011,1,0,1,5,0,0,0,1,0.14,0.2121,0.86,0,0,3,3,3
648,1/30/2011,1,0,1,7,0,0,0,1,0.14,0.2121,0.86,0,0,3,3,3
649,1/30/2011,1,0,1,8,0,0,0,2,0.14,0.2121,0.86,0,1,11,12,11
650,1/30/2011,1,0,1,9,0,0,0,2,0.16,0.2273,0.8,0,4,34,38,34
651,1/30/2011,1,0,1,10,0,0,0,2,0.18,0.2424,0.8,0,7,57,64,57
652,1/30/2011,1,0,1,11,0,0,0,1,0.22,0.2727,0.75,0,9,50,59,50
653,1/30/2011,1,0,1,12,0,0,0,1,0.3,0.3182,0.52,0.1045,10,87,97,87
654,1/30/2011,1,0,1,13,0,0,0,1,0.28,0.2879,0.61,0.1045,13,71,84,71
655,1/30/2011,1,0,1,14,0,0,0,1,0.28,0.303,0.61,0.0896,18,104,122,104
656,1/30/2011,1,0,1,15,0,0,0,1,0.3,0.3333,0.56,0,14,95,109,95
657,1/30/2011,1,0,1,16,0,0,0,1,0.3,0.3333,0.56,0,19,104,123,104
658,1/30/2011,1,0,1,17,0,0,0,1,0.3,0.2879,0.56,0.194,6,71,77,71
659,1/30/2011,1,0,1,18,0,0,0,1,0.26,0.2576,0.65,0.1642,8,57,65,57
660,1/30/2011,1,0,1,19,0,0,0,1,0.26,0.2576,0.65,0.194,9,46,55,46
661,1/30/2011,1,0,1,20,0,0,0,2,0.26,0.2727,0.65,0.1045,3,30,33,30
662,1/30/2011,1,0,1,21,0,0,0,2,0.24,0.2424,0.7,0.1642,3,25,28,25
663,1/30/2011,1,0,1,22,0,0,0,2,0.24,0.2273,0.7,0.194,2,19,21,19
664,1/30/2011,1,0,1,23,0,0,0,2,0.24,0.2121,0.65,0.2836,5,16,21,16
665,1/31/2011,1,0,1,0,0,1,1,2,0.24,0.2273,0.65,0.2239,1,6,7,6
666,1/31/2011,1,0,1,1,0,1,1,1,0.22,0.2121,0.64,0.2537,2,5,7,5
667,1/31/2011,1,0,1,2,0,1,1,1,0.22,0.2273,0.64,0.194,0,1,1,1
668,1/31/2011,1,0,1,3,0,1,1,1,0.22,0.2273,0.64,0.194,0,2,2,2
669,1/31/2011,1,0,1,4,0,1,1,1,0.2,0.197,0.59,0.2239,0,2,2,2
670,1/31/2011,1,0,1,5,0,1,1,1,0.18,0.1667,0.64,0.2836,0,8,8,8
671,1/31/2011,1,0,1,6,0,1,1,1,0.16,0.1364,0.69,0.3284,0,37,37,37
672,1/31/2011,1,0,1,7,0,1,1,2,0.16,0.1364,0.64,0.2836,1,71,72,71
673,1/31/2011,1,0,1,8,0,1,1,2,0.16,0.1364,0.59,0.2836,3,182,185,182
674,1/31/2011,1,0,1,9,0,1,1,2,0.16,0.1364,0.59,0.2985,0,112,112,112
675,1/31/2011,1,0,1,10,0,1,1,2,0.16,0.1515,0.59,0.194,1,68,69,68
676,1/31/2011,1,0,1,11,0,1,1,2,0.16,0.1515,0.59,0.194,2,46,48,46
677,1/31/2011,1,0,1,12,0,1,1,2,0.18,0.2121,0.55,0.1045,6,62,68,62
678,1/31/2011,1,0,1,13,0,1,1,2,0.16,0.2273,0.59,0,2,52,54,52
679,1/31/2011,1,0,1,14,0,1,1,2,0.18,0.197,0.55,0.1343,1,85,86,85
680,1/31/2011,1,0,1,15,0,1,1,2,0.16,0.1818,0.59,0.1343,3,41,44,41
681,1/31/2011,1,0,1,16,0,1,1,2,0.16,0.1818,0.56,0.194,3,83,86,83
682,1/31/2011,1,0,1,17,0,1,1,2,0.16,0.1515,0.59,0.194,6,155,161,155
683,1/31/2011,1,0,1,18,0,1,1,2,0.16,0.1515,0.55,0.2239,3,153,156,153
684,1/31/2011,1,0,1,19,0,1,1,1,0.3,0.3182,0.61,0.1045,3,108,111,108
685,1/31/2011,1,0,1,20,0,1,1,3,0.16,0.1667,0.59,0.1642,0,78,78,78
686,1/31/2011,1,0,1,21,0,1,1,3,0.16,0.197,0.59,0.0896,3,53,56,53
687,1/31/2011,1,0,1,22,0,1,1,2,0.16,0.1818,0.59,0.1045,0,34,34,34
688,1/31/2011,1,0,1,23,0,1,1,2,0.16,0.197,0.64,0.0896,2,15,17,15
689,2/1/2011,1,0,2,0,0,2,1,2,0.16,0.1818,0.64,0.1045,2,6,8,6
690,2/1/2011,1,0,2,1,0,2,1,2,0.16,0.1818,0.69,0.1045,0,3,3,3
691,2/1/2011,1,0,2,2,0,2,1,2,0.16,0.2273,0.69,0,0,2,2,2
692,2/1/2011,1,0,2,3,0,2,1,2,0.16,0.2273,0.69,0,0,2,2,2
693,2/1/2011,1,0,2,5,0,2,1,3,0.14,0.2121,0.93,0,0,3,3,3
694,2/1/2011,1,0,2,6,0,2,1,3,0.14,0.2121,0.93,0,0,22,22,22
695,2/1/2011,1,0,2,7,0,2,1,3,0.16,0.2273,0.93,0,0,52,52,52
696,2/1/2011,1,0,2,8,0,2,1,3,0.16,0.2273,0.93,0,3,132,135,132
697,2/1/2011,1,0,2,9,0,2,1,2,0.16,0.2273,0.93,0,2,114,116,114
698,2/1/2011,1,0,2,10,0,2,1,2,0.16,0.2273,0.93,0,0,47,47,47
699,2/1/2011,1,0,2,11,0,2,1,2,0.18,0.2424,0.86,0,2,49,51,49
700,2/1/2011,1,0,2,12,0,2,1,2,0.2,0.2576,0.86,0,2,53,55,53
701,2/1/2011,1,0,2,13,0,2,1,2,0.2,0.2576,0.86,0,3,49,52,49
702,2/1/2011,1,0,2,14,0,2,1,2,0.22,0.2576,0.8,0.0896,5,49,54,49
703,2/1/2011,1,0,2,15,0,2,1,2,0.24,0.2879,0.75,0,7,45,52,45
704,2/1/2011,1,0,2,16,0,2,1,2,0.24,0.2424,0.75,0.1343,3,61,64,61
705,2/1/2011,1,0,2,17,0,2,1,2,0.24,0.2879,0.75,0,4,172,176,172
706,2/1/2011,1,0,2,18,0,2,1,2,0.24,0.2576,0.81,0.1045,3,165,168,165
707,2/1/2011,1,0,2,19,0,2,1,2,0.24,0.2424,0.81,0.1343,3,105,108,105
708,2/1/2011,1,0,2,20,0,2,1,2,0.22,0.2273,0.87,0.1343,5,69,74,69
709,2/1/2011,1,0,2,21,0,2,1,2,0.22,0.2273,0.87,0.1343,0,64,64,64
710,2/1/2011,1,0,2,22,0,2,1,2,0.22,0.2576,0.87,0.0896,2,34,36,34
711,2/1/2011,1,0,2,23,0,2,1,3,0.2,0.197,0.93,0.194,1,15,16,15
712,2/2/2011,1,0,2,0,0,3,1,3,0.22,0.2424,0.93,0.1045,0,2,2,2
713,2/2/2011,1,0,2,1,0,3,1,3,0.22,0.2273,0.93,0.194,0,3,3,3
714,2/2/2011,1,0,2,2,0,3,1,3,0.22,0.2273,0.93,0.1343,4,0,4,0
715,2/2/2011,1,0,2,3,0,3,1,3,0.22,0.2273,0.93,0.1343,0,1,1,1
716,2/2/2011,1,0,2,4,0,3,1,3,0.22,0.2121,0.93,0.2836,0,1,1,1
717,2/2/2011,1,0,2,5,0,3,1,3,0.22,0.2424,0.93,0.1045,0,3,3,3
718,2/2/2011,1,0,2,6,0,3,1,3,0.22,0.2424,0.93,0.1045,1,17,18,17
719,2/2/2011,1,0,2,7,0,3,1,3,0.22,0.2121,0.93,0.2239,1,48,49,48
720,2/2/2011,1,0,2,8,0,3,1,3,0.22,0.2121,0.93,0.2239,1,154,155,154
721,2/2/2011,1,0,2,9,0,3,1,2,0.24,0.2576,0.93,0.0896,4,119,123,119
722,2/2/2011,1,0,2,10,0,3,1,2,0.22,0.2727,1,0,2,59,61,59
723,2/2/2011,1,0,2,11,0,3,1,2,0.24,0.2273,0.93,0.194,5,47,52,47
724,2/2/2011,1,0,2,12,0,3,1,2,0.24,0.2273,0.93,0.2239,3,61,64,61
725,2/2/2011,1,0,2,13,0,3,1,1,0.34,0.3333,0.93,0.1642,1,74,75,74
726,2/2/2011,1,0,2,14,0,3,1,1,0.38,0.3939,0.82,0.3881,2,61,63,61
727,2/2/2011,1,0,2,15,0,3,1,1,0.38,0.3939,0.76,0.3284,10,66,76,66
728,2/2/2011,1,0,2,16,0,3,1,1,0.36,0.3333,0.71,0.2985,8,95,103,95
729,2/2/2011,1,0,2,17,0,3,1,1,0.36,0.3182,0.53,0.5224,7,183,190,183
730,2/2/2011,1,0,2,18,0,3,1,1,0.34,0.2879,0.42,0.5522,7,175,182,175
731,2/2/2011,1,0,2,19,0,3,1,1,0.28,0.2424,0.45,0.4925,3,88,91,88
732,2/2/2011,1,0,2,20,0,3,1,1,0.24,0.197,0.48,0.5522,4,71,75,71
733,2/2/2011,1,0,2,21,0,3,1,1,0.22,0.197,0.47,0.3284,1,62,63,62
734,2/2/2011,1,0,2,22,0,3,1,1,0.22,0.2121,0.44,0.2537,5,35,40,35
735,2/2/2011,1,0,2,23,0,3,1,1,0.2,0.1667,0.44,0.4478,3,29,32,29
736,2/3/2011,1,0,2,0,0,4,1,1,0.2,0.1667,0.4,0.4478,1,11,12,11
737,2/3/2011,1,0,2,1,0,4,1,1,0.2,0.1515,0.44,0.5224,0,5,5,5
738,2/3/2011,1,0,2,2,0,4,1,1,0.18,0.1667,0.43,0.2537,0,2,2,2
739,2/3/2011,1,0,2,3,0,4,1,1,0.18,0.1667,0.43,0.2537,0,1,1,1
740,2/3/2011,1,0,2,5,0,4,1,1,0.16,0.1364,0.5,0.2985,0,2,2,2
741,2/3/2011,1,0,2,6,0,4,1,1,0.16,0.1364,0.43,0.3582,0,39,39,39
742,2/3/2011,1,0,2,7,0,4,1,1,0.14,0.1212,0.5,0.3284,1,86,87,86
743,2/3/2011,1,0,2,8,0,4,1,1,0.14,0.1212,0.5,0.3582,4,184,188,184
744,2/3/2011,1,0,2,9,0,4,1,1,0.16,0.1364,0.47,0.2985,6,127,133,127
745,2/3/2011,1,0,2,10,0,4,1,1,0.18,0.1515,0.43,0.3284,2,50,52,50
746,2/3/2011,1,0,2,11,0,4,1,1,0.18,0.1364,0.43,0.4478,9,55,64,55
747,2/3/2011,1,0,2,12,0,4,1,1,0.2,0.1818,0.4,0.3582,2,67,69,67
748,2/3/2011,1,0,2,13,0,4,1,1,0.2,0.1667,0.4,0.4179,4,47,51,47
749,2/3/2011,1,0,2,14,0,4,1,1,0.22,0.197,0.37,0.3881,4,43,47,43
750,2/3/2011,1,0,2,15,0,4,1,1,0.22,0.197,0.37,0.3284,4,56,60,56
751,2/3/2011,1,0,2,16,0,4,1,1,0.22,0.2121,0.37,0.2537,5,73,78,73
752,2/3/2011,1,0,2,17,0,4,1,1,0.2,0.197,0.4,0.194,5,170,175,170
753,2/3/2011,1,0,2,18,0,4,1,1,0.2,0.2121,0.4,0.1642,2,145,147,145
754,2/3/2011,1,0,2,19,0,4,1,1,0.2,0.2576,0.4,0,4,92,96,92
755,2/3/2011,1,0,2,20,0,4,1,1,0.2,0.2273,0.47,0.0896,1,108,109,108
756,2/3/2011,1,0,2,21,0,4,1,1,0.18,0.2121,0.55,0.1045,1,53,54,53
757,2/3/2011,1,0,2,22,0,4,1,1,0.18,0.2121,0.51,0.0896,2,39,41,39
758,2/3/2011,1,0,2,23,0,4,1,1,0.2,0.2273,0.47,0.1045,4,34,38,34
759,2/4/2011,1,0,2,0,0,5,1,2,0.2,0.2576,0.44,0,3,10,13,10
760,2/4/2011,1,0,2,1,0,5,1,2,0.16,0.2273,0.59,0,0,7,7,7
761,2/4/2011,1,0,2,2,0,5,1,2,0.14,0.1667,0.63,0.1045,0,1,1,1
762,2/4/2011,1,0,2,3,0,5,1,2,0.14,0.1667,0.63,0.1045,0,1,1,1
763,2/4/2011,1,0,2,5,0,5,1,2,0.14,0.1515,0.63,0.1343,0,7,7,7
764,2/4/2011,1,0,2,6,0,5,1,2,0.16,0.2273,0.55,0,2,26,28,26
765,2/4/2011,1,0,2,7,0,5,1,1,0.14,0.2121,0.59,0,0,87,87,87
766,2/4/2011,1,0,2,8,0,5,1,1,0.14,0.1515,0.74,0.1343,3,217,220,217
767,2/4/2011,1,0,2,9,0,5,1,2,0.16,0.1818,0.8,0.1343,3,124,127,124
768,2/4/2011,1,0,2,10,0,5,1,2,0.2,0.2121,0.51,0.1343,5,46,51,46
769,2/4/2011,1,0,2,11,0,5,1,1,0.22,0.2273,0.51,0.1642,3,61,64,61
770,2/4/2011,1,0,2,12,0,5,1,2,0.24,0.2424,0.48,0.1642,8,78,86,78
771,2/4/2011,1,0,2,13,0,5,1,2,0.26,0.2576,0.5,0.2239,9,73,82,73
772,2/4/2011,1,0,2,14,0,5,1,2,0.28,0.2727,0.45,0.1642,15,76,91,76
773,2/4/2011,1,0,2,15,0,5,1,2,0.28,0.2727,0.48,0.2537,9,81,90,81
774,2/4/2011,1,0,2,16,0,5,1,2,0.3,0.2879,0.42,0.2239,8,91,99,91
775,2/4/2011,1,0,2,17,0,5,1,2,0.26,0.2727,0.56,0.1343,10,195,205,195
776,2/4/2011,1,0,2,18,0,5,1,2,0.24,0.2576,0.6,0.1045,3,152,155,152
777,2/4/2011,1,0,2,19,0,5,1,2,0.24,0.2424,0.65,0.1343,1,102,103,102
778,2/4/2011,1,0,2,20,0,5,1,2,0.24,0.2424,0.65,0.1642,2,69,71,69
779,2/4/2011,1,0,2,21,0,5,1,2,0.24,0.2424,0.7,0.1642,2,41,43,41
780,2/4/2011,1,0,2,22,0,5,1,2,0.24,0.2424,0.65,0.1642,1,45,46,45
781,2/4/2011,1,0,2,23,0,5,1,2,0.24,0.2424,0.7,0.1343,1,30,31,30
782,2/5/2011,1,0,2,0,0,6,0,2,0.24,0.2424,0.7,0.1642,3,36,39,36
783,2/5/2011,1,0,2,1,0,6,0,2,0.24,0.2424,0.65,0.1642,1,17,18,17
784,2/5/2011,1,0,2,2,0,6,0,2,0.24,0.2424,0.75,0.1642,5,12,17,12
785,2/5/2011,1,0,2,3,0,6,0,2,0.24,0.2424,0.75,0.1642,1,10,11,10
786,2/5/2011,1,0,2,4,0,6,0,3,0.22,0.2273,0.93,0.1343,0,8,8,8
787,2/5/2011,1,0,2,5,0,6,0,3,0.2,0.2273,1,0.0896,0,9,9,9
788,2/5/2011,1,0,2,6,0,6,0,3,0.2,0.2576,1,0,0,4,4,4
789,2/5/2011,1,0,2,7,0,6,0,3,0.22,0.2576,0.93,0.0896,0,4,4,4
790,2/5/2011,1,0,2,8,0,6,0,3,0.2,0.2273,1,0.0896,0,10,10,10
791,2/5/2011,1,0,2,9,0,6,0,3,0.2,0.2273,1,0.0896,3,17,20,17
792,2/5/2011,1,0,2,10,0,6,0,3,0.2,0.2121,1,0.1343,3,31,34,31
793,2/5/2011,1,0,2,11,0,6,0,3,0.22,0.2273,1,0.1343,1,46,47,46
794,2/5/2011,1,0,2,12,0,6,0,3,0.22,0.2273,1,0.1642,10,42,52,42
795,2/5/2011,1,0,2,13,0,6,0,3,0.22,0.2273,1,0.1642,10,62,72,62
796,2/5/2011,1,0,2,14,0,6,0,3,0.22,0.2727,1,0,5,50,55,50
797,2/5/2011,1,0,2,15,0,6,0,3,0.22,0.2727,1,0,11,49,60,49
798,2/5/2011,1,0,2,16,0,6,0,3,0.22,0.2273,1,0.1343,8,63,71,63
799,2/5/2011,1,0,2,17,0,6,0,2,0.24,0.2121,1,0.2836,14,64,78,64
800,2/5/2011,1,0,2,18,0,6,0,2,0.28,0.2424,0.93,0.4478,2,81,83,81
801,2/5/2011,1,0,2,19,0,6,0,2,0.28,0.2424,0.93,0.4478,6,78,84,78
802,2/5/2011,1,0,2,20,0,6,0,1,0.3,0.2879,0.87,0.2537,5,64,69,64
803,2/5/2011,1,0,2,21,0,6,0,1,0.26,0.2576,1,0.194,3,53,56,53
804,2/5/2011,1,0,2,22,0,6,0,1,0.26,0.2727,0.93,0.1343,2,43,45,43
805,2/5/2011,1,0,2,23,0,6,0,1,0.26,0.2576,0.93,0.2239,7,52,59,52
806,2/6/2011,1,0,2,0,0,0,0,1,0.26,0.2576,0.7,0.194,2,37,39,37
807,2/6/2011,1,0,2,1,0,0,0,1,0.26,0.2273,0.65,0.4179,4,40,44,40
808,2/6/2011,1,0,2,2,0,0,0,1,0.26,0.2273,0.6,0.3284,0,20,20,20
809,2/6/2011,1,0,2,3,0,0,0,1,0.26,0.2879,0.6,0.0896,3,10,13,10
810,2/6/2011,1,0,2,4,0,0,0,1,0.26,0.2273,0.6,0.3582,0,2,2,2
811,2/6/2011,1,0,2,5,0,0,0,1,0.26,0.2576,0.6,0.2239,0,1,1,1
812,2/6/2011,1,0,2,6,0,0,0,1,0.26,0.2576,0.6,0.2239,0,1,1,1
813,2/6/2011,1,0,2,7,0,0,0,1,0.24,0.2424,0.65,0.1642,0,8,8,8
814,2/6/2011,1,0,2,8,0,0,0,1,0.24,0.2576,0.65,0.1045,2,21,23,21
815,2/6/2011,1,0,2,9,0,0,0,1,0.28,0.2879,0.56,0.1045,7,38,45,38
816,2/6/2011,1,0,2,10,0,0,0,1,0.3,0.2879,0.52,0.2537,15,74,89,74
817,2/6/2011,1,0,2,11,0,0,0,1,0.32,0.303,0.49,0.2537,28,89,117,89
818,2/6/2011,1,0,2,12,0,0,0,1,0.34,0.3333,0.46,0,48,126,174,126
819,2/6/2011,1,0,2,13,0,0,0,1,0.34,0.3636,0.46,0,47,135,182,135
820,2/6/2011,1,0,2,14,0,0,0,1,0.34,0.3485,0.46,0.0896,47,114,161,114
821,2/6/2011,1,0,2,15,0,0,0,1,0.34,0.3485,0.46,0.0896,52,130,182,130
822,2/6/2011,1,0,2,16,0,0,0,1,0.34,0.3485,0.49,0.1045,42,115,157,115
823,2/6/2011,1,0,2,17,0,0,0,1,0.34,0.3636,0.46,0,24,97,121,97
824,2/6/2011,1,0,2,18,0,0,0,1,0.3,0.303,0.56,0.1642,13,65,78,65
825,2/6/2011,1,0,2,19,0,0,0,1,0.28,0.2879,0.61,0.1343,1,20,21,20
826,2/6/2011,1,0,2,20,0,0,0,1,0.28,0.2879,0.61,0.1045,5,21,26,21
827,2/6/2011,1,0,2,21,0,0,0,1,0.26,0.303,0.6,0,5,22,27,22
828,2/6/2011,1,0,2,22,0,0,0,1,0.26,0.303,0.6,0,5,57,62,57
829,2/6/2011,1,0,2,23,0,0,0,1,0.24,0.2879,0.65,0,4,26,30,26
830,2/7/2011,1,0,2,0,0,1,1,1,0.24,0.2879,0.65,0,1,14,15,14
831,2/7/2011,1,0,2,1,0,1,1,1,0.22,0.2727,0.75,0,1,4,5,4
832,2/7/2011,1,0,2,2,0,1,1,1,0.2,0.2576,0.8,0,0,3,3,3
833,2/7/2011,1,0,2,3,0,1,1,1,0.2,0.2576,0.86,0,0,1,1,1
834,2/7/2011,1,0,2,4,0,1,1,1,0.2,0.2576,0.86,0,1,1,2,1
835,2/7/2011,1,0,2,5,0,1,1,1,0.2,0.2576,0.86,0,1,9,10,9
836,2/7/2011,1,0,2,6,0,1,1,1,0.18,0.2424,0.93,0,1,29,30,29
837,2/7/2011,1,0,2,7,0,1,1,1,0.18,0.2424,0.86,0,6,89,95,89
838,2/7/2011,1,0,2,8,0,1,1,2,0.16,0.2273,1,0,7,223,230,223
839,2/7/2011,1,0,2,9,0,1,1,1,0.22,0.2727,0.8,0,3,115,118,115
840,2/7/2011,1,0,2,10,0,1,1,1,0.24,0.2576,0.75,0.1045,6,49,55,49
841,2/7/2011,1,0,2,11,0,1,1,1,0.3,0.3182,0.65,0.0896,11,36,47,36
842,2/7/2011,1,0,2,12,0,1,1,2,0.32,0.3485,0.62,0,7,59,66,59
843,2/7/2011,1,0,2,13,0,1,1,2,0.36,0.3636,0.57,0.0896,10,54,64,54
844,2/7/2011,1,0,2,14,0,1,1,2,0.36,0.3636,0.57,0.0896,8,52,60,52
845,2/7/2011,1,0,2,15,0,1,1,2,0.38,0.3939,0.54,0.0896,4,46,50,46
846,2/7/2011,1,0,2,16,0,1,1,2,0.36,0.3485,0.57,0.1343,16,98,114,98
847,2/7/2011,1,0,2,17,0,1,1,2,0.32,0.3182,0.7,0.1642,9,207,216,207
848,2/7/2011,1,0,2,18,0,1,1,2,0.34,0.3333,0.66,0.1343,5,170,175,170
849,2/7/2011,1,0,2,19,0,1,1,2,0.32,0.3485,0.7,0,5,123,128,123
850,2/7/2011,1,0,2,20,0,1,1,2,0.32,0.3333,0.7,0.1045,6,82,88,82
851,2/7/2011,1,0,2,21,0,1,1,1,0.32,0.3485,0.7,0,3,75,78,75
852,2/7/2011,1,0,2,22,0,1,1,1,0.28,0.303,0.81,0.0896,3,34,37,34
853,2/7/2011,1,0,2,23,0,1,1,2,0.3,0.3333,0.81,0,6,19,25,19
854,2/8/2011,1,0,2,0,0,2,1,2,0.28,0.3182,0.87,0,4,6,10,6
855,2/8/2011,1,0,2,1,0,2,1,2,0.28,0.3182,0.87,0,0,4,4,4
856,2/8/2011,1,0,2,2,0,2,1,2,0.26,0.2727,0.93,0.1045,1,1,2,1
857,2/8/2011,1,0,2,3,0,2,1,3,0.28,0.2727,0.93,0.1642,0,1,1,1
858,2/8/2011,1,0,2,4,0,2,1,1,0.26,0.2576,0.93,0.1642,0,3,3,3
859,2/8/2011,1,0,2,5,0,2,1,1,0.26,0.2273,0.81,0.3284,0,2,2,2
860,2/8/2011,1,0,2,6,0,2,1,1,0.26,0.2273,0.7,0.3284,0,39,39,39
861,2/8/2011,1,0,2,7,0,2,1,1,0.24,0.197,0.65,0.4179,3,97,100,97
862,2/8/2011,1,0,2,8,0,2,1,1,0.24,0.197,0.56,0.4925,7,236,243,236
863,2/8/2011,1,0,2,9,0,2,1,1,0.24,0.197,0.52,0.4925,7,128,135,128
864,2/8/2011,1,0,2,10,0,2,1,1,0.22,0.1818,0.47,0.5522,4,44,48,44
865,2/8/2011,1,0,2,11,0,2,1,1,0.22,0.1818,0.47,0.4627,1,49,50,49
866,2/8/2011,1,0,2,12,0,2,1,1,0.24,0.197,0.38,0.4925,2,63,65,63
867,2/8/2011,1,0,2,13,0,2,1,2,0.24,0.197,0.32,0.4478,2,48,50,48
868,2/8/2011,1,0,2,14,0,2,1,1,0.22,0.197,0.37,0.4179,3,61,64,61
869,2/8/2011,1,0,2,15,0,2,1,1,0.22,0.197,0.35,0.3881,6,45,51,45
870,2/8/2011,1,0,2,16,0,2,1,1,0.22,0.1818,0.35,0.5224,4,79,83,79
871,2/8/2011,1,0,2,17,0,2,1,1,0.22,0.1818,0.32,0.5821,4,172,176,172
872,2/8/2011,1,0,2,18,0,2,1,1,0.2,0.1818,0.32,0.3881,1,151,152,151
873,2/8/2011,1,0,2,19,0,2,1,1,0.16,0.1212,0.4,0.4627,1,100,101,100
874,2/8/2011,1,0,2,20,0,2,1,1,0.16,0.1364,0.4,0.3284,3,53,56,53
875,2/8/2011,1,0,2,21,0,2,1,1,0.14,0.1061,0.33,0.4627,8,46,54,46
876,2/8/2011,1,0,2,22,0,2,1,1,0.12,0.1061,0.33,0.3582,0,29,29,29
877,2/8/2011,1,0,2,23,0,2,1,1,0.12,0.1061,0.33,0.3284,3,9,12,9
878,2/9/2011,1,0,2,0,0,3,1,1,0.1,0.0758,0.36,0.3582,0,17,17,17
879,2/9/2011,1,0,2,1,0,3,1,1,0.1,0.1061,0.36,0.2239,0,7,7,7
880,2/9/2011,1,0,2,2,0,3,1,1,0.08,0.0758,0.38,0.2836,1,2,3,2
881,2/9/2011,1,0,2,3,0,3,1,1,0.06,0.0758,0.45,0.1343,0,2,2,2
882,2/9/2011,1,0,2,5,0,3,1,1,0.06,0.1061,0.45,0.1045,0,7,7,7
883,2/9/2011,1,0,2,6,0,3,1,1,0.06,0.1515,0.45,0,0,43,43,43
884,2/9/2011,1,0,2,7,0,3,1,1,0.06,0.1061,0.49,0.1045,4,95,99,95
885,2/9/2011,1,0,2,8,0,3,1,1,0.1,0.1364,0.42,0,1,198,199,198
886,2/9/2011,1,0,2,9,0,3,1,1,0.12,0.1364,0.39,0.1642,4,119,123,119
887,2/9/2011,1,0,2,10,0,3,1,1,0.14,0.1818,0.36,0,8,51,59,51
888,2/9/2011,1,0,2,11,0,3,1,2,0.14,0.1515,0.43,0.1642,1,40,41,40
889,2/9/2011,1,0,2,12,0,3,1,2,0.18,0.1818,0.4,0.2239,4,57,61,57
890,2/9/2011,1,0,2,13,0,3,1,1,0.18,0.1667,0.4,0.2537,2,67,69,67
891,2/9/2011,1,0,2,14,0,3,1,1,0.2,0.1818,0.34,0.2985,2,56,58,56
892,2/9/2011,1,0,2,15,0,3,1,2,0.2,0.1818,0.34,0.2836,3,61,64,61
893,2/9/2011,1,0,2,16,0,3,1,2,0.2,0.197,0.37,0.2537,7,72,79,72
894,2/9/2011,1,0,2,17,0,3,1,2,0.2,0.197,0.34,0.2537,9,157,166,157
895,2/9/2011,1,0,2,18,0,3,1,2,0.18,0.1667,0.47,0.2985,2,168,170,168
896,2/9/2011,1,0,2,19,0,3,1,3,0.14,0.1212,0.86,0.2537,1,87,88,87
897,2/9/2011,1,0,2,20,0,3,1,3,0.14,0.1515,0.86,0.1642,0,84,84,84
898,2/9/2011,1,0,2,21,0,3,1,2,0.14,0.1515,0.86,0.1642,0,83,83,83
899,2/9/2011,1,0,2,22,0,3,1,3,0.16,0.1667,0.8,0.1642,4,42,46,42
900,2/9/2011,1,0,2,23,0,3,1,3,0.16,0.1515,0.8,0.194,0,37,37,37
901,2/10/2011,1,0,2,0,0,4,1,3,0.14,0.1364,0.86,0.194,0,16,16,16
902,2/10/2011,1,0,2,1,0,4,1,3,0.14,0.1515,0.8,0.1343,0,7,7,7
903,2/10/2011,1,0,2,2,0,4,1,3,0.14,0.1515,0.8,0.1343,0,3,3,3
904,2/10/2011,1,0,2,4,0,4,1,2,0.14,0.1364,0.59,0.2239,0,1,1,1
905,2/10/2011,1,0,2,5,0,4,1,2,0.12,0.1212,0.5,0.2239,0,6,6,6
906,2/10/2011,1,0,2,6,0,4,1,2,0.12,0.1212,0.54,0.2836,0,26,26,26
907,2/10/2011,1,0,2,7,0,4,1,1,0.1,0.0758,0.5,0.4179,0,99,99,99
908,2/10/2011,1,0,2,8,0,4,1,1,0.1,0.0758,0.49,0.3284,5,173,178,173
909,2/10/2011,1,0,2,9,0,4,1,1,0.12,0.1061,0.42,0.3582,1,121,122,121
910,2/10/2011,1,0,2,10,0,4,1,1,0.12,0.1061,0.42,0.2985,1,34,35,34
911,2/10/2011,1,0,2,11,0,4,1,1,0.14,0.1212,0.39,0.3582,1,44,45,44
912,2/10/2011,1,0,2,12,0,4,1,1,0.16,0.1364,0.34,0.3881,4,65,69,65
913,2/10/2011,1,0,2,13,0,4,1,1,0.18,0.1667,0.29,0.2985,3,59,62,59
914,2/10/2011,1,0,2,14,0,4,1,1,0.2,0.1818,0.27,0.2836,6,42,48,42
915,2/10/2011,1,0,2,15,0,4,1,1,0.2,0.197,0.25,0.2537,0,50,50,50
916,2/10/2011,1,0,2,16,0,4,1,1,0.2,0.1818,0.27,0.2985,4,76,80,76
917,2/10/2011,1,0,2,17,0,4,1,1,0.18,0.1818,0.26,0.194,6,159,165,159
918,2/10/2011,1,0,2,18,0,4,1,1,0.16,0.1818,0.28,0.1343,3,157,160,157
919,2/10/2011,1,0,2,19,0,4,1,1,0.14,0.1667,0.28,0.1045,2,110,112,110
920,2/10/2011,1,0,2,20,0,4,1,1,0.14,0.1818,0.31,0.0896,4,93,97,93
921,2/10/2011,1,0,2,21,0,4,1,1,0.14,0.2121,0.39,0,2,70,72,70
922,2/10/2011,1,0,2,22,0,4,1,1,0.12,0.197,0.39,0,4,47,51,47
923,2/10/2011,1,0,2,23,0,4,1,1,0.12,0.1515,0.42,0.1045,1,33,34,33
924,2/11/2011,1,0,2,0,0,5,1,1,0.1,0.1364,0.49,0.1045,2,12,14,12
925,2/11/2011,1,0,2,1,0,5,1,1,0.1,0.1364,0.54,0.0896,1,6,7,6
926,2/11/2011,1,0,2,2,0,5,1,1,0.1,0.1364,0.54,0.0896,0,3,3,3
927,2/11/2011,1,0,2,5,0,5,1,1,0.08,0.1212,0.63,0.0896,0,4,4,4
928,2/11/2011,1,0,2,6,0,5,1,1,0.1,0.1818,0.68,0,1,23,24,23
929,2/11/2011,1,0,2,7,0,5,1,1,0.08,0.1667,0.73,0,1,73,74,73
930,2/11/2011,1,0,2,8,0,5,1,1,0.1,0.1212,0.74,0.1642,4,212,216,212
931,2/11/2011,1,0,2,9,0,5,1,1,0.12,0.1212,0.74,0.2239,8,132,140,132
932,2/11/2011,1,0,2,10,0,5,1,1,0.14,0.1364,0.69,0.194,5,39,44,39
933,2/11/2011,1,0,2,11,0,5,1,1,0.22,0.2273,0.47,0.1343,12,52,64,52
934,2/11/2011,1,0,2,12,0,5,1,1,0.22,0.2273,0.47,0.1343,7,64,71,64
935,2/11/2011,1,0,2,13,0,5,1,1,0.24,0.2273,0.35,0.194,21,89,110,89
936,2/11/2011,1,0,2,14,0,5,1,1,0.3,0.2879,0.26,0.2537,17,67,84,67
937,2/11/2011,1,0,2,15,0,5,1,1,0.32,0.3182,0.21,0.1642,12,62,74,62
938,2/11/2011,1,0,2,16,0,5,1,1,0.3,0.2879,0.28,0.194,14,111,125,111
939,2/11/2011,1,0,2,17,0,5,1,1,0.3,0.3333,0.24,0,18,193,211,193
940,2/11/2011,1,0,2,18,0,5,1,1,0.28,0.3182,0.28,0,9,165,174,165
941,2/11/2011,1,0,2,19,0,5,1,1,0.26,0.303,0.33,0,7,94,101,94
942,2/11/2011,1,0,2,20,0,5,1,1,0.22,0.2273,0.55,0.1343,2,61,63,61
943,2/11/2011,1,0,2,21,0,5,1,1,0.2,0.2121,0.59,0.1343,1,46,47,46
944,2/11/2011,1,0,2,22,0,5,1,1,0.2,0.2273,0.64,0.0896,2,41,43,41
945,2/11/2011,1,0,2,23,0,5,1,1,0.18,0.2424,0.69,0,5,48,53,48
946,2/12/2011,1,0,2,0,0,6,0,1,0.16,0.197,0.69,0.0896,3,27,30,27
947,2/12/2011,1,0,2,1,0,6,0,1,0.14,0.2121,0.86,0,2,22,24,22
948,2/12/2011,1,0,2,2,0,6,0,1,0.14,0.2121,0.8,0,2,13,15,13
949,2/12/2011,1,0,2,3,0,6,0,1,0.12,0.197,0.8,0,3,7,10,7
950,2/12/2011,1,0,2,4,0,6,0,1,0.12,0.1667,0.74,0.0896,0,4,4,4
951,2/12/2011,1,0,2,5,0,6,0,1,0.12,0.1667,0.74,0.0896,0,1,1,1
952,2/12/2011,1,0,2,6,0,6,0,1,0.12,0.1364,0.93,0.194,1,1,2,1
953,2/12/2011,1,0,2,7,0,6,0,1,0.12,0.1515,0.8,0.1045,2,9,11,9
954,2/12/2011,1,0,2,8,0,6,0,1,0.14,0.1515,0.86,0.1343,2,28,30,28
955,2/12/2011,1,0,2,9,0,6,0,1,0.16,0.1818,0.64,0.1343,5,38,43,38
956,2/12/2011,1,0,2,10,0,6,0,1,0.22,0.2121,0.41,0.2537,13,71,84,71
957,2/12/2011,1,0,2,11,0,6,0,1,0.3,0.2727,0.28,0.3284,30,84,114,84
958,2/12/2011,1,0,2,12,0,6,0,1,0.3,0.2727,0.39,0.4627,27,93,120,93
959,2/12/2011,1,0,2,13,0,6,0,1,0.3,0.2727,0.39,0.4179,32,103,135,103
960,2/12/2011,1,0,2,14,0,6,0,1,0.34,0.3182,0.31,0.2836,30,90,120,90
961,2/12/2011,1,0,2,15,0,6,0,1,0.34,0.303,0.29,0.4179,47,127,174,127
962,2/12/2011,1,0,2,16,0,6,0,1,0.34,0.303,0.29,0.4179,42,103,145,103
963,2/12/2011,1,0,2,17,0,6,0,1,0.32,0.2879,0.31,0.5224,24,113,137,113
964,2/12/2011,1,0,2,18,0,6,0,1,0.28,0.2576,0.38,0.3284,4,60,64,60
965,2/12/2011,1,0,2,19,0,6,0,1,0.28,0.2727,0.38,0.1642,2,39,41,39
966,2/12/2011,1,0,2,20,0,6,0,1,0.26,0.2576,0.41,0.2239,1,39,40,39
967,2/12/2011,1,0,2,21,0,6,0,1,0.26,0.303,0.41,0,9,42,51,42
968,2/12/2011,1,0,2,22,0,6,0,1,0.24,0.2576,0.44,0.0896,6,39,45,39
969,2/12/2011,1,0,2,23,0,6,0,1,0.22,0.2273,0.51,0.1343,1,31,32,31
970,2/13/2011,1,0,2,0,0,0,0,1,0.2,0.2273,0.64,0.1045,5,34,39,34
971,2/13/2011,1,0,2,1,0,0,0,1,0.2,0.2273,0.59,0.0896,1,23,24,23
972,2/13/2011,1,0,2,2,0,0,0,2,0.2,0.2273,0.75,0.0896,1,19,20,19
973,2/13/2011,1,0,2,3,0,0,0,2,0.2,0.2273,0.69,0.1045,4,8,12,8
974,2/13/2011,1,0,2,4,0,0,0,2,0.2,0.2121,0.69,0.1642,0,2,2,2
975,2/13/2011,1,0,2,6,0,0,0,2,0.2,0.2121,0.69,0.1343,2,3,5,3
976,2/13/2011,1,0,2,7,0,0,0,2,0.22,0.2727,0.55,0,0,3,3,3
977,2/13/2011,1,0,2,8,0,0,0,2,0.22,0.2273,0.64,0.194,1,11,12,11
978,2/13/2011,1,0,2,9,0,0,0,2,0.24,0.2273,0.6,0.2239,12,35,47,35
979,2/13/2011,1,0,2,10,0,0,0,1,0.3,0.2727,0.45,0.3284,19,86,105,86
980,2/13/2011,1,0,2,11,0,0,0,1,0.32,0.2879,0.39,0.4478,26,86,112,86
981,2/13/2011,1,0,2,12,0,0,0,1,0.36,0.3182,0.32,0.4627,58,94,152,94
982,2/13/2011,1,0,2,13,0,0,0,1,0.38,0.3939,0.29,0.3582,62,92,154,92
983,2/13/2011,1,0,2,14,0,0,0,2,0.4,0.4091,0.3,0.4179,51,110,161,110
984,2/13/2011,1,0,2,15,0,0,0,2,0.4,0.4091,0.3,0.2985,40,122,162,122
985,2/13/2011,1,0,2,16,0,0,0,2,0.42,0.4242,0.28,0.3284,28,106,134,106
986,2/13/2011,1,0,2,17,0,0,0,1,0.42,0.4242,0.28,0.3284,30,95,125,95
987,2/13/2011,1,0,2,18,0,0,0,1,0.4,0.4091,0.32,0.2985,17,78,95,78
988,2/13/2011,1,0,2,19,0,0,0,1,0.4,0.4091,0.35,0.2836,11,50,61,50
989,2/13/2011,1,0,2,20,0,0,0,1,0.4,0.4091,0.35,0.3284,15,32,47,32
990,2/13/2011,1,0,2,21,0,0,0,1,0.4,0.4091,0.35,0.3582,6,45,51,45
991,2/13/2011,1,0,2,22,0,0,0,1,0.4,0.4091,0.35,0.2985,5,31,36,31
992,2/13/2011,1,0,2,23,0,0,0,1,0.4,0.4091,0.35,0.3582,3,27,30,27
993,2/14/2011,1,0,2,0,0,1,1,1,0.38,0.3939,0.37,0.3582,3,8,11,8
994,2/14/2011,1,0,2,1,0,1,1,1,0.38,0.3939,0.37,0.3582,1,6,7,6
995,2/14/2011,1,0,2,2,0,1,1,1,0.36,0.3333,0.4,0.2985,0,2,2,2
996,2/14/2011,1,0,2,3,0,1,1,1,0.34,0.3182,0.46,0.2239,1,1,2,1
997,2/14/2011,1,0,2,4,0,1,1,1,0.32,0.303,0.53,0.2836,0,2,2,2
998,2/14/2011,1,0,2,5,0,1,1,1,0.32,0.303,0.53,0.2836,0,3,3,3
999,2/14/2011,1,0,2,6,0,1,1,1,0.34,0.303,0.46,0.2985,1,25,26,25
1000,2/14/2011,1,0,2,7,0,1,1,1,0.34,0.303,0.46,0.2985,2,96,98,96
1001,2/14/2011,1,0,2,8,0,1,1,1,0.38,0.3939,0.4,0.4627,7,249,256,249
1002,2/14/2011,1,0,2,9,0,1,1,1,0.4,0.4091,0.37,0.3881,8,122,130,122
1003,2/14/2011,1,0,2,10,0,1,1,1,0.44,0.4394,0.33,0.2239,9,46,55,46
1004,2/14/2011,1,0,2,11,0,1,1,1,0.52,0.5,0.23,0.2537,10,43,53,43
1005,2/14/2011,1,0,2,12,0,1,1,1,0.56,0.5303,0.22,0.4478,27,99,126,99
1006,2/14/2011,1,0,2,13,0,1,1,1,0.58,0.5455,0.19,0.3881,27,93,120,93
1007,2/14/2011,1,0,2,14,0,1,1,1,0.6,0.5909,0.15,0.4925,14,76,90,76
1008,2/14/2011,1,0,2,15,0,1,1,1,0.56,0.5303,0.21,0.6567,19,71,90,71
1009,2/14/2011,1,0,2,16,0,1,1,1,0.52,0.5,0.27,0.4627,16,102,118,102
1010,2/14/2011,1,0,2,17,0,1,1,1,0.46,0.4545,0.33,0.6119,25,218,243,218
1011,2/14/2011,1,0,2,18,0,1,1,1,0.4,0.4091,0.4,0.6119,11,194,205,194
1012,2/14/2011,1,0,2,19,0,1,1,1,0.38,0.3939,0.43,0.4925,12,86,98,86
1013,2/14/2011,1,0,2,20,0,1,1,1,0.36,0.3182,0.46,0.4627,5,65,70,65
1014,2/14/2011,1,0,2,21,0,1,1,1,0.36,0.3182,0.5,0.5224,8,35,43,35
1015,2/14/2011,1,0,2,22,0,1,1,1,0.34,0.2879,0.46,0.6567,1,44,45,44
1016,2/14/2011,1,0,2,23,0,1,1,1,0.32,0.2879,0.49,0.4925,1,19,20,19
1017,2/15/2011,1,0,2,0,0,2,1,1,0.3,0.2727,0.49,0.4179,7,12,19,12
1018,2/15/2011,1,0,2,1,0,2,1,1,0.3,0.2424,0.42,0.7761,0,5,5,5
1019,2/15/2011,1,0,2,2,0,2,1,1,0.28,0.2273,0.41,0.6866,1,2,3,2
1020,2/15/2011,1,0,2,4,0,2,1,1,0.22,0.1818,0.37,0.5224,0,1,1,1
1021,2/15/2011,1,0,2,5,0,2,1,1,0.22,0.1818,0.32,0.4627,0,4,4,4
1022,2/15/2011,1,0,2,6,0,2,1,1,0.2,0.1818,0.32,0.3284,0,30,30,30
1023,2/15/2011,1,0,2,7,0,2,1,1,0.2,0.1818,0.32,0.3582,2,103,105,103
1024,2/15/2011,1,0,2,8,0,2,1,1,0.2,0.1818,0.32,0.3582,10,213,223,213
1025,2/15/2011,1,0,2,9,0,2,1,1,0.22,0.197,0.29,0.4478,2,108,110,108
1026,2/15/2011,1,0,2,10,0,2,1,1,0.24,0.2121,0.27,0.2836,5,47,52,47
1027,2/15/2011,1,0,2,11,0,2,1,1,0.26,0.2424,0.25,0.2537,11,46,57,46
1028,2/15/2011,1,0,2,12,0,2,1,1,0.28,0.2727,0.24,0.2537,6,65,71,65
1029,2/15/2011,1,0,2,13,0,2,1,1,0.32,0.303,0.21,0.2239,14,68,82,68
1030,2/15/2011,1,0,2,14,0,2,1,1,0.34,0.3182,0.19,0.2239,10,69,79,69
1031,2/15/2011,1,0,2,15,0,2,1,1,0.34,0.3333,0.19,0.1642,11,74,85,74
1032,2/15/2011,1,0,2,16,0,2,1,1,0.34,0.3182,0.19,0.2537,21,77,98,77
1033,2/15/2011,1,0,2,17,0,2,1,1,0.32,0.303,0.22,0.2239,15,191,206,191
1034,2/15/2011,1,0,2,18,0,2,1,1,0.3,0.303,0.22,0.1343,14,198,212,198
1035,2/15/2011,1,0,2,19,0,2,1,1,0.28,0.2879,0.26,0.1343,3,142,145,142
1036,2/15/2011,1,0,2,20,0,2,1,1,0.26,0.2727,0.33,0.1045,3,98,101,98
1037,2/15/2011,1,0,2,21,0,2,1,1,0.24,0.2879,0.52,0,5,61,66,61
1038,2/15/2011,1,0,2,22,0,2,1,1,0.24,0.2879,0.44,0,0,41,41,41
1039,2/15/2011,1,0,2,23,0,2,1,2,0.22,0.2576,0.44,0.0896,0,20,20,20
1040,2/16/2011,1,0,2,0,0,3,1,1,0.22,0.2576,0.41,0.0896,0,15,15,15
1041,2/16/2011,1,0,2,1,0,3,1,1,0.2,0.2273,0.44,0.0896,0,9,9,9
1042,2/16/2011,1,0,2,3,0,3,1,2,0.2,0.197,0.47,0.194,0,1,1,1
1043,2/16/2011,1,0,2,4,0,3,1,1,0.2,0.197,0.51,0.194,0,1,1,1
1044,2/16/2011,1,0,2,5,0,3,1,1,0.2,0.197,0.47,0.194,0,5,5,5
1045,2/16/2011,1,0,2,6,0,3,1,1,0.2,0.197,0.55,0.2239,1,32,33,32
1046,2/16/2011,1,0,2,7,0,3,1,2,0.2,0.197,0.55,0.2239,5,103,108,103
1047,2/16/2011,1,0,2,8,0,3,1,2,0.22,0.2273,0.55,0.1642,6,224,230,224
1048,2/16/2011,1,0,2,9,0,3,1,1,0.24,0.2121,0.52,0.2836,2,122,124,122
1049,2/16/2011,1,0,2,10,0,3,1,1,0.26,0.2273,0.41,0.3881,14,55,69,55
1050,2/16/2011,1,0,2,11,0,3,1,1,0.34,0.303,0.34,0.2985,7,59,66,59
1051,2/16/2011,1,0,2,12,0,3,1,1,0.38,0.3939,0.32,0.3284,14,72,86,72
1052,2/16/2011,1,0,2,13,0,3,1,1,0.42,0.4242,0.3,0.3582,13,80,93,80
1053,2/16/2011,1,0,2,14,0,3,1,1,0.46,0.4545,0.28,0.4179,17,65,82,65
1054,2/16/2011,1,0,2,15,0,3,1,1,0.46,0.4545,0.28,0.4179,35,82,117,82
1055,2/16/2011,1,0,2,16,0,3,1,1,0.46,0.4545,0.31,0.3881,26,96,122,96
1056,2/16/2011,1,0,2,17,0,3,1,1,0.46,0.4545,0.28,0.2836,11,244,255,244
1057,2/16/2011,1,0,2,18,0,3,1,1,0.4,0.4091,0.4,0.2239,20,202,222,202
1058,2/16/2011,1,0,2,19,0,3,1,1,0.34,0.3182,0.53,0.2239,18,143,161,143
1059,2/16/2011,1,0,2,20,0,3,1,1,0.38,0.3939,0.43,0.194,10,108,118,108
1060,2/16/2011,1,0,2,21,0,3,1,1,0.36,0.3485,0.46,0.194,5,87,92,87
1061,2/16/2011,1,0,2,22,0,3,1,1,0.34,0.3333,0.53,0.194,12,61,73,61
1062,2/16/2011,1,0,2,23,0,3,1,1,0.38,0.3939,0.4,0.2239,2,31,33,31
1063,2/17/2011,1,0,2,0,0,4,1,1,0.34,0.3333,0.53,0.194,1,16,17,16
1064,2/17/2011,1,0,2,1,0,4,1,1,0.34,0.3182,0.53,0.2239,0,6,6,6
1065,2/17/2011,1,0,2,2,0,4,1,2,0.34,0.3182,0.53,0.2239,2,4,6,4
1066,2/17/2011,1,0,2,3,0,4,1,1,0.34,0.3333,0.53,0.194,3,1,4,1
1067,2/17/2011,1,0,2,4,0,4,1,1,0.32,0.3182,0.57,0.194,3,1,4,1
1068,2/17/2011,1,0,2,5,0,4,1,1,0.32,0.3333,0.66,0.0896,1,11,12,11
1069,2/17/2011,1,0,2,6,0,4,1,1,0.3,0.303,0.7,0.1343,3,44,47,44
1070,2/17/2011,1,0,2,7,0,4,1,1,0.32,0.3333,0.57,0.1045,7,119,126,119
1071,2/17/2011,1,0,2,8,0,4,1,1,0.32,0.3333,0.57,0.0896,18,267,285,267
1072,2/17/2011,1,0,2,9,0,4,1,1,0.36,0.3485,0.57,0.194,16,163,179,163
1073,2/17/2011,1,0,2,10,0,4,1,1,0.38,0.3939,0.54,0.194,18,70,88,70
1074,2/17/2011,1,0,2,11,0,4,1,2,0.44,0.4394,0.44,0.2537,19,71,90,71
1075,2/17/2011,1,0,2,12,0,4,1,1,0.48,0.4697,0.41,0.2239,15,86,101,86
1076,2/17/2011,1,0,2,13,0,4,1,1,0.54,0.5152,0.34,0.2239,15,108,123,108
1077,2/17/2011,1,0,2,14,0,4,1,1,0.6,0.6212,0.31,0.2239,26,55,81,55
1078,2/17/2011,1,0,2,15,0,4,1,1,0.6,0.6061,0.28,0.2537,15,91,106,91
1079,2/17/2011,1,0,2,16,0,4,1,2,0.56,0.5303,0.35,0.2985,29,117,146,117
1080,2/17/2011,1,0,2,17,0,4,1,2,0.58,0.5455,0.32,0.2985,18,256,274,256
1081,2/17/2011,1,0,2,18,0,4,1,2,0.54,0.5152,0.42,0.2836,11,211,222,211
1082,2/17/2011,1,0,2,19,0,4,1,1,0.48,0.4697,0.55,0.3284,14,161,175,161
1083,2/17/2011,1,0,2,20,0,4,1,1,0.48,0.4697,0.59,0.3284,8,131,139,131
1084,2/17/2011,1,0,2,21,0,4,1,1,0.52,0.5,0.55,0.3881,5,119,124,119
1085,2/17/2011,1,0,2,22,0,4,1,1,0.5,0.4848,0.59,0.2836,8,68,76,68
1086,2/17/2011,1,0,2,23,0,4,1,1,0.46,0.4545,0.67,0.2985,4,40,44,40
1087,2/18/2011,1,0,2,0,0,5,1,1,0.44,0.4394,0.72,0.2836,12,20,32,20
1088,2/18/2011,1,0,2,1,0,5,1,1,0.44,0.4394,0.72,0.2239,1,7,8,7
1089,2/18/2011,1,0,2,2,0,5,1,1,0.44,0.4394,0.72,0.2836,2,5,7,5
1090,2/18/2011,1,0,2,3,0,5,1,1,0.46,0.4545,0.67,0.2537,2,6,8,6
1091,2/18/2011,1,0,2,4,0,5,1,1,0.46,0.4545,0.67,0.2537,0,1,1,1
1092,2/18/2011,1,0,2,5,0,5,1,2,0.46,0.4545,0.67,0.1045,1,6,7,6
1093,2/18/2011,1,0,2,6,0,5,1,2,0.44,0.4394,0.72,0.1642,2,48,50,48
1094,2/18/2011,1,0,2,7,0,5,1,2,0.42,0.4242,0.77,0.2239,8,108,116,108
1095,2/18/2011,1,0,2,8,0,5,1,2,0.42,0.4242,0.77,0.194,26,246,272,246
1096,2/18/2011,1,0,2,9,0,5,1,2,0.42,0.4242,0.77,0.194,15,154,169,154
1097,2/18/2011,1,0,2,10,0,5,1,2,0.44,0.4394,0.72,0.2239,17,78,95,78
1098,2/18/2011,1,0,2,11,0,5,1,1,0.44,0.4394,0.72,0.1642,31,82,113,82
1099,2/18/2011,1,0,2,12,0,5,1,1,0.5,0.4848,0.59,0.194,59,126,185,126
1100,2/18/2011,1,0,2,13,0,5,1,1,0.6,0.6212,0.43,0.194,45,131,176,131
1101,2/18/2011,1,0,2,14,0,5,1,1,0.66,0.6212,0.36,0.2985,73,118,191,118
1102,2/18/2011,1,0,2,15,0,5,1,1,0.66,0.6212,0.36,0.3284,55,117,172,117
1103,2/18/2011,1,0,2,16,0,5,1,1,0.66,0.6212,0.36,0.2836,68,164,232,164
1104,2/18/2011,1,0,2,17,0,5,1,1,0.66,0.6212,0.34,0.3582,52,275,327,275
1105,2/18/2011,1,0,2,18,0,5,1,1,0.64,0.6212,0.33,0.3284,29,195,224,195
1106,2/18/2011,1,0,2,19,0,5,1,1,0.62,0.6212,0.29,0.5821,16,146,162,146
1107,2/18/2011,1,0,2,20,0,5,1,1,0.6,0.6212,0.31,0.194,19,105,124,105
1108,2/18/2011,1,0,2,21,0,5,1,1,0.58,0.5455,0.21,0.4925,11,61,72,61
1109,2/18/2011,1,0,2,22,0,5,1,1,0.54,0.5152,0.1,0.2537,19,88,107,88
1110,2/18/2011,1,0,2,23,0,5,1,1,0.52,0.5,0.08,0.2836,16,61,77,61
1111,2/19/2011,1,0,2,0,0,6,0,1,0.48,0.4697,0.12,0.4925,6,23,29,23
1112,2/19/2011,1,0,2,1,0,6,0,1,0.46,0.4545,0.14,0.4179,10,21,31,21
1113,2/19/2011,1,0,2,2,0,6,0,1,0.44,0.4394,0.13,0.3881,3,14,17,14
1114,2/19/2011,1,0,2,3,0,6,0,1,0.42,0.4242,0.14,0.2985,0,7,7,7
1115,2/19/2011,1,0,2,4,0,6,0,1,0.4,0.4091,0.15,0.3284,0,3,3,3
1116,2/19/2011,1,0,2,5,0,6,0,1,0.4,0.4091,0.15,0.3284,0,3,3,3
1117,2/19/2011,1,0,2,6,0,6,0,1,0.4,0.4091,0.17,0.4179,3,3,6,3
1118,2/19/2011,1,0,2,7,0,6,0,1,0.38,0.3939,0.17,0.5224,6,16,22,16
1119,2/19/2011,1,0,2,8,0,6,0,1,0.38,0.3939,0.17,0.5821,9,36,45,36
1120,2/19/2011,1,0,2,9,0,6,0,1,0.4,0.4091,0.16,0.6567,18,37,55,37
1121,2/19/2011,1,0,2,10,0,6,0,1,0.42,0.4242,0.16,0.5821,34,72,106,72
1122,2/19/2011,1,0,2,11,0,6,0,1,0.44,0.4394,0.16,0.5821,47,76,123,76
1123,2/19/2011,1,0,2,12,0,6,0,1,0.44,0.4394,0.18,0.4925,38,81,119,81
1124,2/19/2011,1,0,2,13,0,6,0,1,0.44,0.4394,0.16,0.6119,52,103,155,103
1125,2/19/2011,1,0,2,14,0,6,0,1,0.46,0.4545,0.15,0.6567,102,94,196,94
1126,2/19/2011,1,0,2,15,0,6,0,1,0.44,0.4394,0.16,0.7463,84,87,171,87
1127,2/19/2011,1,0,2,16,0,6,0,1,0.44,0.4394,0.16,0.6418,39,81,120,81
1128,2/19/2011,1,0,2,17,0,6,0,1,0.42,0.4242,0.19,0.6119,36,91,127,91
1129,2/19/2011,1,0,2,18,0,6,0,1,0.36,0.3182,0.25,0.4478,21,67,88,67
1130,2/19/2011,1,0,2,19,0,6,0,1,0.34,0.303,0.29,0.3582,5,54,59,54
1131,2/19/2011,1,0,2,20,0,6,0,1,0.32,0.2879,0.28,0.5224,9,38,47,38
1132,2/19/2011,1,0,2,21,0,6,0,1,0.32,0.2727,0.26,0.5522,4,29,33,29
1133,2/19/2011,1,0,2,22,0,6,0,1,0.3,0.2576,0.28,0.4925,2,42,44,42
1134,2/19/2011,1,0,2,23,0,6,0,1,0.28,0.2424,0.33,0.4478,4,25,29,25
1135,2/20/2011,1,0,2,0,0,0,0,1,0.26,0.2121,0.35,0.4478,3,14,17,14
1136,2/20/2011,1,0,2,1,0,0,0,1,0.24,0.197,0.41,0.4627,5,11,16,11
1137,2/20/2011,1,0,2,2,0,0,0,1,0.24,0.197,0.41,0.5522,0,17,17,17
1138,2/20/2011,1,0,2,3,0,0,0,1,0.22,0.1818,0.44,0.5522,9,9,18,9
1139,2/20/2011,1,0,2,4,0,0,0,1,0.22,0.1818,0.44,0.5522,0,1,1,1
1140,2/20/2011,1,0,2,6,0,0,0,1,0.2,0.1818,0.47,0.2985,1,1,2,1
1141,2/20/2011,1,0,2,7,0,0,0,1,0.18,0.1667,0.51,0.2537,0,2,2,2
1142,2/20/2011,1,0,2,8,0,0,0,1,0.2,0.2273,0.51,0.1045,2,22,24,22
1143,2/20/2011,1,0,2,9,0,0,0,1,0.22,0.2121,0.47,0.2836,7,48,55,48
1144,2/20/2011,1,0,2,10,0,0,0,2,0.26,0.2576,0.41,0.194,34,70,104,70
1145,2/20/2011,1,0,2,11,0,0,0,2,0.3,0.303,0.33,0.1642,72,89,161,89
1146,2/20/2011,1,0,2,12,0,0,0,1,0.3,0.3182,0.33,0.1045,62,120,182,120
1147,2/20/2011,1,0,2,13,0,0,0,1,0.34,0.3333,0.29,0,76,122,198,122
1148,2/20/2011,1,0,2,14,0,0,0,1,0.36,0.3485,0.27,0.1642,108,104,212,104
1149,2/20/2011,1,0,2,15,0,0,0,1,0.36,0.3636,0.27,0.0896,66,102,168,102
1150,2/20/2011,1,0,2,16,0,0,0,1,0.36,0.3636,0.29,0.0896,59,88,147,88
1151,2/20/2011,1,0,2,17,0,0,0,1,0.34,0.3485,0.33,0.1642,60,86,146,86
1152,2/20/2011,1,0,2,18,0,0,0,2,0.34,0.3333,0.36,0.1343,30,71,101,71
1153,2/20/2011,1,0,2,19,0,0,0,2,0.34,0.3333,0.36,0.1343,3,39,42,39
1154,2/20/2011,1,0,2,20,0,0,0,2,0.34,0.3636,0.42,0,12,30,42,30
1155,2/20/2011,1,0,2,21,0,0,0,2,0.32,0.3485,0.53,0,17,39,56,39
1156,2/20/2011,1,0,2,22,0,0,0,2,0.32,0.303,0.57,0.2239,4,43,47,43
1157,2/20/2011,1,0,2,23,0,0,0,2,0.3,0.303,0.61,0.1642,9,45,54,45
1158,2/21/2011,1,0,2,0,1,1,0,2,0.34,0.303,0.42,0.3284,7,30,37,30
1159,2/21/2011,1,0,2,1,1,1,0,2,0.34,0.303,0.42,0.3284,2,11,13,11
1160,2/21/2011,1,0,2,2,1,1,0,2,0.34,0.303,0.42,0.3284,1,3,4,3
1161,2/21/2011,1,0,2,3,1,1,0,2,0.34,0.303,0.42,0.2985,2,3,5,3
1162,2/21/2011,1,0,2,4,1,1,0,1,0.32,0.3182,0.45,0.1642,1,0,1,0
1163,2/21/2011,1,0,2,5,1,1,0,2,0.34,0.3636,0.36,0,1,2,3,2
1164,2/21/2011,1,0,2,6,1,1,0,2,0.42,0.4242,0.26,0.2985,2,6,8,6
1165,2/21/2011,1,0,2,7,1,1,0,2,0.42,0.4242,0.26,0.2836,3,16,19,16
1166,2/21/2011,1,0,2,8,1,1,0,2,0.32,0.303,0.57,0.2985,7,56,63,56
1167,2/21/2011,1,0,2,9,1,1,0,2,0.32,0.303,0.57,0.2836,11,46,57,46
1168,2/21/2011,1,0,2,10,1,1,0,2,0.32,0.303,0.57,0.2537,29,52,81,52
1169,2/21/2011,1,0,2,11,1,1,0,2,0.32,0.3333,0.57,0.1045,20,70,90,70
1170,2/21/2011,1,0,2,12,1,1,0,2,0.32,0.3182,0.66,0.194,26,67,93,67
1171,2/21/2011,1,0,2,13,1,1,0,3,0.3,0.2727,0.81,0.3284,28,75,103,75
1172,2/21/2011,1,0,2,14,1,1,0,2,0.32,0.303,0.76,0.2537,15,101,116,101
1173,2/21/2011,1,0,2,15,1,1,0,2,0.3,0.2727,0.7,0.4478,11,76,87,76
1174,2/21/2011,1,0,2,16,1,1,0,3,0.28,0.2424,0.75,0.4179,8,48,56,48
1175,2/21/2011,1,0,2,17,1,1,0,2,0.28,0.2576,0.75,0.3881,18,62,80,62
1176,2/21/2011,1,0,2,18,1,1,0,2,0.24,0.2121,0.87,0.3582,2,64,66,64
1177,2/21/2011,1,0,2,19,1,1,0,2,0.24,0.2121,0.87,0.3582,0,49,49,49
1178,2/21/2011,1,0,2,20,1,1,0,3,0.24,0.2121,0.81,0.3881,0,29,29,29
1179,2/21/2011,1,0,2,21,1,1,0,3,0.22,0.197,0.75,0.4478,1,33,34,33
1180,2/21/2011,1,0,2,22,1,1,0,3,0.2,0.1667,0.75,0.4179,0,11,11,11
1181,2/21/2011,1,0,2,23,1,1,0,3,0.2,0.1667,0.75,0.4179,0,2,2,2
1182,2/22/2011,1,0,2,6,0,2,1,2,0.12,0.1212,0.8,0.2836,0,7,7,7
1183,2/22/2011,1,0,2,7,0,2,1,2,0.12,0.1212,0.8,0.2836,0,40,40,40
1184,2/22/2011,1,0,2,8,0,2,1,2,0.12,0.1212,0.8,0.2537,7,107,114,107
1185,2/22/2011,1,0,2,9,0,2,1,2,0.14,0.1212,0.74,0.2537,5,101,106,101
1186,2/22/2011,1,0,2,10,0,2,1,1,0.16,0.1818,0.69,0,0,44,44,44
1187,2/22/2011,1,0,2,11,0,2,1,1,0.16,0.2273,0.64,0,7,43,50,43
1188,2/22/2011,1,0,2,12,0,2,1,1,0.2,0.2273,0.59,0.1045,7,48,55,48
1189,2/22/2011,1,0,2,13,0,2,1,1,0.22,0.2273,0.55,0.1642,3,52,55,52
1190,2/22/2011,1,0,2,14,0,2,1,1,0.22,0.2273,0.55,0.194,9,49,58,49
1191,2/22/2011,1,0,2,15,0,2,1,1,0.24,0.2273,0.48,0.194,2,67,69,67
1192,2/22/2011,1,0,2,16,0,2,1,1,0.22,0.2273,0.51,0.1642,7,79,86,79
1193,2/22/2011,1,0,2,17,0,2,1,1,0.22,0.2121,0.51,0.2239,8,188,196,188
1194,2/22/2011,1,0,2,18,0,2,1,1,0.22,0.2273,0.47,0.1343,6,161,167,161
1195,2/22/2011,1,0,2,19,0,2,1,1,0.2,0.1818,0.47,0.2836,4,114,118,114
1196,2/22/2011,1,0,2,20,0,2,1,1,0.2,0.197,0.47,0.2239,3,102,105,102
1197,2/22/2011,1,0,2,21,0,2,1,1,0.2,0.197,0.47,0.2537,2,80,82,80
1198,2/22/2011,1,0,2,22,0,2,1,1,0.16,0.1515,0.43,0.2537,1,76,77,76
1199,2/22/2011,1,0,2,23,0,2,1,1,0.16,0.1515,0.43,0.2537,3,18,21,18
1200,2/23/2011,1,0,2,0,0,3,1,1,0.14,0.1364,0.5,0.194,0,6,6,6
1201,2/23/2011,1,0,2,1,0,3,1,1,0.14,0.1515,0.46,0.1642,0,4,4,4
1202,2/23/2011,1,0,2,2,0,3,1,1,0.12,0.1515,0.5,0.1343,0,1,1,1
1203,2/23/2011,1,0,2,3,0,3,1,1,0.12,0.1364,0.5,0.1642,0,2,2,2
1204,2/23/2011,1,0,2,5,0,3,1,1,0.12,0.1515,0.5,0.1045,0,8,8,8
1205,2/23/2011,1,0,2,6,0,3,1,1,0.12,0.1515,0.5,0.1045,0,36,36,36
1206,2/23/2011,1,0,2,7,0,3,1,1,0.12,0.1515,0.54,0.1343,2,94,96,94
1207,2/23/2011,1,0,2,8,0,3,1,1,0.14,0.1515,0.54,0.1642,8,227,235,227
1208,2/23/2011,1,0,2,9,0,3,1,1,0.18,0.2121,0.51,0.0896,9,130,139,130
1209,2/23/2011,1,0,2,10,0,3,1,1,0.2,0.2576,0.4,0,4,47,51,47
1210,2/23/2011,1,0,2,11,0,3,1,1,0.24,0.2576,0.41,0.1045,16,53,69,53
1211,2/23/2011,1,0,2,12,0,3,1,1,0.26,0.2879,0.35,0.0896,11,56,67,56
1212,2/23/2011,1,0,2,13,0,3,1,1,0.3,0.3182,0.28,0.0896,9,78,87,78
1213,2/23/2011,1,0,2,14,0,3,1,1,0.32,0.3333,0.29,0.1045,17,61,78,61
1214,2/23/2011,1,0,2,15,0,3,1,1,0.34,0.3485,0.25,0.0896,18,54,72,54
1215,2/23/2011,1,0,2,16,0,3,1,1,0.34,0.3636,0.25,0,15,79,94,79
1216,2/23/2011,1,0,2,17,0,3,1,1,0.34,0.3485,0.25,0.0896,15,207,222,207
1217,2/23/2011,1,0,2,18,0,3,1,1,0.32,0.3333,0.26,0.0896,3,206,209,206
1218,2/23/2011,1,0,2,19,0,3,1,1,0.3,0.3333,0.33,0,6,135,141,135
1219,2/23/2011,1,0,2,20,0,3,1,1,0.24,0.2424,0.6,0.1642,2,107,109,107
1220,2/23/2011,1,0,2,21,0,3,1,1,0.24,0.2879,0.48,0,2,89,91,89
1221,2/23/2011,1,0,2,22,0,3,1,1,0.24,0.2879,0.48,0,1,60,61,60
1222,2/23/2011,1,0,2,23,0,3,1,1,0.22,0.2576,0.55,0.0896,1,38,39,38
1223,2/24/2011,1,0,2,0,0,4,1,1,0.22,0.2576,0.55,0.0896,0,11,11,11
1224,2/24/2011,1,0,2,1,0,4,1,1,0.22,0.2576,0.6,0.0896,0,7,7,7
1225,2/24/2011,1,0,2,2,0,4,1,1,0.2,0.2273,0.64,0.0896,0,4,4,4
1226,2/24/2011,1,0,2,3,0,4,1,1,0.2,0.2121,0.64,0.1343,0,2,2,2
1227,2/24/2011,1,0,2,5,0,4,1,1,0.2,0.2121,0.69,0.1343,1,3,4,3
1228,2/24/2011,1,0,2,6,0,4,1,1,0.2,0.197,0.69,0.194,0,58,58,58
1229,2/24/2011,1,0,2,7,0,4,1,1,0.2,0.197,0.72,0.194,0,104,104,104
1230,2/24/2011,1,0,2,8,0,4,1,1,0.24,0.2273,0.7,0.2239,8,244,252,244
1231,2/24/2011,1,0,2,9,0,4,1,2,0.24,0.2121,0.75,0.2985,4,133,137,133
1232,2/24/2011,1,0,2,10,0,4,1,2,0.26,0.2424,0.7,0.2836,8,49,57,49
1233,2/24/2011,1,0,2,11,0,4,1,2,0.32,0.2879,0.57,0.3881,8,71,79,71
1234,2/24/2011,1,0,2,12,0,4,1,2,0.36,0.3333,0.53,0.3582,10,85,95,85
1235,2/24/2011,1,0,2,13,0,4,1,2,0.38,0.3939,0.54,0.2985,16,72,88,72
1236,2/24/2011,1,0,2,14,0,4,1,2,0.4,0.4091,0.5,0.2985,2,67,69,67
1237,2/24/2011,1,0,2,15,0,4,1,3,0.4,0.4091,0.54,0.3881,5,58,63,58
1238,2/24/2011,1,0,2,16,0,4,1,3,0.38,0.3939,0.62,0.2836,4,67,71,67
1239,2/24/2011,1,0,2,17,0,4,1,3,0.36,0.3485,0.66,0.194,9,168,177,168
1240,2/24/2011,1,0,2,18,0,4,1,2,0.34,0.303,0.87,0.3284,5,132,137,132
1241,2/24/2011,1,0,2,19,0,4,1,3,0.34,0.303,0.93,0.2985,3,112,115,112
1242,2/24/2011,1,0,2,20,0,4,1,2,0.34,0.303,0.93,0.3582,2,87,89,87
1243,2/24/2011,1,0,2,21,0,4,1,2,0.34,0.303,0.87,0.3284,7,76,83,76
1244,2/24/2011,1,0,2,22,0,4,1,3,0.34,0.3182,0.87,0.2836,5,50,55,50
1245,2/24/2011,1,0,2,23,0,4,1,2,0.32,0.303,0.93,0.2239,3,47,50,47
1246,2/25/2011,1,0,2,0,0,5,1,3,0.32,0.3485,0.93,0,1,8,9,8
1247,2/25/2011,1,0,2,1,0,5,1,2,0.32,0.3485,1,0,1,9,10,9
1248,2/25/2011,1,0,2,2,0,5,1,2,0.32,0.3485,1,0,0,3,3,3
1249,2/25/2011,1,0,2,3,0,5,1,2,0.32,0.3333,0.93,0.1045,1,1,2,1
1250,2/25/2011,1,0,2,5,0,5,1,2,0.32,0.3333,0.93,0.1045,1,5,6,5
1251,2/25/2011,1,0,2,6,0,5,1,3,0.34,0.3485,0.93,0.0896,0,11,11,11
1252,2/25/2011,1,0,2,7,0,5,1,3,0.34,0.3333,1,0.1343,1,34,35,34
1253,2/25/2011,1,0,2,8,0,5,1,3,0.36,0.3485,0.93,0.1343,3,70,73,70
1254,2/25/2011,1,0,2,9,0,5,1,3,0.34,0.303,0.93,0.3582,3,111,114,111
1255,2/25/2011,1,0,2,10,0,5,1,3,0.42,0.4242,0.94,0.3284,7,42,49,42
1256,2/25/2011,1,0,2,11,0,5,1,1,0.52,0.5,0.77,0.4478,9,50,59,50
1257,2/25/2011,1,0,2,12,0,5,1,3,0.54,0.5152,0.6,0.4627,20,95,115,95
1258,2/25/2011,1,0,2,13,0,5,1,3,0.54,0.5152,0.6,0.4627,6,77,83,77
1259,2/25/2011,1,0,2,14,0,5,1,3,0.56,0.5303,0.56,0.6119,14,71,85,71
1260,2/25/2011,1,0,2,15,0,5,1,1,0.46,0.4545,0.41,0.806,5,50,55,50
1261,2/25/2011,1,0,2,16,0,5,1,1,0.32,0.2879,0.49,0.4627,11,91,102,91
1262,2/25/2011,1,0,2,17,0,5,1,1,0.32,0.2727,0.49,0.7463,8,181,189,181
1263,2/25/2011,1,0,2,18,0,5,1,1,0.32,0.2879,0.49,0.4925,7,150,157,150
1264,2/25/2011,1,0,2,19,0,5,1,1,0.3,0.2727,0.52,0.4478,4,86,90,86
1265,2/25/2011,1,0,2,20,0,5,1,1,0.3,0.2576,0.49,0.6119,2,60,62,60
1266,2/25/2011,1,0,2,21,0,5,1,1,0.28,0.2576,0.48,0.3881,7,56,63,56
1267,2/25/2011,1,0,2,22,0,5,1,1,0.26,0.2121,0.48,0.4478,7,43,50,43
1268,2/25/2011,1,0,2,23,0,5,1,1,0.26,0.2273,0.48,0.3284,2,37,39,37
1269,2/26/2011,1,0,2,0,0,6,0,1,0.24,0.2273,0.52,0.194,3,25,28,25
1270,2/26/2011,1,0,2,1,0,6,0,1,0.24,0.2121,0.52,0.2985,2,25,27,25
1271,2/26/2011,1,0,2,2,0,6,0,1,0.22,0.197,0.6,0.3582,3,9,12,9
1272,2/26/2011,1,0,2,3,0,6,0,1,0.22,0.2273,0.55,0.1343,1,7,8,7
1273,2/26/2011,1,0,2,4,0,6,0,2,0.22,0.2576,0.6,0.0896,1,1,2,1
1274,2/26/2011,1,0,2,5,0,6,0,2,0.22,0.2424,0.64,0.1045,1,9,10,9
1275,2/26/2011,1,0,2,6,0,6,0,1,0.22,0.2727,0.6,0,1,6,7,6
1276,2/26/2011,1,0,2,7,0,6,0,1,0.22,0.2576,0.6,0.0896,1,21,22,21
1277,2/26/2011,1,0,2,8,0,6,0,2,0.24,0.2879,0.6,0,2,55,57,55
1278,2/26/2011,1,0,2,9,0,6,0,2,0.26,0.2576,0.56,0.1642,9,65,74,65
1279,2/26/2011,1,0,2,10,0,6,0,2,0.3,0.303,0.49,0.1343,14,71,85,71
1280,2/26/2011,1,0,2,11,0,6,0,1,0.3,0.3333,0.45,0,26,100,126,100
1281,2/26/2011,1,0,2,12,0,6,0,2,0.32,0.3182,0.45,0.1642,45,115,160,115
1282,2/26/2011,1,0,2,13,0,6,0,2,0.34,0.3182,0.42,0.2537,38,136,174,136
1283,2/26/2011,1,0,2,14,0,6,0,2,0.34,0.303,0.36,0.3284,57,154,211,154
1284,2/26/2011,1,0,2,15,0,6,0,2,0.36,0.3333,0.4,0.2836,40,125,165,125
1285,2/26/2011,1,0,2,16,0,6,0,1,0.36,0.3333,0.46,0.2836,41,130,171,130
1286,2/26/2011,1,0,2,17,0,6,0,1,0.36,0.3485,0.43,0.2239,53,130,183,130
1287,2/26/2011,1,0,2,18,0,6,0,1,0.34,0.3333,0.46,0.194,26,111,137,111
1288,2/26/2011,1,0,2,19,0,6,0,1,0.32,0.303,0.49,0.2537,30,64,94,64
1289,2/26/2011,1,0,2,20,0,6,0,1,0.3,0.303,0.56,0.1642,8,60,68,60
1290,2/26/2011,1,0,2,21,0,6,0,1,0.28,0.2727,0.65,0.2537,9,59,68,59
1291,2/26/2011,1,0,2,22,0,6,0,1,0.28,0.2727,0.75,0.2239,8,38,46,38
1292,2/26/2011,1,0,2,23,0,6,0,1,0.28,0.2576,0.75,0.2836,5,29,34,29
1293,2/27/2011,1,0,2,0,0,0,0,1,0.26,0.2424,0.87,0.2836,8,26,34,26
1294,2/27/2011,1,0,2,1,0,0,0,1,0.26,0.2576,0.87,0.194,7,30,37,30
1295,2/27/2011,1,0,2,2,0,0,0,1,0.26,0.2727,0.87,0.1343,2,20,22,20
1296,2/27/2011,1,0,2,3,0,0,0,1,0.26,0.2879,0.87,0.0896,3,8,11,8
1297,2/27/2011,1,0,2,4,0,0,0,1,0.24,0.2424,0.87,0.1343,0,2,2,2
1298,2/27/2011,1,0,2,6,0,0,0,1,0.24,0.2879,0.87,0,2,1,3,1
1299,2/27/2011,1,0,2,7,0,0,0,1,0.24,0.2424,0.87,0.1343,6,8,14,8
1300,2/27/2011,1,0,2,8,0,0,0,1,0.26,0.303,0.87,0,9,26,35,26
1301,2/27/2011,1,0,2,9,0,0,0,1,0.28,0.303,0.87,0.0896,17,42,59,42
1302,2/27/2011,1,0,2,10,0,0,0,1,0.3,0.303,0.81,0.1642,24,79,103,79
1303,2/27/2011,1,0,2,11,0,0,0,1,0.36,0.3485,0.62,0.1343,33,92,125,92
1304,2/27/2011,1,0,2,12,0,0,0,1,0.4,0.4091,0.54,0.0896,61,132,193,132
1305,2/27/2011,1,0,2,13,0,0,0,1,0.42,0.4242,0.47,0,90,169,259,169
1306,2/27/2011,1,0,2,14,0,0,0,1,0.44,0.4394,0.47,0.0896,105,177,282,177
1307,2/27/2011,1,0,2,15,0,0,0,1,0.46,0.4545,0.44,0.1343,98,163,261,163
1308,2/27/2011,1,0,2,16,0,0,0,1,0.48,0.4697,0.44,0.1642,98,170,268,170
1309,2/27/2011,1,0,2,17,0,0,0,1,0.42,0.4242,0.54,0.194,66,121,187,121
1310,2/27/2011,1,0,2,18,0,0,0,1,0.4,0.4091,0.54,0.194,24,103,127,103
1311,2/27/2011,1,0,2,19,0,0,0,1,0.4,0.4091,0.54,0.1343,16,86,102,86
1312,2/27/2011,1,0,2,20,0,0,0,1,0.4,0.4091,0.54,0.0896,9,72,81,72
1313,2/27/2011,1,0,2,21,0,0,0,1,0.38,0.3939,0.62,0.1642,8,61,69,61
1314,2/27/2011,1,0,2,22,0,0,0,2,0.38,0.3939,0.62,0.1045,2,67,69,67
1315,2/27/2011,1,0,2,23,0,0,0,2,0.36,0.3485,0.62,0.1642,6,53,59,53
1316,2/28/2011,1,0,2,0,0,1,1,2,0.36,0.3636,0.66,0.1045,5,25,30,25
1317,2/28/2011,1,0,2,1,0,1,1,3,0.34,0.303,0.87,0.3582,1,7,8,7
1318,2/28/2011,1,0,2,3,0,1,1,3,0.32,0.3182,0.93,0.1642,0,1,1,1
1319,2/28/2011,1,0,2,5,0,1,1,2,0.34,0.3636,0.93,0,1,4,5,4
1320,2/28/2011,1,0,2,6,0,1,1,2,0.34,0.3485,0.96,0.1045,1,27,28,27
1321,2/28/2011,1,0,2,7,0,1,1,2,0.36,0.3636,0.93,0.1045,2,90,92,90
1322,2/28/2011,1,0,2,8,0,1,1,2,0.34,0.303,0.93,0.2985,13,242,255,242
1323,2/28/2011,1,0,2,9,0,1,1,1,0.42,0.4242,0.82,0.2836,15,127,142,127
1324,2/28/2011,1,0,2,10,0,1,1,2,0.52,0.5,0.72,0.4925,13,79,92,79
1325,2/28/2011,1,0,2,11,0,1,1,2,0.56,0.5303,0.64,0.2985,13,74,87,74
1326,2/28/2011,1,0,2,12,0,1,1,2,0.56,0.5303,0.64,0.2985,0,36,36,36
1327,2/28/2011,1,0,2,13,0,1,1,3,0.46,0.4545,0.94,0.2239,1,31,32,31
1328,2/28/2011,1,0,2,14,0,1,1,3,0.42,0.4242,1,0.2985,1,24,25,24
1329,2/28/2011,1,0,2,15,0,1,1,3,0.42,0.4242,1,0.2985,0,35,35,35
1330,2/28/2011,1,0,2,16,0,1,1,3,0.42,0.4242,1,0.1343,2,40,42,40
1331,2/28/2011,1,0,2,17,0,1,1,3,0.4,0.4091,1,0.2985,2,77,79,77
1332,2/28/2011,1,0,2,18,0,1,1,3,0.46,0.4545,0.94,0.194,4,127,131,127
1333,2/28/2011,1,0,2,19,0,1,1,3,0.44,0.4394,0.88,0.6119,1,79,80,79
1334,2/28/2011,1,0,2,20,0,1,1,3,0.44,0.4394,0.88,0.6119,0,45,45,45
1335,2/28/2011,1,0,2,21,0,1,1,2,0.38,0.3939,0.87,0.3881,2,78,80,78
1336,2/28/2011,1,0,2,22,0,1,1,3,0.34,0.303,0.93,0.4179,4,72,76,72
1337,2/28/2011,1,0,2,23,0,1,1,2,0.32,0.2879,0.81,0.3881,0,45,45,45
1338,3/1/2011,1,0,3,0,0,2,1,1,0.3,0.2727,0.7,0.4627,0,7,7,7
1339,3/1/2011,1,0,3,1,0,2,1,1,0.26,0.2273,0.7,0.3582,0,3,3,3
1340,3/1/2011,1,0,3,2,0,2,1,1,0.24,0.2121,0.65,0.3881,0,4,4,4
1341,3/1/2011,1,0,3,3,0,2,1,1,0.22,0.2121,0.69,0.2836,0,2,2,2
1342,3/1/2011,1,0,3,4,0,2,1,1,0.22,0.2121,0.69,0.2537,0,1,1,1
1343,3/1/2011,1,0,3,5,0,2,1,1,0.2,0.1818,0.64,0.2836,1,1,2,1
1344,3/1/2011,1,0,3,6,0,2,1,1,0.2,0.1818,0.59,0.2985,0,46,46,46
1345,3/1/2011,1,0,3,7,0,2,1,1,0.2,0.1818,0.59,0.3284,2,105,107,105
1346,3/1/2011,1,0,3,8,0,2,1,1,0.2,0.1818,0.59,0.3881,10,204,214,204
1347,3/1/2011,1,0,3,9,0,2,1,1,0.22,0.197,0.55,0.4179,8,116,124,116
1348,3/1/2011,1,0,3,10,0,2,1,1,0.24,0.2121,0.52,0.2836,13,55,68,55
1349,3/1/2011,1,0,3,11,0,2,1,1,0.28,0.2727,0.45,0.2537,8,48,56,48
1350,3/1/2011,1,0,3,12,0,2,1,1,0.3,0.303,0.39,0.1343,6,80,86,80
1351,3/1/2011,1,0,3,13,0,2,1,1,0.32,0.3485,0.39,0,13,65,78,65
1352,3/1/2011,1,0,3,14,0,2,1,1,0.32,0.3333,0.36,0.1343,18,61,79,61
1353,3/1/2011,1,0,3,15,0,2,1,1,0.34,0.3636,0.34,0,7,57,64,57
1354,3/1/2011,1,0,3,16,0,2,1,1,0.34,0.3485,0.34,0.0896,10,92,102,92
1355,3/1/2011,1,0,3,17,0,2,1,1,0.34,0.3485,0.34,0.0896,12,230,242,230
1356,3/1/2011,1,0,3,18,0,2,1,1,0.32,0.3182,0.39,0.194,10,214,224,214
1357,3/1/2011,1,0,3,19,0,2,1,1,0.3,0.303,0.49,0.1343,4,115,119,115
1358,3/1/2011,1,0,3,20,0,2,1,1,0.3,0.3182,0.61,0.0896,2,86,88,86
1359,3/1/2011,1,0,3,21,0,2,1,1,0.26,0.303,0.56,0,8,55,63,55
1360,3/1/2011,1,0,3,22,0,2,1,1,0.24,0.2727,0.62,0.1045,3,44,47,44
1361,3/1/2011,1,0,3,23,0,2,1,1,0.24,0.2273,0.65,0.2239,2,23,25,23
1362,3/2/2011,1,0,3,0,0,3,1,1,0.22,0.2273,0.69,0.1642,3,5,8,5
1363,3/2/2011,1,0,3,1,0,3,1,1,0.22,0.2273,0.69,0.194,0,4,4,4
1364,3/2/2011,1,0,3,2,0,3,1,1,0.22,0.2273,0.69,0.194,0,2,2,2
1365,3/2/2011,1,0,3,3,0,3,1,1,0.22,0.2121,0.69,0.2836,3,1,4,1
1366,3/2/2011,1,0,3,4,0,3,1,1,0.2,0.2121,0.75,0.1343,1,0,1,0
1367,3/2/2011,1,0,3,5,0,3,1,1,0.22,0.2121,0.69,0.2239,0,5,5,5
1368,3/2/2011,1,0,3,6,0,3,1,1,0.22,0.2121,0.55,0.2537,1,39,40,39
1369,3/2/2011,1,0,3,7,0,3,1,1,0.22,0.2121,0.64,0.2537,2,108,110,108
1370,3/2/2011,1,0,3,8,0,3,1,1,0.24,0.2121,0.65,0.2836,13,243,256,243
1371,3/2/2011,1,0,3,9,0,3,1,1,0.28,0.2576,0.56,0.2985,7,141,148,141
1372,3/2/2011,1,0,3,10,0,3,1,1,0.32,0.303,0.49,0.2836,11,65,76,65
1373,3/2/2011,1,0,3,11,0,3,1,1,0.34,0.303,0.53,0.3284,8,65,73,65
1374,3/2/2011,1,0,3,12,0,3,1,1,0.4,0.4091,0.43,0.194,20,62,82,62
1375,3/2/2011,1,0,3,13,0,3,1,1,0.5,0.4848,0.25,0,35,90,125,90
1376,3/2/2011,1,0,3,14,0,3,1,1,0.52,0.5,0.23,0.2985,21,75,96,75
1377,3/2/2011,1,0,3,15,0,3,1,1,0.54,0.5152,0.19,0.4179,19,91,110,91
1378,3/2/2011,1,0,3,16,0,3,1,1,0.54,0.5152,0.19,0.3284,27,112,139,112
1379,3/2/2011,1,0,3,17,0,3,1,1,0.5,0.4848,0.23,0.2836,30,238,268,238
1380,3/2/2011,1,0,3,18,0,3,1,1,0.46,0.4545,0.23,0.4925,8,193,201,193
1381,3/2/2011,1,0,3,19,0,3,1,1,0.4,0.4091,0.28,0.5224,6,144,150,144
1382,3/2/2011,1,0,3,20,0,3,1,1,0.36,0.3333,0.29,0.4179,9,86,95,86
1383,3/2/2011,1,0,3,21,0,3,1,1,0.34,0.2879,0.29,0.4627,3,68,71,68
1384,3/2/2011,1,0,3,22,0,3,1,1,0.3,0.2576,0.26,0.5522,4,44,48,44
1385,3/2/2011,1,0,3,23,0,3,1,1,0.26,0.2121,0.3,0.5224,0,22,22,22
1386,3/3/2011,1,0,3,0,0,4,1,1,0.24,0.197,0.3,0.4627,3,10,13,10
1387,3/3/2011,1,0,3,1,0,4,1,1,0.24,0.197,0.3,0.4627,0,1,1,1
1388,3/3/2011,1,0,3,2,0,4,1,1,0.2,0.1667,0.27,0.4627,1,2,3,2
1389,3/3/2011,1,0,3,3,0,4,1,1,0.2,0.1667,0.27,0.4627,0,1,1,1
1390,3/3/2011,1,0,3,4,0,4,1,1,0.16,0.1212,0.31,0.4925,0,1,1,1
1391,3/3/2011,1,0,3,5,0,4,1,1,0.14,0.1212,0.33,0.2985,1,7,8,7
1392,3/3/2011,1,0,3,6,0,4,1,1,0.14,0.1212,0.33,0.2985,1,34,35,34
1393,3/3/2011,1,0,3,7,0,4,1,1,0.12,0.0909,0.42,0.4179,1,110,111,110
1394,3/3/2011,1,0,3,8,0,4,1,1,0.14,0.1212,0.39,0.2985,4,216,220,216
1395,3/3/2011,1,0,3,9,0,4,1,1,0.16,0.1364,0.37,0.2836,10,135,145,135
1396,3/3/2011,1,0,3,10,0,4,1,1,0.18,0.1818,0.29,0.194,7,49,56,49
1397,3/3/2011,1,0,3,11,0,4,1,1,0.2,0.2273,0.29,0.0896,10,40,50,40
1398,3/3/2011,1,0,3,12,0,4,1,1,0.22,0.2273,0.25,0.1343,7,65,72,65
1399,3/3/2011,1,0,3,13,0,4,1,1,0.22,0.2576,0.25,0.0896,13,67,80,67
1400,3/3/2011,1,0,3,14,0,4,1,1,0.24,0.2576,0.21,0.1045,18,60,78,60
1401,3/3/2011,1,0,3,15,0,4,1,1,0.24,0.2879,0.23,0,6,62,68,62
1402,3/3/2011,1,0,3,16,0,4,1,1,0.26,0.303,0.23,0,6,65,71,65
1403,3/3/2011,1,0,3,17,0,4,1,1,0.26,0.303,0.22,0,17,185,202,185
1404,3/3/2011,1,0,3,18,0,4,1,1,0.24,0.2121,0.35,0.3284,6,161,167,161
1405,3/3/2011,1,0,3,19,0,4,1,1,0.2,0.197,0.4,0.2537,5,101,106,101
1406,3/3/2011,1,0,3,20,0,4,1,1,0.2,0.2273,0.4,0.0896,1,69,70,69
1407,3/3/2011,1,0,3,21,0,4,1,1,0.18,0.2121,0.4,0.1045,3,48,51,48
1408,3/3/2011,1,0,3,22,0,4,1,1,0.2,0.2576,0.4,0,3,50,53,50
1409,3/3/2011,1,0,3,23,0,4,1,2,0.18,0.2121,0.43,0.0896,0,23,23,23
1410,3/4/2011,1,0,3,0,0,5,1,2,0.2,0.197,0.55,0.194,0,12,12,12
1411,3/4/2011,1,0,3,1,0,5,1,2,0.18,0.1818,0.64,0.194,0,4,4,4
1412,3/4/2011,1,0,3,2,0,5,1,2,0.18,0.1818,0.64,0.194,0,2,2,2
1413,3/4/2011,1,0,3,3,0,5,1,2,0.18,0.1667,0.74,0.2537,0,1,1,1
1414,3/4/2011,1,0,3,4,0,5,1,2,0.18,0.1818,0.74,0.194,1,0,1,0
1415,3/4/2011,1,0,3,5,0,5,1,2,0.16,0.1818,0.74,0.1343,0,7,7,7
1416,3/4/2011,1,0,3,6,0,5,1,2,0.16,0.197,0.74,0.0896,1,28,29,28
1417,3/4/2011,1,0,3,7,0,5,1,1,0.16,0.1818,0.8,0.1343,0,83,83,83
1418,3/4/2011,1,0,3,8,0,5,1,1,0.18,0.197,0.74,0.1343,6,222,228,222
1419,3/4/2011,1,0,3,9,0,5,1,1,0.22,0.2273,0.6,0.1343,12,138,150,138
1420,3/4/2011,1,0,3,10,0,5,1,1,0.24,0.2273,0.6,0.2537,10,56,66,56
1421,3/4/2011,1,0,3,11,0,5,1,1,0.28,0.2727,0.52,0.2239,16,73,89,73
1422,3/4/2011,1,0,3,12,0,5,1,1,0.32,0.303,0.43,0.1642,10,87,97,87
1423,3/4/2011,1,0,3,13,0,5,1,1,0.34,0.3182,0.42,0.2239,13,74,87,74
1424,3/4/2011,1,0,3,14,0,5,1,1,0.36,0.3333,0.4,0.2836,30,65,95,65
1425,3/4/2011,1,0,3,15,0,5,1,1,0.36,0.3333,0.4,0.2985,31,75,106,75
1426,3/4/2011,1,0,3,16,0,5,1,1,0.36,0.3485,0.46,0.194,17,101,118,101
1427,3/4/2011,1,0,3,17,0,5,1,2,0.36,0.3333,0.5,0.2537,22,206,228,206
1428,3/4/2011,1,0,3,18,0,5,1,2,0.34,0.303,0.53,0.2985,15,172,187,172
1429,3/4/2011,1,0,3,19,0,5,1,1,0.32,0.303,0.61,0.2537,5,102,107,102
1430,3/4/2011,1,0,3,20,0,5,1,2,0.3,0.2879,0.7,0.194,9,78,87,78
1431,3/4/2011,1,0,3,21,0,5,1,2,0.3,0.2879,0.7,0.2239,6,64,70,64
1432,3/4/2011,1,0,3,22,0,5,1,1,0.3,0.2879,0.7,0.194,4,40,44,40
1433,3/4/2011,1,0,3,23,0,5,1,2,0.3,0.303,0.75,0.1642,6,40,46,40
1434,3/5/2011,1,0,3,0,0,6,0,2,0.28,0.2879,0.81,0.1045,4,15,19,15
1435,3/5/2011,1,0,3,1,0,6,0,2,0.3,0.3182,0.81,0.1045,5,20,25,20
1436,3/5/2011,1,0,3,2,0,6,0,2,0.3,0.2879,0.87,0.194,5,15,20,15
1437,3/5/2011,1,0,3,3,0,6,0,2,0.3,0.2879,0.87,0.194,0,2,2,2
1438,3/5/2011,1,0,3,4,0,6,0,2,0.3,0.303,0.93,0.1642,0,1,1,1
1439,3/5/2011,1,0,3,5,0,6,0,2,0.3,0.303,1,0.1343,0,3,3,3
1440,3/5/2011,1,0,3,6,0,6,0,2,0.3,0.2879,1,0.2239,1,3,4,3
1441,3/5/2011,1,0,3,7,0,6,0,2,0.3,0.2727,1,0.2985,5,10,15,10
1442,3/5/2011,1,0,3,8,0,6,0,2,0.3,0.2727,1,0.2985,11,34,45,34
1443,3/5/2011,1,0,3,9,0,6,0,2,0.32,0.303,0.93,0.2239,15,48,63,48
1444,3/5/2011,1,0,3,10,0,6,0,2,0.34,0.3333,0.93,0.194,34,69,103,69
1445,3/5/2011,1,0,3,11,0,6,0,2,0.4,0.4091,0.76,0.2239,43,116,159,116
1446,3/5/2011,1,0,3,12,0,6,0,2,0.44,0.4394,0.67,0.2537,46,121,167,121
1447,3/5/2011,1,0,3,13,0,6,0,2,0.46,0.4545,0.67,0.2836,60,130,190,130
1448,3/5/2011,1,0,3,14,0,6,0,2,0.48,0.4697,0.59,0.2836,80,118,198,118
1449,3/5/2011,1,0,3,15,0,6,0,2,0.46,0.4545,0.63,0.2985,83,122,205,122
1450,3/5/2011,1,0,3,16,0,6,0,2,0.48,0.4697,0.59,0.2985,74,130,204,130
1451,3/5/2011,1,0,3,17,0,6,0,2,0.48,0.4697,0.59,0.3582,60,104,164,104
1452,3/5/2011,1,0,3,18,0,6,0,2,0.48,0.4697,0.59,0.3284,37,115,152,115
1453,3/5/2011,1,0,3,19,0,6,0,2,0.46,0.4545,0.67,0.3284,27,62,89,62
1454,3/5/2011,1,0,3,20,0,6,0,2,0.44,0.4394,0.77,0.3284,12,58,70,58
1455,3/5/2011,1,0,3,21,0,6,0,2,0.44,0.4394,0.72,0.3284,12,60,72,60
1456,3/5/2011,1,0,3,22,0,6,0,2,0.42,0.4242,0.77,0.2985,16,47,63,47
1457,3/5/2011,1,0,3,23,0,6,0,2,0.44,0.4394,0.77,0.2985,10,34,44,34
1458,3/6/2011,1,0,3,0,0,0,0,2,0.42,0.4242,0.77,0.3582,11,41,52,41
1459,3/6/2011,1,0,3,1,0,0,0,2,0.42,0.4242,0.77,0.2836,12,27,39,27
1460,3/6/2011,1,0,3,2,0,0,0,2,0.4,0.4091,0.82,0.2836,5,27,32,27
1461,3/6/2011,1,0,3,3,0,0,0,2,0.42,0.4242,0.82,0.2985,2,9,11,9
1462,3/6/2011,1,0,3,4,0,0,0,2,0.42,0.4242,0.88,0.3582,0,3,3,3
1463,3/6/2011,1,0,3,6,0,0,0,2,0.42,0.4242,0.94,0.3582,1,1,2,1
1464,3/6/2011,1,0,3,7,0,0,0,3,0.42,0.4242,1,0.4478,0,5,5,5
1465,3/6/2011,1,0,3,8,0,0,0,2,0.4,0.4091,1,0.2985,1,8,9,8
1466,3/6/2011,1,0,3,9,0,0,0,2,0.42,0.4242,1,0.2836,4,18,22,18
1467,3/6/2011,1,0,3,10,0,0,0,2,0.42,0.4242,1,0.2985,4,27,31,27
1468,3/6/2011,1,0,3,11,0,0,0,2,0.42,0.4242,1,0.2239,18,44,62,44
1469,3/6/2011,1,0,3,12,0,0,0,2,0.46,0.4545,0.94,0.3284,10,69,79,69
1470,3/6/2011,1,0,3,13,0,0,0,2,0.46,0.4545,0.94,0.3582,22,83,105,83
1471,3/6/2011,1,0,3,14,0,0,0,3,0.44,0.4394,1,0.2239,12,27,39,27
1472,3/6/2011,1,0,3,15,0,0,0,3,0.44,0.4394,1,0.2239,3,4,7,4
1473,3/6/2011,1,0,3,16,0,0,0,3,0.36,0.3333,1,0.2836,3,8,11,8
1474,3/6/2011,1,0,3,17,0,0,0,3,0.34,0.303,1,0.2985,2,23,25,23
1475,3/6/2011,1,0,3,18,0,0,0,3,0.32,0.2879,1,0.3582,0,23,23,23
1476,3/6/2011,1,0,3,19,0,0,0,3,0.3,0.2576,1,0.4925,0,11,11,11
1477,3/6/2011,1,0,3,20,0,0,0,3,0.28,0.2424,1,0.4179,3,8,11,8
1478,3/6/2011,1,0,3,21,0,0,0,3,0.24,0.1818,0.93,0.6119,1,6,7,6
1479,3/6/2011,1,0,3,22,0,0,0,2,0.22,0.197,1,0.3881,0,10,10,10
1480,3/6/2011,1,0,3,23,0,0,0,2,0.22,0.197,1,0.4179,0,9,9,9
1481,3/7/2011,1,0,3,0,0,1,1,3,0.2,0.1818,1,0.3284,0,4,4,4
1482,3/7/2011,1,0,3,1,0,1,1,3,0.2,0.1818,1,0.3284,0,2,2,2
1483,3/7/2011,1,0,3,3,0,1,1,1,0.2,0.1515,0.8,0.5821,0,1,1,1
1484,3/7/2011,1,0,3,4,0,1,1,1,0.2,0.1515,0.8,0.5224,1,0,1,0
1485,3/7/2011,1,0,3,5,0,1,1,1,0.2,0.1818,0.75,0.3582,0,1,1,1
1486,3/7/2011,1,0,3,6,0,1,1,1,0.2,0.1818,0.75,0.3881,3,31,34,31
1487,3/7/2011,1,0,3,7,0,1,1,1,0.2,0.1667,0.75,0.4179,3,88,91,88
1488,3/7/2011,1,0,3,8,0,1,1,1,0.2,0.1818,0.75,0.3881,11,200,211,200
1489,3/7/2011,1,0,3,9,0,1,1,1,0.22,0.1818,0.64,0.4627,5,129,134,129
1490,3/7/2011,1,0,3,10,0,1,1,1,0.24,0.2121,0.6,0.2985,15,43,58,43
1491,3/7/2011,1,0,3,11,0,1,1,1,0.26,0.2121,0.48,0.4478,19,41,60,41
1492,3/7/2011,1,0,3,12,0,1,1,1,0.3,0.2727,0.42,0.4179,28,68,96,68
1493,3/7/2011,1,0,3,13,0,1,1,1,0.32,0.2879,0.36,0.3881,16,54,70,54
1494,3/7/2011,1,0,3,14,0,1,1,1,0.32,0.2879,0.36,0.4179,21,56,77,56
1495,3/7/2011,1,0,3,15,0,1,1,1,0.34,0.303,0.31,0.3881,32,64,96,64
1496,3/7/2011,1,0,3,16,0,1,1,1,0.34,0.303,0.31,0.3582,26,96,122,96
1497,3/7/2011,1,0,3,17,0,1,1,1,0.34,0.303,0.29,0.3582,27,206,233,206
1498,3/7/2011,1,0,3,18,0,1,1,1,0.32,0.303,0.31,0.2239,19,214,233,214
1499,3/7/2011,1,0,3,19,0,1,1,1,0.3,0.2879,0.33,0.2239,11,134,145,134
1500,3/7/2011,1,0,3,20,0,1,1,1,0.3,0.303,0.33,0.1642,5,87,92,87
1501,3/7/2011,1,0,3,21,0,1,1,1,0.28,0.2727,0.38,0.2239,1,53,54,53
1502,3/7/2011,1,0,3,22,0,1,1,1,0.26,0.2576,0.48,0.1642,1,34,35,34
1503,3/7/2011,1,0,3,23,0,1,1,1,0.28,0.3182,0.48,0,0,22,22,22
1504,3/8/2011,1,0,3,0,0,2,1,1,0.26,0.2879,0.48,0.0896,1,9,10,9
1505,3/8/2011,1,0,3,1,0,2,1,1,0.24,0.2424,0.52,0.1343,0,4,4,4
1506,3/8/2011,1,0,3,2,0,2,1,1,0.24,0.2424,0.52,0.1343,1,0,1,0
1507,3/8/2011,1,0,3,3,0,2,1,1,0.24,0.2576,0.52,0.0896,5,2,7,2
1508,3/8/2011,1,0,3,4,0,2,1,1,0.22,0.2727,0.64,0,0,2,2,2
1509,3/8/2011,1,0,3,5,0,2,1,1,0.2,0.2273,0.69,0.1045,2,8,10,8
1510,3/8/2011,1,0,3,6,0,2,1,1,0.2,0.2576,0.59,0,3,42,45,42
1511,3/8/2011,1,0,3,7,0,2,1,1,0.18,0.197,0.64,0.1343,9,119,128,119
1512,3/8/2011,1,0,3,8,0,2,1,1,0.22,0.2273,0.55,0.194,10,247,257,247
1513,3/8/2011,1,0,3,9,0,2,1,1,0.26,0.2576,0.41,0.1642,11,140,151,140
1514,3/8/2011,1,0,3,10,0,2,1,2,0.3,0.2879,0.33,0.194,25,46,71,46
1515,3/8/2011,1,0,3,11,0,2,1,2,0.36,0.3485,0.25,0.1642,26,52,78,52
1516,3/8/2011,1,0,3,12,0,2,1,2,0.36,0.3788,0.23,0,29,70,99,70
1517,3/8/2011,1,0,3,13,0,2,1,2,0.38,0.3939,0.25,0.1045,25,73,98,73
1518,3/8/2011,1,0,3,14,0,2,1,2,0.38,0.3939,0.2,0,16,56,72,56
1519,3/8/2011,1,0,3,15,0,2,1,2,0.36,0.3788,0.18,0,35,77,112,77
1520,3/8/2011,1,0,3,16,0,2,1,1,0.38,0.3939,0.27,0.1642,26,82,108,82
1521,3/8/2011,1,0,3,17,0,2,1,1,0.36,0.3485,0.27,0.2239,39,209,248,209
1522,3/8/2011,1,0,3,18,0,2,1,1,0.34,0.3333,0.27,0.194,21,214,235,214
1523,3/8/2011,1,0,3,19,0,2,1,1,0.34,0.3485,0.31,0.1045,9,141,150,141
1524,3/8/2011,1,0,3,20,0,2,1,1,0.32,0.3333,0.39,0.0896,2,74,76,74
1525,3/8/2011,1,0,3,21,0,2,1,1,0.3,0.2879,0.49,0.194,7,68,75,68
1526,3/8/2011,1,0,3,22,0,2,1,1,0.3,0.2879,0.49,0.2239,11,44,55,44
1527,3/8/2011,1,0,3,23,0,2,1,1,0.28,0.2727,0.61,0.194,3,38,41,38
1528,3/9/2011,1,0,3,0,0,3,1,1,0.26,0.2879,0.65,0.0896,0,9,9,9
1529,3/9/2011,1,0,3,1,0,3,1,1,0.26,0.2727,0.52,0.1343,0,4,4,4
1530,3/9/2011,1,0,3,2,0,3,1,1,0.26,0.2727,0.52,0.1343,1,1,2,1
1531,3/9/2011,1,0,3,3,0,3,1,1,0.24,0.2576,0.7,0.0896,1,2,3,2
1532,3/9/2011,1,0,3,4,0,3,1,1,0.24,0.2576,0.75,0.1045,0,2,2,2
1533,3/9/2011,1,0,3,5,0,3,1,2,0.24,0.2424,0.81,0.1343,1,7,8,7
1534,3/9/2011,1,0,3,6,0,3,1,2,0.24,0.2576,0.85,0.1045,5,44,49,44
1535,3/9/2011,1,0,3,7,0,3,1,2,0.24,0.2424,0.87,0.1642,18,123,141,123
1536,3/9/2011,1,0,3,8,0,3,1,2,0.24,0.2424,0.87,0.1343,11,238,249,238
1537,3/9/2011,1,0,3,9,0,3,1,2,0.26,0.2424,0.87,0.2537,5,136,141,136
1538,3/9/2011,1,0,3,10,0,3,1,2,0.3,0.2879,0.75,0.2537,8,49,57,49
1539,3/9/2011,1,0,3,11,0,3,1,2,0.32,0.2879,0.76,0.3881,15,44,59,44
1540,3/9/2011,1,0,3,12,0,3,1,2,0.32,0.303,0.76,0.2537,14,84,98,84
1541,3/9/2011,1,0,3,13,0,3,1,2,0.32,0.2879,0.76,0.3582,17,82,99,82
1542,3/9/2011,1,0,3,14,0,3,1,2,0.34,0.303,0.76,0.2985,10,61,71,61
1543,3/9/2011,1,0,3,15,0,3,1,2,0.36,0.3333,0.71,0.2985,15,64,79,64
1544,3/9/2011,1,0,3,16,0,3,1,2,0.34,0.303,0.76,0.3284,10,102,112,102
1545,3/9/2011,1,0,3,17,0,3,1,2,0.34,0.303,0.76,0.2985,18,176,194,176
1546,3/9/2011,1,0,3,18,0,3,1,2,0.34,0.3182,0.76,0.2537,12,176,188,176
1547,3/9/2011,1,0,3,19,0,3,1,2,0.34,0.303,0.76,0.3284,11,123,134,123
1548,3/9/2011,1,0,3,20,0,3,1,2,0.32,0.3182,0.87,0.194,4,87,91,87
1549,3/9/2011,1,0,3,21,0,3,1,2,0.32,0.303,0.93,0.3284,10,52,62,52
1550,3/9/2011,1,0,3,22,0,3,1,3,0.32,0.3182,0.93,0.1642,4,17,21,17
1551,3/9/2011,1,0,3,23,0,3,1,3,0.34,0.3333,0.93,0.194,1,17,18,17
1552,3/10/2011,1,0,3,0,0,4,1,3,0.34,0.3182,0,0.2537,3,0,3,0
1553,3/10/2011,1,0,3,1,0,4,1,3,0.34,0.3182,0,0.2537,0,2,2,2
1554,3/10/2011,1,0,3,2,0,4,1,3,0.34,0.3182,0,0.2537,0,1,1,1
1555,3/10/2011,1,0,3,5,0,4,1,3,0.36,0.3485,0,0.194,1,2,3,2
1556,3/10/2011,1,0,3,6,0,4,1,3,0.36,0.3333,0,0.3284,0,12,12,12
1557,3/10/2011,1,0,3,7,0,4,1,3,0.38,0.3939,0,0.2239,1,36,37,36
1558,3/10/2011,1,0,3,8,0,4,1,3,0.38,0.3939,0,0.2836,1,43,44,43
1559,3/10/2011,1,0,3,9,0,4,1,3,0.4,0.4091,0,0.2239,1,23,24,23
1560,3/10/2011,1,0,3,10,0,4,1,3,0.4,0.4091,0,0.1642,0,17,17,17
1561,3/10/2011,1,0,3,11,0,4,1,3,0.4,0.4091,0,0.2537,6,5,11,5
1562,3/10/2011,1,0,3,12,0,4,1,3,0.42,0.4242,0,0.2239,4,30,34,30
1563,3/10/2011,1,0,3,13,0,4,1,3,0.42,0.4242,0,0.2239,1,11,12,11
1564,3/10/2011,1,0,3,14,0,4,1,3,0.44,0.4394,0,0.2985,0,12,12,12
1565,3/10/2011,1,0,3,15,0,4,1,3,0.44,0.4394,0,0.2239,3,11,14,11
1566,3/10/2011,1,0,3,16,0,4,1,3,0.42,0.4242,0,0.2537,1,20,21,20
1567,3/10/2011,1,0,3,17,0,4,1,2,0.44,0.4394,0,0.3881,2,109,111,109
1568,3/10/2011,1,0,3,18,0,4,1,3,0.44,0.4394,0,0.3582,2,80,82,80
1569,3/10/2011,1,0,3,19,0,4,1,3,0.44,0.4394,0,0.5821,5,51,56,51
1570,3/10/2011,1,0,3,20,0,4,1,3,0.36,0.3333,0,0.3284,9,29,38,29
1571,3/10/2011,1,0,3,21,0,4,1,3,0.36,0.3485,0,0.2239,1,27,28,27
1572,3/10/2011,1,0,3,22,0,4,1,2,0.34,0.3333,0,0.1343,4,30,34,30
1573,3/10/2011,1,0,3,23,0,4,1,3,0.34,0.3485,0,0.0896,1,26,27,26
1574,3/11/2011,1,0,3,0,0,5,1,2,0.34,0.3485,1,0.0896,0,6,6,6
1575,3/11/2011,1,0,3,1,0,5,1,3,0.34,0.3485,1,0.1045,0,8,8,8
1576,3/11/2011,1,0,3,2,0,5,1,3,0.34,0.3485,1,0.1045,2,3,5,3
1577,3/11/2011,1,0,3,3,0,5,1,2,0.32,0.3333,0.93,0.0896,0,2,2,2
1578,3/11/2011,1,0,3,5,0,5,1,1,0.3,0.2879,0.81,0.2239,1,6,7,6
1579,3/11/2011,1,0,3,6,0,5,1,1,0.26,0.2424,0.81,0.2836,1,31,32,31
1580,3/11/2011,1,0,3,7,0,5,1,1,0.26,0.2576,0.7,0.194,10,104,114,104
1581,3/11/2011,1,0,3,8,0,5,1,1,0.28,0.2727,0.7,0.2537,15,244,259,244
1582,3/11/2011,1,0,3,9,0,5,1,2,0.3,0.2879,0.61,0.2836,13,143,156,143
1583,3/11/2011,1,0,3,10,0,5,1,2,0.32,0.303,0.57,0.2985,18,60,78,60
1584,3/11/2011,1,0,3,11,0,5,1,2,0.32,0.303,0.57,0.2985,14,67,81,67
1585,3/11/2011,1,0,3,12,0,5,1,2,0.34,0.3182,0.53,0.2537,15,96,111,96
1586,3/11/2011,1,0,3,13,0,5,1,1,0.36,0.3333,0.53,0.2537,15,92,107,92
1587,3/11/2011,1,0,3,14,0,5,1,2,0.36,0.3333,0.5,0.3582,25,64,89,64
1588,3/11/2011,1,0,3,15,0,5,1,2,0.34,0.3182,0.53,0.2537,21,64,85,64
1589,3/11/2011,1,0,3,16,0,5,1,2,0.34,0.303,0.49,0.2985,18,95,113,95
1590,3/11/2011,1,0,3,17,0,5,1,1,0.34,0.3182,0.49,0.2239,23,200,223,200
1591,3/11/2011,1,0,3,18,0,5,1,1,0.32,0.303,0.49,0.3284,19,134,153,134
1592,3/11/2011,1,0,3,19,0,5,1,1,0.3,0.2727,0.56,0.3284,7,111,118,111
1593,3/11/2011,1,0,3,20,0,5,1,1,0.3,0.303,0.56,0.1642,6,70,76,70
1594,3/11/2011,1,0,3,21,0,5,1,2,0.3,0.2879,0.52,0.2537,10,43,53,43
1595,3/11/2011,1,0,3,22,0,5,1,1,0.3,0.303,0.52,0.1642,11,53,64,53
1596,3/11/2011,1,0,3,23,0,5,1,1,0.3,0.2879,0.52,0.2537,3,34,37,34
1597,3/12/2011,1,0,3,0,0,6,0,1,0.26,0.2727,0.6,0.1343,4,30,34,30
1598,3/12/2011,1,0,3,1,0,6,0,1,0.24,0.2273,0.65,0.194,3,15,18,15
1599,3/12/2011,1,0,3,2,0,6,0,1,0.24,0.2273,0.65,0.194,0,14,14,14
1600,3/12/2011,1,0,3,3,0,6,0,1,0.24,0.2273,0.65,0.2537,1,6,7,6
1601,3/12/2011,1,0,3,4,0,6,0,1,0.24,0.2273,0.65,0.2537,0,1,1,1
1602,3/12/2011,1,0,3,5,0,6,0,1,0.22,0.2273,0.69,0.194,0,2,2,2
1603,3/12/2011,1,0,3,6,0,6,0,1,0.22,0.2121,0.75,0.2537,2,2,4,2
1604,3/12/2011,1,0,3,7,0,6,0,1,0.24,0.2273,0.7,0.194,4,19,23,19
1605,3/12/2011,1,0,3,8,0,6,0,1,0.26,0.2576,0.65,0.1642,9,44,53,44
1606,3/12/2011,1,0,3,9,0,6,0,1,0.28,0.2879,0.65,0.1045,25,76,101,76
1607,3/12/2011,1,0,3,10,0,6,0,1,0.32,0.303,0.66,0.2239,21,78,99,78
1608,3/12/2011,1,0,3,11,0,6,0,1,0.34,0.303,0.49,0.3284,36,83,119,83
1609,3/12/2011,1,0,3,12,0,6,0,1,0.34,0.3182,0.53,0.2836,51,107,158,107
1610,3/12/2011,1,0,3,13,0,6,0,1,0.36,0.3333,0.51,0.3582,62,95,157,95
1611,3/12/2011,1,0,3,14,0,6,0,1,0.4,0.4091,0.5,0.4478,70,96,166,96
1612,3/12/2011,1,0,3,15,0,6,0,1,0.42,0.4242,0.44,0.4925,81,101,182,101
1613,3/12/2011,1,0,3,16,0,6,0,1,0.46,0.4545,0.41,0.4478,100,144,244,144
1614,3/12/2011,1,0,3,17,0,6,0,1,0.46,0.4545,0.44,0.3284,99,114,213,114
1615,3/12/2011,1,0,3,18,0,6,0,1,0.42,0.4242,0.54,0.1642,54,91,145,91
1616,3/12/2011,1,0,3,19,0,6,0,1,0.42,0.4242,0.54,0.0896,26,86,112,86
1617,3/12/2011,1,0,3,20,0,6,0,1,0.4,0.4091,0.58,0.1045,22,64,86,64
1618,3/12/2011,1,0,3,21,0,6,0,1,0.38,0.3939,0.62,0,36,46,82,46
1619,3/12/2011,1,0,3,22,0,6,0,1,0.36,0.3788,0.71,0,7,56,63,56
1620,3/12/2011,1,0,3,23,0,6,0,1,0.38,0.3939,0.66,0.0896,11,38,49,38
1621,3/13/2011,1,0,3,0,0,0,0,1,0.38,0.3939,0.62,0.1045,3,35,38,35
1622,3/13/2011,1,0,3,1,0,0,0,1,0.36,0.3485,0.66,0.1343,10,23,33,23
1623,3/13/2011,1,0,3,3,0,0,0,1,0.34,0.3333,0.76,0.1343,6,17,23,17
1624,3/13/2011,1,0,3,4,0,0,0,1,0.34,0.3333,0.66,0.1642,4,9,13,9
1625,3/13/2011,1,0,3,5,0,0,0,1,0.36,0.3485,0.62,0.1343,0,3,3,3
1626,3/13/2011,1,0,3,6,0,0,0,1,0.34,0.3636,0.66,0,0,2,2,2
1627,3/13/2011,1,0,3,7,0,0,0,1,0.36,0.3485,0.62,0.194,2,8,10,8
1628,3/13/2011,1,0,3,8,0,0,0,1,0.4,0.4091,0.5,0.2985,11,23,34,23
1629,3/13/2011,1,0,3,9,0,0,0,1,0.4,0.4091,0.5,0.4179,8,36,44,36
1630,3/13/2011,1,0,3,10,0,0,0,1,0.42,0.4242,0.47,0.2537,36,86,122,86
1631,3/13/2011,1,0,3,11,0,0,0,1,0.44,0.4394,0.41,0.4179,88,93,181,93
1632,3/13/2011,1,0,3,12,0,0,0,1,0.46,0.4545,0.38,0.3881,74,120,194,120
1633,3/13/2011,1,0,3,13,0,0,0,1,0.46,0.4545,0.38,0.3881,97,124,221,124
1634,3/13/2011,1,0,3,14,0,0,0,1,0.46,0.4545,0.41,0.2985,144,106,250,106
1635,3/13/2011,1,0,3,15,0,0,0,1,0.48,0.4697,0.39,0.3284,149,155,304,155
1636,3/13/2011,1,0,3,16,0,0,0,1,0.46,0.4545,0.41,0.3881,124,132,256,132
1637,3/13/2011,1,0,3,17,0,0,0,1,0.44,0.4394,0.41,0.3582,98,143,241,143
1638,3/13/2011,1,0,3,18,0,0,0,1,0.4,0.4091,0.43,0.3582,55,92,147,92
1639,3/13/2011,1,0,3,19,0,0,0,1,0.36,0.3333,0.5,0.3582,28,73,101,73
1640,3/13/2011,1,0,3,20,0,0,0,1,0.32,0.303,0.57,0.2985,23,54,77,54
1641,3/13/2011,1,0,3,21,0,0,0,1,0.3,0.2879,0.56,0.2537,9,49,58,49
1642,3/13/2011,1,0,3,22,0,0,0,1,0.3,0.2727,0.56,0.3284,8,29,37,29
1643,3/13/2011,1,0,3,23,0,0,0,1,0.26,0.2576,0.65,0.2239,5,23,28,23
1644,3/14/2011,1,0,3,0,0,1,1,1,0.26,0.2727,0.65,0.1045,4,7,11,7
1645,3/14/2011,1,0,3,1,0,1,1,1,0.26,0.2879,0.65,0.0896,0,1,1,1
1646,3/14/2011,1,0,3,2,0,1,1,1,0.26,0.2879,0.65,0.0896,0,1,1,1
1647,3/14/2011,1,0,3,3,0,1,1,1,0.26,0.2727,0.65,0.1343,0,3,3,3
1648,3/14/2011,1,0,3,5,0,1,1,1,0.24,0.2424,0.7,0.1343,0,8,8,8
1649,3/14/2011,1,0,3,6,0,1,1,1,0.26,0.2727,0.65,0.1343,1,27,28,27
1650,3/14/2011,1,0,3,7,0,1,1,2,0.28,0.3182,0.61,0,4,84,88,84
1651,3/14/2011,1,0,3,8,0,1,1,2,0.3,0.303,0.56,0.1343,24,217,241,217
1652,3/14/2011,1,0,3,9,0,1,1,1,0.32,0.303,0.53,0.3284,13,127,140,127
1653,3/14/2011,1,0,3,10,0,1,1,1,0.34,0.3182,0.42,0.2537,27,57,84,57
1654,3/14/2011,1,0,3,11,0,1,1,1,0.36,0.3333,0.4,0.2537,26,45,71,45
1655,3/14/2011,1,0,3,12,0,1,1,1,0.38,0.3939,0.37,0,40,54,94,54
1656,3/14/2011,1,0,3,13,0,1,1,1,0.38,0.3939,0.36,0.3284,24,51,75,51
1657,3/14/2011,1,0,3,14,0,1,1,2,0.38,0.3939,0.34,0,27,52,79,52
1658,3/14/2011,1,0,3,15,0,1,1,1,0.38,0.3939,0.37,0.1642,24,77,101,77
1659,3/14/2011,1,0,3,16,0,1,1,1,0.4,0.4091,0.35,0.1045,27,80,107,80
1660,3/14/2011,1,0,3,17,0,1,1,1,0.38,0.3939,0.4,0.194,42,229,271,229
1661,3/14/2011,1,0,3,18,0,1,1,1,0.36,0.3636,0.4,0.1045,25,210,235,210
1662,3/14/2011,1,0,3,19,0,1,1,1,0.36,0.3485,0.43,0.1343,17,133,150,133
1663,3/14/2011,1,0,3,20,0,1,1,1,0.34,0.3182,0.46,0.2239,23,106,129,106
1664,3/14/2011,1,0,3,21,0,1,1,1,0.34,0.3333,0.46,0.1343,5,58,63,58
1665,3/14/2011,1,0,3,22,0,1,1,1,0.32,0.3333,0.49,0.1045,4,43,47,43
1666,3/14/2011,1,0,3,23,0,1,1,1,0.32,0.3485,0.53,0,2,17,19,17
1667,3/15/2011,1,0,3,0,0,2,1,1,0.32,0.3485,0.53,0,7,7,14,7
1668,3/15/2011,1,0,3,1,0,2,1,1,0.3,0.303,0.62,0.0896,4,6,10,6
1669,3/15/2011,1,0,3,2,0,2,1,1,0.3,0.303,0.62,0.0896,1,2,3,2
1670,3/15/2011,1,0,3,4,0,2,1,1,0.24,0.2576,0.75,0.0896,1,1,2,1
1671,3/15/2011,1,0,3,5,0,2,1,1,0.24,0.2273,0.75,0.194,0,11,11,11
1672,3/15/2011,1,0,3,6,0,2,1,1,0.22,0.2273,0.8,0.194,3,32,35,32
1673,3/15/2011,1,0,3,7,0,2,1,1,0.24,0.2424,0.75,0.1642,10,109,119,109
1674,3/15/2011,1,0,3,8,0,2,1,1,0.26,0.2879,0.7,0.0896,23,259,282,259
1675,3/15/2011,1,0,3,9,0,2,1,2,0.3,0.3333,0.7,0,10,147,157,147
1676,3/15/2011,1,0,3,10,0,2,1,2,0.32,0.3182,0.66,0.194,22,56,78,56
1677,3/15/2011,1,0,3,11,0,2,1,2,0.34,0.3182,0.57,0.2239,27,51,78,51
1678,3/15/2011,1,0,3,12,0,2,1,2,0.36,0.3485,0.5,0.2239,32,70,102,70
1679,3/15/2011,1,0,3,13,0,2,1,2,0.36,0.3333,0.57,0.2836,23,74,97,74
1680,3/15/2011,1,0,3,14,0,2,1,2,0.38,0.3939,0.46,0.2985,14,74,88,74
1681,3/15/2011,1,0,3,15,0,2,1,2,0.38,0.3939,0.43,0.2836,24,66,90,66
1682,3/15/2011,1,0,3,16,0,2,1,2,0.38,0.3939,0.46,0.3284,21,93,114,93
1683,3/15/2011,1,0,3,17,0,2,1,2,0.36,0.3485,0.62,0.194,22,195,217,195
1684,3/15/2011,1,0,3,18,0,2,1,2,0.36,0.3333,0.62,0.2985,18,207,225,207
1685,3/15/2011,1,0,3,19,0,2,1,2,0.34,0.3182,0.71,0.2836,14,138,152,138
1686,3/15/2011,1,0,3,20,0,2,1,2,0.34,0.3182,0.71,0.2836,9,79,88,79
1687,3/15/2011,1,0,3,21,0,2,1,3,0.32,0.3333,0.81,0.1045,2,53,55,53
1688,3/15/2011,1,0,3,22,0,2,1,2,0.32,0.3182,0.87,0.1642,1,20,21,20
1689,3/15/2011,1,0,3,23,0,2,1,2,0.32,0.3182,0.87,0.1642,1,17,18,17
1690,3/16/2011,1,0,3,0,0,3,1,3,0.3,0.2879,0.93,0.2537,0,8,8,8
1691,3/16/2011,1,0,3,1,0,3,1,3,0.3,0.2727,1,0.2985,1,2,3,2
1692,3/16/2011,1,0,3,3,0,3,1,2,0.28,0.2727,1,0.2239,1,2,3,2
1693,3/16/2011,1,0,3,4,0,3,1,2,0.3,0.303,0.93,0.1642,0,1,1,1
1694,3/16/2011,1,0,3,5,0,3,1,2,0.3,0.3182,0.93,0.1045,0,3,3,3
1695,3/16/2011,1,0,3,6,0,3,1,2,0.3,0.3182,0.93,0.1045,1,30,31,30
1696,3/16/2011,1,0,3,7,0,3,1,2,0.3,0.2879,0.93,0.194,10,101,111,101
1697,3/16/2011,1,0,3,8,0,3,1,2,0.32,0.3182,0.93,0,26,227,253,227
1698,3/16/2011,1,0,3,9,0,3,1,2,0.32,0.3333,0.93,0.1343,10,144,154,144
1699,3/16/2011,1,0,3,10,0,3,1,2,0.36,0.3485,0.81,0.1642,19,49,68,49
1700,3/16/2011,1,0,3,11,0,3,1,2,0.36,0.3485,0.81,0.1343,13,62,75,62
1701,3/16/2011,1,0,3,12,0,3,1,2,0.4,0.4091,0.71,0.1045,23,65,88,65
1702,3/16/2011,1,0,3,13,0,3,1,2,0.4,0.4091,0.76,0.1343,18,81,99,81
1703,3/16/2011,1,0,3,14,0,3,1,2,0.4,0.4091,0.76,0.2239,33,67,100,67
1704,3/16/2011,1,0,3,15,0,3,1,2,0.4,0.4091,0.76,0.2537,22,79,101,79
1705,3/16/2011,1,0,3,16,0,3,1,2,0.4,0.4091,0.76,0.1642,30,121,151,121
1706,3/16/2011,1,0,3,17,0,3,1,2,0.44,0.4394,0.54,0.2985,37,216,253,216
1707,3/16/2011,1,0,3,18,0,3,1,2,0.44,0.4394,0.54,0.2239,26,211,237,211
1708,3/16/2011,1,0,3,19,0,3,1,2,0.44,0.4394,0.51,0.3284,18,150,168,150
1709,3/16/2011,1,0,3,20,0,3,1,2,0.42,0.4242,0.54,0.2985,10,111,121,111
1710,3/16/2011,1,0,3,21,0,3,1,2,0.42,0.4242,0.58,0.2836,3,75,78,75
1711,3/16/2011,1,0,3,22,0,3,1,2,0.4,0.4091,0.62,0.3881,11,48,59,48
1712,3/16/2011,1,0,3,23,0,3,1,1,0.4,0.4091,0.65,0.194,9,18,27,18
1713,3/17/2011,1,0,3,0,0,4,1,1,0.38,0.3939,0.66,0.2537,4,19,23,19
1714,3/17/2011,1,0,3,1,0,4,1,1,0.36,0.3485,0.71,0.2239,1,11,12,11
1715,3/17/2011,1,0,3,2,0,4,1,1,0.34,0.303,0.71,0.2985,3,5,8,5
1716,3/17/2011,1,0,3,3,0,4,1,1,0.34,0.3333,0.66,0.1642,1,1,2,1
1717,3/17/2011,1,0,3,4,0,4,1,1,0.34,0.3333,0.71,0.194,0,3,3,3
1718,3/17/2011,1,0,3,5,0,4,1,1,0.32,0.3333,0.76,0.1045,0,13,13,13
1719,3/17/2011,1,0,3,6,0,4,1,1,0.32,0.3182,0.76,0.194,4,47,51,47
1720,3/17/2011,1,0,3,7,0,4,1,1,0.32,0.3333,0.76,0.1343,12,128,140,128
1721,3/17/2011,1,0,3,8,0,4,1,1,0.36,0.3485,0.66,0.1343,17,282,299,282
1722,3/17/2011,1,0,3,9,0,4,1,1,0.4,0.4091,0.62,0.2537,23,162,185,162
1723,3/17/2011,1,0,3,10,0,4,1,1,0.44,0.4394,0.54,0.3284,9,69,78,69
1724,3/17/2011,1,0,3,11,0,4,1,1,0.44,0.4394,0.54,0.2836,20,66,86,66
1725,3/17/2011,1,0,3,12,0,4,1,1,0.5,0.4848,0.45,0.2239,24,81,105,81
1726,3/17/2011,1,0,3,13,0,4,1,2,0.52,0.5,0.42,0.0896,26,85,111,85
1727,3/17/2011,1,0,3,14,0,4,1,1,0.5,0.4848,0.45,0.1045,32,87,119,87
1728,3/17/2011,1,0,3,15,0,4,1,1,0.52,0.5,0.42,0.2537,30,95,125,95
1729,3/17/2011,1,0,3,16,0,4,1,1,0.5,0.4848,0.48,0.2836,34,108,142,108
1730,3/17/2011,1,0,3,17,0,4,1,1,0.5,0.4848,0.42,0.194,48,265,313,265
1731,3/17/2011,1,0,3,18,0,4,1,2,0.46,0.4545,0.59,0.1642,50,260,310,260
1732,3/17/2011,1,0,3,19,0,4,1,1,0.44,0.4394,0.58,0.194,18,189,207,189
1733,3/17/2011,1,0,3,20,0,4,1,1,0.42,0.4242,0.67,0.2239,25,112,137,112
1734,3/17/2011,1,0,3,21,0,4,1,1,0.42,0.4242,0.62,0.2239,19,119,138,119
1735,3/17/2011,1,0,3,22,0,4,1,1,0.4,0.4091,0.66,0.2239,17,70,87,70
1736,3/17/2011,1,0,3,23,0,4,1,1,0.42,0.4242,0.62,0.2836,7,43,50,43
1737,3/18/2011,1,0,3,0,0,5,1,1,0.42,0.4242,0.58,0.2836,5,24,29,24
1738,3/18/2011,1,0,3,1,0,5,1,1,0.4,0.4091,0.62,0.2537,4,12,16,12
1739,3/18/2011,1,0,3,2,0,5,1,1,0.4,0.4091,0.62,0.194,5,9,14,9
1740,3/18/2011,1,0,3,3,0,5,1,1,0.36,0.3485,0.71,0.194,1,4,5,4
1741,3/18/2011,1,0,3,5,0,5,1,1,0.38,0.3939,0.66,0.1642,2,8,10,8
1742,3/18/2011,1,0,3,6,0,5,1,1,0.4,0.4091,0.66,0.194,1,35,36,35
1743,3/18/2011,1,0,3,7,0,5,1,1,0.4,0.4091,0.66,0.194,11,112,123,112
1744,3/18/2011,1,0,3,8,0,5,1,1,0.42,0.4242,0.67,0.2537,24,256,280,256
1745,3/18/2011,1,0,3,9,0,5,1,1,0.46,0.4545,0.63,0.2239,18,192,210,192
1746,3/18/2011,1,0,3,10,0,5,1,1,0.52,0.5,0.53,0.2836,43,74,117,74
1747,3/18/2011,1,0,3,11,0,5,1,1,0.54,0.5152,0.52,0.2836,55,104,159,104
1748,3/18/2011,1,0,3,12,0,5,1,2,0.56,0.5303,0.49,0.3582,72,123,195,123
1749,3/18/2011,1,0,3,13,0,5,1,1,0.64,0.6212,0.41,0.2836,57,118,175,118
1750,3/18/2011,1,0,3,14,0,5,1,1,0.66,0.6212,0.39,0.2537,71,103,174,103
1751,3/18/2011,1,0,3,15,0,5,1,2,0.68,0.6364,0.39,0.3582,62,111,173,111
1752,3/18/2011,1,0,3,16,0,5,1,1,0.68,0.6364,0.39,0.2836,67,137,204,137
1753,3/18/2011,1,0,3,17,0,5,1,1,0.7,0.6364,0.37,0.3284,95,237,332,237
1754,3/18/2011,1,0,3,18,0,5,1,1,0.68,0.6364,0.39,0.1642,84,247,331,247
1755,3/18/2011,1,0,3,19,0,5,1,1,0.66,0.6212,0.44,0.1343,58,132,190,132
1756,3/18/2011,1,0,3,20,0,5,1,1,0.62,0.6212,0.46,0.1343,46,103,149,103
1757,3/18/2011,1,0,3,21,0,5,1,1,0.62,0.6212,0.46,0.1045,22,91,113,91
1758,3/18/2011,1,0,3,22,0,5,1,1,0.62,0.6212,0.5,0.1642,55,63,118,63
1759,3/18/2011,1,0,3,23,0,5,1,2,0.6,0.6212,0.53,0.2239,26,60,86,60
1760,3/19/2011,1,0,3,0,0,6,0,2,0.6,0.6212,0.53,0.2537,26,50,76,50
1761,3/19/2011,1,0,3,1,0,6,0,2,0.58,0.5455,0.46,0.3582,16,35,51,35
1762,3/19/2011,1,0,3,2,0,6,0,2,0.56,0.5303,0.43,0.2239,5,20,25,20
1763,3/19/2011,1,0,3,3,0,6,0,2,0.54,0.5152,0.39,0.3284,1,7,8,7
1764,3/19/2011,1,0,3,4,0,6,0,1,0.52,0.5,0.34,0.4179,1,2,3,2
1765,3/19/2011,1,0,3,5,0,6,0,1,0.52,0.5,0.34,0.4179,0,2,2,2
1766,3/19/2011,1,0,3,6,0,6,0,1,0.44,0.4394,0.44,0.4179,0,10,10,10
1767,3/19/2011,1,0,3,7,0,6,0,1,0.4,0.4091,0.5,0.3284,4,9,13,9
1768,3/19/2011,1,0,3,8,0,6,0,1,0.42,0.4242,0.47,0.4925,11,37,48,37
1769,3/19/2011,1,0,3,9,0,6,0,1,0.42,0.4242,0.44,0.4627,35,41,76,41
1770,3/19/2011,1,0,3,10,0,6,0,1,0.44,0.4394,0.38,0.4179,55,85,140,85
1771,3/19/2011,1,0,3,11,0,6,0,1,0.46,0.4545,0.36,0.4478,90,106,196,106
1772,3/19/2011,1,0,3,12,0,6,0,1,0.46,0.4545,0.33,0.4179,126,141,267,141
1773,3/19/2011,1,0,3,13,0,6,0,1,0.5,0.4848,0.34,0.4627,174,127,301,127
1774,3/19/2011,1,0,3,14,0,6,0,1,0.5,0.4848,0.31,0.4925,168,144,312,144
1775,3/19/2011,1,0,3,15,0,6,0,1,0.5,0.4848,0.29,0.4179,170,143,313,143
1776,3/19/2011,1,0,3,16,0,6,0,1,0.5,0.4848,0.31,0.3881,175,129,304,129
1777,3/19/2011,1,0,3,17,0,6,0,1,0.48,0.4697,0.31,0.3284,138,140,278,140
1778,3/19/2011,1,0,3,18,0,6,0,1,0.46,0.4545,0.31,0.3284,92,125,217,125
1779,3/19/2011,1,0,3,19,0,6,0,1,0.44,0.4394,0.33,0.2836,38,116,154,116
1780,3/19/2011,1,0,3,20,0,6,0,1,0.42,0.4242,0.35,0.2239,39,69,108,69
1781,3/19/2011,1,0,3,21,0,6,0,1,0.4,0.4091,0.37,0.2985,20,73,93,73
1782,3/19/2011,1,0,3,22,0,6,0,1,0.4,0.4091,0.37,0.3284,27,45,72,45
1783,3/19/2011,1,0,3,23,0,6,0,1,0.38,0.3939,0.4,0.2985,13,37,50,37
1784,3/20/2011,1,0,3,0,0,0,0,1,0.34,0.303,0.49,0.4179,7,33,40,33
1785,3/20/2011,1,0,3,1,0,0,0,1,0.32,0.2879,0.53,0.3582,2,22,24,22
1786,3/20/2011,1,0,3,2,0,0,0,1,0.3,0.2879,0.52,0.2836,6,24,30,24
1787,3/20/2011,1,0,3,3,0,0,0,1,0.28,0.2727,0.56,0.2537,1,11,12,11
1788,3/20/2011,1,0,3,4,0,0,0,1,0.26,0.2576,0.56,0.2239,2,1,3,1
1789,3/20/2011,1,0,3,5,0,0,0,1,0.26,0.2576,0.6,0.194,3,6,9,6
1790,3/20/2011,1,0,3,6,0,0,0,1,0.26,0.2576,0.6,0.2239,1,3,4,3
1791,3/20/2011,1,0,3,7,0,0,0,1,0.24,0.2273,0.6,0.2239,5,9,14,9
1792,3/20/2011,1,0,3,8,0,0,0,1,0.28,0.2727,0.56,0.1642,7,30,37,30
1793,3/20/2011,1,0,3,9,0,0,0,1,0.3,0.303,0.52,0.1343,35,43,78,43
1794,3/20/2011,1,0,3,10,0,0,0,2,0.32,0.3485,0.45,0,55,81,136,81
1795,3/20/2011,1,0,3,11,0,0,0,1,0.34,0.3485,0.39,0.1045,92,111,203,111
1796,3/20/2011,1,0,3,12,0,0,0,1,0.36,0.3636,0.4,0.1045,120,108,228,108
1797,3/20/2011,1,0,3,13,0,0,0,1,0.38,0.3939,0.34,0,88,115,203,115
1798,3/20/2011,1,0,3,14,0,0,0,1,0.4,0.4091,0.3,0,145,134,279,134
1799,3/20/2011,1,0,3,15,0,0,0,1,0.4,0.4091,0.32,0.0896,172,136,308,136
1800,3/20/2011,1,0,3,16,0,0,0,1,0.42,0.4242,0.32,0,92,132,224,132
1801,3/20/2011,1,0,3,17,0,0,0,1,0.4,0.4091,0.35,0.2836,83,143,226,143
1802,3/20/2011,1,0,3,18,0,0,0,1,0.38,0.3939,0.4,0.3582,58,98,156,98
1803,3/20/2011,1,0,3,19,0,0,0,1,0.36,0.3333,0.43,0.2836,21,58,79,58
1804,3/20/2011,1,0,3,20,0,0,0,1,0.36,0.3333,0.46,0.2836,21,46,67,46
1805,3/20/2011,1,0,3,21,0,0,0,2,0.34,0.3182,0.53,0.2836,10,39,49,39
1806,3/20/2011,1,0,3,22,0,0,0,2,0.34,0.303,0.53,0.3284,8,30,38,30
1807,3/20/2011,1,0,3,23,0,0,0,3,0.34,0.303,0.61,0.3881,13,11,24,11
1808,3/21/2011,2,0,3,0,0,1,1,3,0.34,0.303,0.66,0.3881,2,11,13,11
1809,3/21/2011,2,0,3,1,0,1,1,2,0.34,0.303,0.71,0.3881,1,6,7,6
1810,3/21/2011,2,0,3,2,0,1,1,2,0.34,0.303,0.71,0.3284,1,5,6,5
1811,3/21/2011,2,0,3,3,0,1,1,2,0.34,0.303,0.71,0.3284,0,1,1,1
1812,3/21/2011,2,0,3,5,0,1,1,1,0.32,0.303,0.81,0.2985,1,1,2,1
1813,3/21/2011,2,0,3,6,0,1,1,3,0.32,0.303,0.76,0.2537,2,30,32,30
1814,3/21/2011,2,0,3,7,0,1,1,3,0.3,0.2727,0.87,0.4179,3,15,18,15
1815,3/21/2011,2,0,3,8,0,1,1,2,0.3,0.2727,0.87,0.4179,3,95,98,95
1816,3/21/2011,2,0,3,9,0,1,1,2,0.34,0.303,0.81,0.3284,12,115,127,115
1817,3/21/2011,2,0,3,10,0,1,1,2,0.38,0.3939,0.76,0.3881,17,45,62,45
1818,3/21/2011,2,0,3,11,0,1,1,2,0.42,0.4242,0.71,0.2985,32,47,79,47
1819,3/21/2011,2,0,3,12,0,1,1,2,0.44,0.4394,0.77,0.2537,25,56,81,56
1820,3/21/2011,2,0,3,13,0,1,1,2,0.5,0.4848,0.63,0.2239,35,77,112,77
1821,3/21/2011,2,0,3,14,0,1,1,2,0.54,0.5152,0.64,0.2239,36,65,101,65
1822,3/21/2011,2,0,3,15,0,1,1,2,0.56,0.5303,0.6,0.2239,41,66,107,66
1823,3/21/2011,2,0,3,16,0,1,1,2,0.54,0.5152,0.64,0.2836,29,112,141,112
1824,3/21/2011,2,0,3,17,0,1,1,2,0.54,0.5152,0.64,0.2537,41,231,272,231
1825,3/21/2011,2,0,3,18,0,1,1,2,0.52,0.5,0.72,0.2239,44,232,276,232
1826,3/21/2011,2,0,3,19,0,1,1,1,0.58,0.5455,0.6,0.4179,22,199,221,199
1827,3/21/2011,2,0,3,20,0,1,1,1,0.56,0.5303,0.64,0.194,16,106,122,106
1828,3/21/2011,2,0,3,21,0,1,1,1,0.46,0.4545,0.94,0.194,12,79,91,79
1829,3/21/2011,2,0,3,22,0,1,1,1,0.46,0.4545,0.88,0.2239,18,60,78,60
1830,3/21/2011,2,0,3,23,0,1,1,1,0.46,0.4545,0.88,0.0896,8,22,30,22
1831,3/22/2011,2,0,3,0,0,2,1,1,0.46,0.4545,0.88,0.194,4,7,11,7
1832,3/22/2011,2,0,3,1,0,2,1,1,0.42,0.4242,1,0.1343,6,13,19,13
1833,3/22/2011,2,0,3,2,0,2,1,1,0.44,0.4394,0.94,0.0896,0,1,1,1
1834,3/22/2011,2,0,3,3,0,2,1,1,0.44,0.4394,0.82,0.2239,3,2,5,2
1835,3/22/2011,2,0,3,4,0,2,1,2,0.42,0.4242,0.82,0.1642,0,1,1,1
1836,3/22/2011,2,0,3,5,0,2,1,2,0.4,0.4091,0.87,0.1343,1,11,12,11
1837,3/22/2011,2,0,3,6,0,2,1,1,0.4,0.4091,0.87,0.2537,2,58,60,58
1838,3/22/2011,2,0,3,7,0,2,1,2,0.4,0.4091,0.76,0.1045,4,132,136,132
1839,3/22/2011,2,0,3,8,0,2,1,2,0.4,0.4091,0.58,0.2985,24,312,336,312
1840,3/22/2011,2,0,3,9,0,2,1,2,0.4,0.4091,0.58,0.4627,19,159,178,159
1841,3/22/2011,2,0,3,10,0,2,1,2,0.44,0.4394,0.54,0.2985,29,95,124,95
1842,3/22/2011,2,0,3,11,0,2,1,1,0.44,0.4394,0.51,0.3284,22,64,86,64
1843,3/22/2011,2,0,3,12,0,2,1,1,0.46,0.4545,0.47,0.2537,35,86,121,86
1844,3/22/2011,2,0,3,13,0,2,1,1,0.5,0.4848,0.45,0.2239,21,85,106,85
1845,3/22/2011,2,0,3,14,0,2,1,1,0.5,0.4848,0.42,0.3284,30,71,101,71
1846,3/22/2011,2,0,3,15,0,2,1,1,0.5,0.4848,0.42,0.2239,55,79,134,79
1847,3/22/2011,2,0,3,16,0,2,1,1,0.5,0.4848,0.42,0.1045,40,125,165,125
1848,3/22/2011,2,0,3,17,0,2,1,1,0.5,0.4848,0.42,0.1045,42,265,307,265
1849,3/22/2011,2,0,3,18,0,2,1,1,0.48,0.4697,0.44,0.0896,41,271,312,271
1850,3/22/2011,2,0,3,19,0,2,1,2,0.44,0.4394,0.54,0.2537,22,142,164,142
1851,3/22/2011,2,0,3,20,0,2,1,2,0.44,0.4394,0.54,0.3582,19,116,135,116
1852,3/22/2011,2,0,3,21,0,2,1,2,0.42,0.4242,0.54,0.2836,24,63,87,63
1853,3/22/2011,2,0,3,22,0,2,1,2,0.4,0.4091,0.58,0.2537,13,57,70,57
1854,3/22/2011,2,0,3,23,0,2,1,2,0.4,0.4091,0.58,0.2537,4,28,32,28
1855,3/23/2011,2,0,3,0,0,3,1,3,0.36,0.3485,0.71,0.2239,3,8,11,8
1856,3/23/2011,2,0,3,1,0,3,1,3,0.34,0.3182,0.76,0.2239,0,7,7,7
1857,3/23/2011,2,0,3,2,0,3,1,3,0.34,0.3182,0.76,0.2239,1,1,2,1
1858,3/23/2011,2,0,3,3,0,3,1,2,0.34,0.3182,0.76,0.2537,0,3,3,3
1859,3/23/2011,2,0,3,5,0,3,1,3,0.32,0.3182,0.87,0.194,0,10,10,10
1860,3/23/2011,2,0,3,6,0,3,1,2,0.34,0.3182,0.87,0.2537,1,43,44,43
1861,3/23/2011,2,0,3,7,0,3,1,2,0.32,0.303,0.93,0.2239,7,111,118,111
1862,3/23/2011,2,0,3,8,0,3,1,2,0.32,0.3182,0.87,0.194,14,247,261,247
1863,3/23/2011,2,0,3,9,0,3,1,2,0.32,0.303,0.81,0.2537,8,174,182,174
1864,3/23/2011,2,0,3,10,0,3,1,2,0.34,0.3182,0.81,0.2836,15,60,75,60
1865,3/23/2011,2,0,3,11,0,3,1,2,0.34,0.3333,0.87,0.194,18,53,71,53
1866,3/23/2011,2,0,3,12,0,3,1,2,0.34,0.3182,0.87,0.2239,14,73,87,73
1867,3/23/2011,2,0,3,13,0,3,1,3,0.34,0.3333,0.87,0.1343,14,94,108,94
1868,3/23/2011,2,0,3,14,0,3,1,2,0.36,0.3636,0.87,0.1045,13,71,84,71
1869,3/23/2011,2,0,3,15,0,3,1,2,0.38,0.3939,0.82,0.2239,11,74,85,74
1870,3/23/2011,2,0,3,16,0,3,1,2,0.4,0.4091,0.76,0.2239,13,123,136,123
1871,3/23/2011,2,0,3,17,0,3,1,2,0.4,0.4091,0.76,0.2239,28,245,273,245
1872,3/23/2011,2,0,3,18,0,3,1,3,0.38,0.3939,0.82,0.2537,20,218,238,218
1873,3/23/2011,2,0,3,19,0,3,1,3,0.38,0.3939,0.82,0.2537,12,147,159,147
1874,3/23/2011,2,0,3,20,0,3,1,3,0.36,0.303,0.87,0.6418,3,72,75,72
1875,3/23/2011,2,0,3,21,0,3,1,3,0.32,0.2879,1,0.4179,0,22,22,22
1876,3/23/2011,2,0,3,22,0,3,1,2,0.32,0.3182,0.93,0.1642,6,38,44,38
1877,3/23/2011,2,0,3,23,0,3,1,3,0.32,0.3333,0.9,0,2,24,26,24
1878,3/24/2011,2,0,3,0,0,4,1,2,0.32,0.303,0.93,0.2239,0,11,11,11
1879,3/24/2011,2,0,3,1,0,4,1,2,0.3,0.2879,1,0.2239,0,3,3,3
1880,3/24/2011,2,0,3,2,0,4,1,2,0.3,0.2879,1,0.2537,0,6,6,6
1881,3/24/2011,2,0,3,3,0,4,1,2,0.28,0.2727,1,0.194,1,0,1,0
1882,3/24/2011,2,0,3,4,0,4,1,2,0.28,0.2727,1,0.194,0,1,1,1
1883,3/24/2011,2,0,3,5,0,4,1,2,0.28,0.2727,0.93,0.2239,1,8,9,8
1884,3/24/2011,2,0,3,6,0,4,1,2,0.28,0.2727,0.93,0.2239,0,41,41,41
1885,3/24/2011,2,0,3,7,0,4,1,3,0.26,0.2576,1,0.2239,2,106,108,106
1886,3/24/2011,2,0,3,8,0,4,1,3,0.26,0.2273,1,0.2985,4,120,124,120
1887,3/24/2011,2,0,3,9,0,4,1,2,0.26,0.2576,0.93,0.2239,3,94,97,94
1888,3/24/2011,2,0,3,10,0,4,1,2,0.26,0.2273,0.93,0.3284,10,55,65,55
1889,3/24/2011,2,0,3,11,0,4,1,2,0.3,0.2727,0.81,0.2985,10,61,71,61
1890,3/24/2011,2,0,3,12,0,4,1,2,0.3,0.2727,0.7,0.3284,12,82,94,82
1891,3/24/2011,2,0,3,13,0,4,1,2,0.32,0.303,0.7,0.2239,11,90,101,90
1892,3/24/2011,2,0,3,14,0,4,1,2,0.3,0.303,0.7,0.1343,17,66,83,66
1893,3/24/2011,2,0,3,15,0,4,1,2,0.3,0.2879,0.7,0.2537,13,77,90,77
1894,3/24/2011,2,0,3,16,0,4,1,2,0.3,0.2879,0.65,0.2239,6,78,84,78
1895,3/24/2011,2,0,3,17,0,4,1,2,0.3,0.2879,0.7,0.2239,12,221,233,221
1896,3/24/2011,2,0,3,18,0,4,1,2,0.3,0.2727,0.61,0.2985,17,197,214,197
1897,3/24/2011,2,0,3,19,0,4,1,1,0.3,0.2727,0.56,0.3881,16,122,138,122
1898,3/24/2011,2,0,3,20,0,4,1,1,0.28,0.2576,0.61,0.2836,8,110,118,110
1899,3/24/2011,2,0,3,21,0,4,1,1,0.26,0.2576,0.65,0.2239,11,67,78,67
1900,3/24/2011,2,0,3,22,0,4,1,1,0.26,0.2576,0.65,0.1642,3,59,62,59
1901,3/24/2011,2,0,3,23,0,4,1,1,0.24,0.2273,0.65,0.194,9,24,33,24
1902,3/25/2011,2,0,3,0,0,5,1,1,0.24,0.2273,0.6,0.194,1,17,18,17
1903,3/25/2011,2,0,3,1,0,5,1,1,0.2,0.2121,0.69,0.1642,0,5,5,5
1904,3/25/2011,2,0,3,2,0,5,1,1,0.2,0.197,0.69,0.2239,0,5,5,5
1905,3/25/2011,2,0,3,3,0,5,1,1,0.2,0.2273,0.69,0.1045,0,2,2,2
1906,3/25/2011,2,0,3,4,0,5,1,1,0.18,0.2121,0.74,0.1045,3,2,5,2
1907,3/25/2011,2,0,3,5,0,5,1,1,0.18,0.197,0.74,0.1642,0,9,9,9
1908,3/25/2011,2,0,3,6,0,5,1,1,0.18,0.1818,0.74,0.2239,0,32,32,32
1909,3/25/2011,2,0,3,7,0,5,1,1,0.2,0.1818,0.59,0.3582,4,100,104,100
1910,3/25/2011,2,0,3,8,0,5,1,1,0.22,0.2121,0.51,0.2836,9,228,237,228
1911,3/25/2011,2,0,3,9,0,5,1,1,0.24,0.2121,0.48,0.2985,16,150,166,150
1912,3/25/2011,2,0,3,10,0,5,1,1,0.26,0.2576,0.48,0,15,53,68,53
1913,3/25/2011,2,0,3,11,0,5,1,1,0.3,0.2879,0.45,0.2836,17,58,75,58
1914,3/25/2011,2,0,3,12,0,5,1,1,0.32,0.303,0.42,0.2537,37,108,145,108
1915,3/25/2011,2,0,3,13,0,5,1,1,0.32,0.3182,0.39,0.194,34,104,138,104
1916,3/25/2011,2,0,3,14,0,5,1,1,0.36,0.3333,0.32,0.3284,30,103,133,103
1917,3/25/2011,2,0,3,15,0,5,1,2,0.34,0.3182,0.36,0.2537,43,79,122,79
1918,3/25/2011,2,0,3,16,0,5,1,2,0.34,0.303,0.34,0.2985,23,127,150,127
1919,3/25/2011,2,0,3,17,0,5,1,2,0.32,0.2879,0.36,0.3582,23,202,225,202
1920,3/25/2011,2,0,3,18,0,5,1,1,0.3,0.2879,0.39,0.2537,8,190,198,190
1921,3/25/2011,2,0,3,19,0,5,1,2,0.3,0.2879,0.36,0.2836,9,126,135,126
1922,3/25/2011,2,0,3,20,0,5,1,2,0.3,0.303,0.39,0.1343,6,75,81,75
1923,3/25/2011,2,0,3,21,0,5,1,2,0.3,0.303,0.39,0.1642,11,64,75,64
1924,3/25/2011,2,0,3,22,0,5,1,2,0.28,0.2576,0.38,0.3284,3,40,43,40
1925,3/25/2011,2,0,3,23,0,5,1,2,0.26,0.2424,0.38,0.2836,8,31,39,31
1926,3/26/2011,2,0,3,0,0,6,0,2,0.26,0.2424,0.38,0.2836,3,25,28,25
1927,3/26/2011,2,0,3,1,0,6,0,1,0.26,0.2273,0.38,0.2985,3,24,27,24
1928,3/26/2011,2,0,3,2,0,6,0,1,0.22,0.2121,0.44,0.2239,4,21,25,21
1929,3/26/2011,2,0,3,3,0,6,0,1,0.2,0.197,0.47,0.194,2,7,9,7
1930,3/26/2011,2,0,3,4,0,6,0,1,0.22,0.2121,0.44,0.2239,2,4,6,4
1931,3/26/2011,2,0,3,5,0,6,0,1,0.2,0.197,0.51,0.194,0,8,8,8
1932,3/26/2011,2,0,3,6,0,6,0,1,0.18,0.1818,0.55,0.194,2,8,10,8
1933,3/26/2011,2,0,3,7,0,6,0,1,0.2,0.197,0.51,0.194,18,23,41,23
1934,3/26/2011,2,0,3,8,0,6,0,1,0.22,0.2273,0.44,0.1343,24,42,66,42
1935,3/26/2011,2,0,3,9,0,6,0,1,0.24,0.2424,0.41,0.1343,32,68,100,68
1936,3/26/2011,2,0,3,10,0,6,0,1,0.26,0.2576,0.41,0.1642,32,93,125,93
1937,3/26/2011,2,0,3,11,0,6,0,1,0.28,0.2727,0.38,0.1642,75,93,168,93
1938,3/26/2011,2,0,3,12,0,6,0,1,0.3,0.2879,0.36,0.194,98,129,227,129
1939,3/26/2011,2,0,3,13,0,6,0,1,0.32,0.303,0.33,0.2239,94,145,239,145
1940,3/26/2011,2,0,3,14,0,6,0,1,0.34,0.3182,0.29,0.2239,93,123,216,123
1941,3/26/2011,2,0,3,15,0,6,0,1,0.34,0.3333,0.29,0.194,110,109,219,109
1942,3/26/2011,2,0,3,16,0,6,0,1,0.34,0.3333,0.23,0.194,118,130,248,130
1943,3/26/2011,2,0,3,17,0,6,0,1,0.32,0.303,0.24,0.2239,102,101,203,101
1944,3/26/2011,2,0,3,18,0,6,0,2,0.32,0.3182,0.21,0.1642,64,89,153,89
1945,3/26/2011,2,0,3,19,0,6,0,2,0.28,0.2727,0.45,0.2537,45,93,138,93
1946,3/26/2011,2,0,3,20,0,6,0,2,0.28,0.2727,0.45,0.2537,18,67,85,67
1947,3/26/2011,2,0,3,21,0,6,0,2,0.26,0.2576,0.44,0.194,15,36,51,36
1948,3/26/2011,2,0,3,22,0,6,0,2,0.28,0.2727,0.41,0.2239,17,46,63,46
1949,3/26/2011,2,0,3,23,0,6,0,2,0.26,0.2424,0.44,0.2836,10,31,41,31
1950,3/27/2011,2,0,3,0,0,0,0,2,0.26,0.2576,0.41,0.1642,5,26,31,26
1951,3/27/2011,2,0,3,1,0,0,0,2,0.24,0.2273,0.52,0.194,3,17,20,17
1952,3/27/2011,2,0,3,2,0,0,0,3,0.22,0.2273,0.55,0.194,6,15,21,15
1953,3/27/2011,2,0,3,3,0,0,0,3,0.2,0.197,0.69,0.2239,0,14,14,14
1954,3/27/2011,2,0,3,4,0,0,0,3,0.18,0.197,0.74,0.1642,1,5,6,5
1955,3/27/2011,2,0,3,6,0,0,0,3,0.16,0.1818,0.86,0.1343,0,2,2,2
1956,3/27/2011,2,0,3,7,0,0,0,3,0.16,0.1667,0.86,0.1642,0,7,7,7
1957,3/27/2011,2,0,3,8,0,0,0,1,0.2,0.197,0.69,0.2239,6,8,14,8
1958,3/27/2011,2,0,3,9,0,0,0,1,0.22,0.2273,0.55,0.1343,17,37,54,37
1959,3/27/2011,2,0,3,10,0,0,0,2,0.22,0.2121,0.55,0.2239,27,59,86,59
1960,3/27/2011,2,0,3,11,0,0,0,2,0.24,0.2424,0.48,0.1642,23,85,108,85
1961,3/27/2011,2,0,3,12,0,0,0,2,0.26,0.2576,0.44,0.2239,43,120,163,120
1962,3/27/2011,2,0,3,13,0,0,0,1,0.3,0.2879,0.39,0.2239,47,100,147,100
1963,3/27/2011,2,0,3,14,0,0,0,1,0.32,0.3182,0.36,0.1642,61,103,164,103
1964,3/27/2011,2,0,3,15,0,0,0,1,0.32,0.303,0.36,0.2836,61,111,172,111
1965,3/27/2011,2,0,3,16,0,0,0,1,0.34,0.3333,0.34,0,45,98,143,98
1966,3/27/2011,2,0,3,17,0,0,0,1,0.32,0.303,0.31,0.2537,50,109,159,109
1967,3/27/2011,2,0,3,18,0,0,0,1,0.3,0.2879,0.33,0.194,32,105,137,105
1968,3/27/2011,2,0,3,19,0,0,0,1,0.3,0.2879,0.31,0.2239,23,80,103,80
1969,3/27/2011,2,0,3,20,0,0,0,1,0.28,0.2727,0.36,0.1642,7,50,57,50
1970,3/27/2011,2,0,3,21,0,0,0,1,0.26,0.2576,0.41,0.1642,7,29,36,29
1971,3/27/2011,2,0,3,22,0,0,0,1,0.26,0.2576,0.41,0.1642,5,25,30,25
1972,3/27/2011,2,0,3,23,0,0,0,1,0.26,0.2576,0.44,0.194,3,16,19,16
1973,3/28/2011,2,0,3,0,0,1,1,1,0.22,0.2273,0.55,0.194,1,11,12,11
1974,3/28/2011,2,0,3,1,0,1,1,1,0.22,0.2273,0.44,0.194,2,4,6,4
1975,3/28/2011,2,0,3,2,0,1,1,1,0.22,0.2273,0.44,0.1642,0,5,5,5
1976,3/28/2011,2,0,3,3,0,1,1,1,0.22,0.2273,0.44,0.1642,0,2,2,2
1977,3/28/2011,2,0,3,5,0,1,1,1,0.18,0.1818,0.43,0.194,0,8,8,8
1978,3/28/2011,2,0,3,6,0,1,1,1,0.18,0.1667,0.34,0.2836,0,40,40,40
1979,3/28/2011,2,0,3,7,0,1,1,1,0.2,0.1818,0.32,0.3284,6,104,110,104
1980,3/28/2011,2,0,3,8,0,1,1,1,0.2,0.197,0.34,0.2239,15,239,254,239
1981,3/28/2011,2,0,3,9,0,1,1,2,0.22,0.2121,0.32,0.2239,12,109,121,109
1982,3/28/2011,2,0,3,10,0,1,1,1,0.24,0.2273,0.3,0.194,22,47,69,47
1983,3/28/2011,2,0,3,11,0,1,1,2,0.26,0.2424,0.3,0.2836,18,39,57,39
1984,3/28/2011,2,0,3,12,0,1,1,2,0.26,0.2727,0.25,0,8,71,79,71
1985,3/28/2011,2,0,3,13,0,1,1,2,0.3,0.2879,0.24,0.2239,14,69,83,69
1986,3/28/2011,2,0,3,14,0,1,1,1,0.32,0.303,0.22,0.2239,15,65,80,65
1987,3/28/2011,2,0,3,15,0,1,1,1,0.32,0.303,0.24,0.2836,19,53,72,53
1988,3/28/2011,2,0,3,16,0,1,1,1,0.34,0.3182,0.23,0.2239,15,117,132,117
1989,3/28/2011,2,0,3,17,0,1,1,1,0.34,0.303,0.23,0.2985,25,227,252,227
1990,3/28/2011,2,0,3,18,0,1,1,1,0.32,0.303,0.21,0.2836,21,220,241,220
1991,3/28/2011,2,0,3,19,0,1,1,1,0.3,0.303,0.22,0.1343,17,156,173,156
1992,3/28/2011,2,0,3,20,0,1,1,1,0.32,0.3333,0.22,0.1045,5,107,112,107
1993,3/28/2011,2,0,3,21,0,1,1,1,0.32,0.3333,0.21,0.1343,6,55,61,55
1994,3/28/2011,2,0,3,22,0,1,1,1,0.3,0.2879,0.22,0.2239,0,40,40,40
1995,3/28/2011,2,0,3,23,0,1,1,1,0.28,0.2576,0.24,0.2985,1,18,19,18
1996,3/29/2011,2,0,3,0,0,2,1,1,0.26,0.2273,0.28,0.3284,1,15,16,15
1997,3/29/2011,2,0,3,1,0,2,1,1,0.24,0.2121,0.32,0.2985,0,4,4,4
1998,3/29/2011,2,0,3,2,0,2,1,1,0.24,0.2121,0.32,0.2985,0,3,3,3
1999,3/29/2011,2,0,3,3,0,2,1,1,0.24,0.2121,0.32,0.2985,2,1,3,1
2000,3/29/2011,2,0,3,4,0,2,1,1,0.2,0.2121,0.44,0.1642,1,1,2,1
2001,3/29/2011,2,0,3,5,0,2,1,1,0.22,0.2121,0.37,0.2537,0,8,8,8
2002,3/29/2011,2,0,3,6,0,2,1,1,0.22,0.2121,0.41,0.2985,4,46,50,46
2003,3/29/2011,2,0,3,7,0,2,1,1,0.22,0.197,0.41,0.3582,5,128,133,128
2004,3/29/2011,2,0,3,8,0,2,1,1,0.24,0.2121,0.35,0.3582,19,268,287,268
2005,3/29/2011,2,0,3,9,0,2,1,1,0.28,0.2576,0.28,0.3881,16,156,172,156
2006,3/29/2011,2,0,3,10,0,2,1,1,0.3,0.2727,0.24,0.2985,13,46,59,46
2007,3/29/2011,2,0,3,11,0,2,1,2,0.34,0.303,0.25,0.3881,18,63,81,63
2008,3/29/2011,2,0,3,12,0,2,1,1,0.34,0.3333,0.25,0.1642,29,77,106,77
2009,3/29/2011,2,0,3,13,0,2,1,1,0.34,0.303,0.25,0.2985,24,80,104,80
2010,3/29/2011,2,0,3,14,0,2,1,1,0.36,0.3333,0.25,0.2537,20,66,86,66
2011,3/29/2011,2,0,3,15,0,2,1,1,0.38,0.3939,0.25,0.2239,22,65,87,65
2012,3/29/2011,2,0,3,16,0,2,1,1,0.38,0.3939,0.22,0.1642,12,124,136,124
2013,3/29/2011,2,0,3,17,0,2,1,1,0.4,0.4091,0.2,0.1343,34,265,299,265
2014,3/29/2011,2,0,3,18,0,2,1,1,0.36,0.3636,0.21,0.0896,42,252,294,252
2015,3/29/2011,2,0,3,19,0,2,1,1,0.34,0.3333,0.23,0.194,20,170,190,170
2016,3/29/2011,2,0,3,20,0,2,1,1,0.36,0.3636,0.21,0.0896,13,119,132,119
2017,3/29/2011,2,0,3,21,0,2,1,1,0.34,0.3636,0.42,0,8,75,83,75
2018,3/29/2011,2,0,3,22,0,2,1,1,0.34,0.3636,0.49,0,6,49,55,49
2019,3/29/2011,2,0,3,23,0,2,1,2,0.32,0.3333,0.57,0.1045,8,27,35,27
2020,3/30/2011,2,0,3,0,0,3,1,2,0.32,0.3485,0.57,0,3,8,11,8
2021,3/30/2011,2,0,3,1,0,3,1,1,0.32,0.3485,0.39,0,1,9,10,9
2022,3/30/2011,2,0,3,2,0,3,1,2,0.32,0.3485,0.57,0,0,4,4,4
2023,3/30/2011,2,0,3,3,0,3,1,2,0.32,0.3485,0.49,0,0,4,4,4
2024,3/30/2011,2,0,3,4,0,3,1,2,0.32,0.3485,0.57,0,1,0,1,0
2025,3/30/2011,2,0,3,5,0,3,1,2,0.3,0.2879,0.56,0.194,0,7,7,7
2026,3/30/2011,2,0,3,6,0,3,1,2,0.3,0.303,0.49,0.1343,4,44,48,44
2027,3/30/2011,2,0,3,7,0,3,1,2,0.32,0.3333,0.45,0.1045,8,128,136,128
2028,3/30/2011,2,0,3,8,0,3,1,2,0.32,0.3182,0.49,0.1642,16,247,263,247
2029,3/30/2011,2,0,3,9,0,3,1,2,0.32,0.303,0.45,0.2239,7,147,154,147
2030,3/30/2011,2,0,3,10,0,3,1,2,0.34,0.3182,0.46,0.2239,13,51,64,51
2031,3/30/2011,2,0,3,11,0,3,1,2,0.34,0.3182,0.46,0.2537,26,64,90,64
2032,3/30/2011,2,0,3,12,0,3,1,2,0.34,0.3333,0.46,0.1642,15,65,80,65
2033,3/30/2011,2,0,3,13,0,3,1,2,0.36,0.3485,0.46,0.2239,14,84,98,84
2034,3/30/2011,2,0,3,14,0,3,1,2,0.36,0.3333,0.46,0.2985,16,64,80,64
2035,3/30/2011,2,0,3,15,0,3,1,3,0.28,0.2576,0.81,0.2985,14,56,70,56
2036,3/30/2011,2,0,3,16,0,3,1,3,0.28,0.2727,0.87,0.2537,0,36,36,36
2037,3/30/2011,2,0,3,17,0,3,1,3,0.26,0.2727,0.93,0.1045,11,105,116,105
2038,3/30/2011,2,0,3,18,0,3,1,2,0.26,0.2576,0.93,0.2239,6,79,85,79
2039,3/30/2011,2,0,3,19,0,3,1,2,0.26,0.2576,0.93,0.2239,5,67,72,67
2040,3/30/2011,2,0,3,20,0,3,1,3,0.24,0.2121,0.93,0.2985,4,40,44,40
2041,3/30/2011,2,0,3,21,0,3,1,2,0.24,0.2273,0.93,0.2537,0,27,27,27
2042,3/30/2011,2,0,3,22,0,3,1,3,0.24,0.2273,0.93,0.2239,3,21,24,21
2043,3/30/2011,2,0,3,23,0,3,1,3,0.24,0.2121,0.93,0.2836,1,11,12,11
2044,3/31/2011,2,0,3,0,0,4,1,3,0.24,0.2273,0.93,0.2239,0,3,3,3
2045,3/31/2011,2,0,3,1,0,4,1,3,0.24,0.2273,0.93,0.194,1,4,5,4
2046,3/31/2011,2,0,3,2,0,4,1,3,0.24,0.2273,0.93,0.194,0,5,5,5
2047,3/31/2011,2,0,3,3,0,4,1,3,0.24,0.2273,0.93,0.2239,0,1,1,1
2048,3/31/2011,2,0,3,4,0,4,1,3,0.24,0.2273,0.93,0.2537,0,2,2,2
2049,3/31/2011,2,0,3,5,0,4,1,3,0.24,0.2273,0.93,0.2239,0,8,8,8
2050,3/31/2011,2,0,3,6,0,4,1,3,0.24,0.2121,0.93,0.2985,2,34,36,34
2051,3/31/2011,2,0,3,7,0,4,1,3,0.24,0.2273,0.93,0.2537,5,87,92,87
2052,3/31/2011,2,0,3,8,0,4,1,2,0.24,0.2273,1,0.2537,7,185,192,185
2053,3/31/2011,2,0,3,9,0,4,1,3,0.26,0.2424,0.93,0.2537,6,126,132,126
2054,3/31/2011,2,0,3,10,0,4,1,3,0.26,0.2424,0.93,0.2537,15,54,69,54
2055,3/31/2011,2,0,3,11,0,4,1,3,0.28,0.2727,0.93,0.194,6,52,58,52
2056,3/31/2011,2,0,3,12,0,4,1,3,0.28,0.2727,0.93,0.194,17,73,90,73
2057,3/31/2011,2,0,3,13,0,4,1,3,0.3,0.303,0.87,0.1343,13,55,68,55
2058,3/31/2011,2,0,3,14,0,4,1,3,0.3,0.303,0.87,0.1343,27,49,76,49
2059,3/31/2011,2,0,3,15,0,4,1,3,0.3,0.2727,0.87,0.2985,4,61,65,61
2060,3/31/2011,2,0,3,16,0,4,1,2,0.3,0.2879,0.87,0.2537,13,72,85,72
2061,3/31/2011,2,0,3,17,0,4,1,2,0.3,0.2879,0.87,0.2537,15,153,168,153
2062,3/31/2011,2,0,3,18,0,4,1,2,0.3,0.303,0.87,0.1343,12,165,177,165
2063,3/31/2011,2,0,3,19,0,4,1,2,0.3,0.303,0.87,0.1343,12,118,130,118
2064,3/31/2011,2,0,3,20,0,4,1,3,0.28,0.2576,0.93,0.2836,6,79,85,79
2065,3/31/2011,2,0,3,21,0,4,1,2,0.28,0.2727,0.93,0.1642,7,53,60,53
2066,3/31/2011,2,0,3,22,0,4,1,3,0.28,0.2727,0.93,0.2537,7,44,51,44
2067,3/31/2011,2,0,3,23,0,4,1,3,0.26,0.2576,1,0.1642,4,23,27,23
2068,4/1/2011,2,0,4,0,0,5,1,3,0.26,0.2576,1,0.1642,0,6,6,6
2069,4/1/2011,2,0,4,1,0,5,1,3,0.26,0.2576,1,0.1642,0,4,4,4
2070,4/1/2011,2,0,4,2,0,5,1,3,0.26,0.2576,0.93,0.194,0,7,7,7
2071,4/1/2011,2,0,4,3,0,5,1,2,0.24,0.2273,0.93,0.2537,0,4,4,4
2072,4/1/2011,2,0,4,4,0,5,1,2,0.24,0.2273,0.93,0.2537,0,3,3,3
2073,4/1/2011,2,0,4,5,0,5,1,3,0.24,0.2273,0.93,0.2239,1,11,12,11
2074,4/1/2011,2,0,4,6,0,5,1,3,0.24,0.2273,0.93,0.2239,2,26,28,26
2075,4/1/2011,2,0,4,7,0,5,1,3,0.24,0.2424,0.93,0,4,91,95,91
2076,4/1/2011,2,0,4,8,0,5,1,2,0.26,0.2424,0.87,0.2537,8,198,206,198
2077,4/1/2011,2,0,4,9,0,5,1,1,0.32,0.2879,0.7,0.3582,11,162,173,162
2078,4/1/2011,2,0,4,10,0,5,1,1,0.32,0.303,0.66,0.2836,12,63,75,63
2079,4/1/2011,2,0,4,11,0,5,1,1,0.32,0.2879,0.61,0.3582,17,72,89,72
2080,4/1/2011,2,0,4,12,0,5,1,1,0.34,0.303,0.53,0.3582,15,80,95,80
2081,4/1/2011,2,0,4,13,0,5,1,1,0.36,0.3333,0.5,0.3582,18,92,110,92
2082,4/1/2011,2,0,4,14,0,5,1,2,0.36,0.3333,0.46,0.3582,26,61,87,61
2083,4/1/2011,2,0,4,15,0,5,1,1,0.34,0.303,0.46,0.4179,30,81,111,81
2084,4/1/2011,2,0,4,16,0,5,1,1,0.34,0.303,0.46,0.4179,42,125,167,125
2085,4/1/2011,2,0,4,17,0,5,1,1,0.34,0.303,0.46,0.3284,36,245,281,245
2086,4/1/2011,2,0,4,18,0,5,1,1,0.34,0.303,0.46,0.3284,36,205,241,205
2087,4/1/2011,2,0,4,19,0,5,1,1,0.34,0.303,0.49,0.3284,16,120,136,120
2088,4/1/2011,2,0,4,20,0,5,1,1,0.32,0.3182,0.53,0.194,2,75,77,75
2089,4/1/2011,2,0,4,21,0,5,1,1,0.32,0.3333,0.53,0.1343,9,84,93,84
2090,4/1/2011,2,0,4,22,0,5,1,1,0.3,0.303,0.56,0.1642,10,64,74,64
2091,4/1/2011,2,0,4,23,0,5,1,1,0.3,0.3182,0.61,0.0896,12,41,53,41
2092,4/2/2011,2,0,4,0,0,6,0,2,0.3,0.3333,0.61,0,3,29,32,29
2093,4/2/2011,2,0,4,1,0,6,0,1,0.26,0.2727,0.65,0.1343,4,28,32,28
2094,4/2/2011,2,0,4,2,0,6,0,1,0.24,0.2424,0.75,0.1343,1,20,21,20
2095,4/2/2011,2,0,4,3,0,6,0,1,0.24,0.2424,0.7,0.1642,1,8,9,8
2096,4/2/2011,2,0,4,4,0,6,0,1,0.24,0.2424,0.7,0.1642,0,5,5,5
2097,4/2/2011,2,0,4,5,0,6,0,2,0.24,0.2424,0.75,0.1642,1,4,5,4
2098,4/2/2011,2,0,4,6,0,6,0,1,0.26,0.2727,0.7,0.1045,5,7,12,7
2099,4/2/2011,2,0,4,7,0,6,0,2,0.26,0.2727,0.7,0.1045,2,16,18,16
2100,4/2/2011,2,0,4,8,0,6,0,1,0.3,0.3182,0.7,0.1045,10,45,55,45
2101,4/2/2011,2,0,4,9,0,6,0,2,0.34,0.3485,0.66,0.1045,22,65,87,65
2102,4/2/2011,2,0,4,10,0,6,0,2,0.36,0.3485,0.57,0.1642,41,113,154,113
2103,4/2/2011,2,0,4,11,0,6,0,2,0.4,0.4091,0.47,0.1642,72,126,198,126
2104,4/2/2011,2,0,4,12,0,6,0,3,0.32,0.3333,0.81,0.1343,84,100,184,100
2105,4/2/2011,2,0,4,13,0,6,0,1,0.34,0.3333,0.81,0.1343,56,81,137,81
2106,4/2/2011,2,0,4,14,0,6,0,3,0.32,0.303,0.76,0.3284,97,93,190,93
2107,4/2/2011,2,0,4,15,0,6,0,3,0.34,0.303,0.76,0.3881,72,64,136,64
2108,4/2/2011,2,0,4,16,0,6,0,1,0.38,0.3939,0.62,0.3284,111,85,196,85
2109,4/2/2011,2,0,4,17,0,6,0,1,0.38,0.3939,0.54,0.3582,89,95,184,95
2110,4/2/2011,2,0,4,18,0,6,0,1,0.38,0.3939,0.54,0.194,69,110,179,110
2111,4/2/2011,2,0,4,19,0,6,0,1,0.36,0.3333,0.53,0.3582,71,77,148,77
2112,4/2/2011,2,0,4,20,0,6,0,1,0.34,0.3182,0.53,0.2836,29,56,85,56
2113,4/2/2011,2,0,4,21,0,6,0,1,0.32,0.303,0.61,0.2537,24,53,77,53
2114,4/2/2011,2,0,4,22,0,6,0,1,0.32,0.303,0.61,0.2985,14,41,55,41
2115,4/2/2011,2,0,4,23,0,6,0,1,0.32,0.3182,0.61,0.1642,20,33,53,33
2116,4/3/2011,2,0,4,0,0,0,0,1,0.3,0.2879,0.65,0.194,8,31,39,31
2117,4/3/2011,2,0,4,1,0,0,0,1,0.3,0.3182,0.61,0.1045,8,26,34,26
2118,4/3/2011,2,0,4,2,0,0,0,1,0.26,0.2727,0.7,0.1343,5,19,24,19
2119,4/3/2011,2,0,4,3,0,0,0,1,0.3,0.3333,0.61,0,3,8,11,8
2120,4/3/2011,2,0,4,4,0,0,0,1,0.28,0.303,0.7,0.0896,3,0,3,0
2121,4/3/2011,2,0,4,5,0,0,0,1,0.28,0.2727,0.65,0.2239,1,4,5,4
2122,4/3/2011,2,0,4,6,0,0,0,1,0.28,0.2727,0.65,0.194,10,23,33,23
2123,4/3/2011,2,0,4,7,0,0,0,1,0.32,0.303,0.57,0.2239,13,20,33,20
2124,4/3/2011,2,0,4,8,0,0,0,1,0.34,0.3333,0.57,0.1642,18,44,62,44
2125,4/3/2011,2,0,4,9,0,0,0,1,0.36,0.3182,0.5,0.4925,68,74,142,74
2126,4/3/2011,2,0,4,10,0,0,0,1,0.4,0.4091,0.43,0.4179,111,104,215,104
2127,4/3/2011,2,0,4,11,0,0,0,1,0.42,0.4242,0.41,0.2537,139,104,243,104
2128,4/3/2011,2,0,4,12,0,0,0,1,0.44,0.4394,0.38,0.2836,166,147,313,147
2129,4/3/2011,2,0,4,13,0,0,0,1,0.44,0.4394,0.33,0.2985,219,148,367,148
2130,4/3/2011,2,0,4,14,0,0,0,1,0.46,0.4545,0.31,0.1343,240,109,349,109
2131,4/3/2011,2,0,4,15,0,0,0,2,0.46,0.4545,0.33,0,174,118,292,118
2132,4/3/2011,2,0,4,16,0,0,0,2,0.46,0.4545,0.31,0.194,147,156,303,156
2133,4/3/2011,2,0,4,17,0,0,0,2,0.46,0.4545,0.28,0.1343,148,126,274,126
2134,4/3/2011,2,0,4,18,0,0,0,2,0.46,0.4545,0.31,0,71,101,172,101
2135,4/3/2011,2,0,4,19,0,0,0,2,0.42,0.4242,0.44,0.194,51,93,144,93
2136,4/3/2011,2,0,4,20,0,0,0,3,0.42,0.4242,0.41,0.2239,24,55,79,55
2137,4/3/2011,2,0,4,21,0,0,0,2,0.42,0.4242,0.44,0.2239,8,37,45,37
2138,4/3/2011,2,0,4,22,0,0,0,1,0.4,0.4091,0.43,0.1045,7,29,36,29
2139,4/3/2011,2,0,4,23,0,0,0,1,0.4,0.4091,0.5,0.0896,9,22,31,22
2140,4/4/2011,2,0,4,0,0,1,1,1,0.4,0.4091,0.5,0.2239,1,5,6,5
2141,4/4/2011,2,0,4,1,0,1,1,1,0.4,0.4091,0.56,0.3582,7,4,11,4
2142,4/4/2011,2,0,4,2,0,1,1,1,0.38,0.3939,0.66,0.2537,1,1,2,1
2143,4/4/2011,2,0,4,3,0,1,1,1,0.38,0.3939,0.66,0.2836,1,0,1,0
2144,4/4/2011,2,0,4,4,0,1,1,1,0.38,0.3939,0.71,0.2985,1,1,2,1
2145,4/4/2011,2,0,4,5,0,1,1,1,0.4,0.4091,0.62,0.2537,0,7,7,7
2146,4/4/2011,2,0,4,6,0,1,1,1,0.42,0.4242,0.58,0.2836,3,43,46,43
2147,4/4/2011,2,0,4,7,0,1,1,2,0.44,0.4394,0.54,0.2537,7,150,157,150
2148,4/4/2011,2,0,4,8,0,1,1,2,0.46,0.4545,0.55,0.2985,31,308,339,308
2149,4/4/2011,2,0,4,9,0,1,1,2,0.5,0.4848,0.51,0.3881,24,134,158,134
2150,4/4/2011,2,0,4,10,0,1,1,2,0.54,0.5152,0.45,0.3582,35,55,90,55
2151,4/4/2011,2,0,4,11,0,1,1,1,0.6,0.6212,0.4,0.3881,58,66,124,66
2152,4/4/2011,2,0,4,12,0,1,1,1,0.64,0.6212,0.36,0.4627,59,98,157,98
2153,4/4/2011,2,0,4,13,0,1,1,1,0.68,0.6364,0.34,0.3284,47,92,139,92
2154,4/4/2011,2,0,4,14,0,1,1,2,0.74,0.6515,0.27,0.4925,47,76,123,76
2155,4/4/2011,2,0,4,15,0,1,1,1,0.76,0.6667,0.23,0.5522,47,96,143,96
2156,4/4/2011,2,0,4,16,0,1,1,1,0.76,0.6515,0.22,0.5224,59,130,189,130
2157,4/4/2011,2,0,4,17,0,1,1,1,0.74,0.6515,0.23,0.6119,83,283,366,283
2158,4/4/2011,2,0,4,18,0,1,1,2,0.72,0.6364,0.23,0.4925,78,308,386,308
2159,4/4/2011,2,0,4,19,0,1,1,1,0.7,0.6364,0.24,0.4627,51,227,278,227
2160,4/4/2011,2,0,4,20,0,1,1,2,0.7,0.6364,0.24,0.5522,40,133,173,133
2161,4/4/2011,2,0,4,21,0,1,1,2,0.7,0.6364,0.3,0.4478,19,76,95,76
2162,4/4/2011,2,0,4,22,0,1,1,2,0.68,0.6364,0.36,0.4627,17,58,75,58
2163,4/4/2011,2,0,4,23,0,1,1,2,0.64,0.6212,0.47,0.2239,18,30,48,30
2164,4/5/2011,2,0,4,0,0,2,1,1,0.62,0.6212,0.5,0.1045,10,12,22,12
2165,4/5/2011,2,0,4,1,0,2,1,3,0.62,0.6212,0.57,0.4179,10,5,15,5
2166,4/5/2011,2,0,4,2,0,2,1,2,0.54,0.5152,0.73,0.3284,0,5,5,5
2167,4/5/2011,2,0,4,3,0,2,1,2,0.54,0.5152,0.73,0.3284,1,3,4,3
2168,4/5/2011,2,0,4,4,0,2,1,3,0.5,0.4848,0.88,0.4925,0,2,2,2
2169,4/5/2011,2,0,4,5,0,2,1,3,0.46,0.4545,0.94,0.2985,0,5,5,5
2170,4/5/2011,2,0,4,6,0,2,1,2,0.48,0.4697,0.88,0.3284,2,36,38,36
2171,4/5/2011,2,0,4,7,0,2,1,2,0.48,0.4697,0.88,0.3284,10,124,134,124
2172,4/5/2011,2,0,4,8,0,2,1,3,0.38,0.3939,0.87,0.5821,9,148,157,148
2173,4/5/2011,2,0,4,9,0,2,1,3,0.36,0.3182,0.87,0.4925,2,44,46,44
2174,4/5/2011,2,0,4,10,0,2,1,3,0.34,0.303,0.81,0.3881,3,25,28,25
2175,4/5/2011,2,0,4,11,0,2,1,3,0.32,0.2879,0.81,0.4478,1,18,19,18
2176,4/5/2011,2,0,4,12,0,2,1,2,0.34,0.303,0.71,0.3881,6,32,38,32
2177,4/5/2011,2,0,4,13,0,2,1,2,0.36,0.3333,0.63,0.4179,5,51,56,51
2178,4/5/2011,2,0,4,14,0,2,1,2,0.36,0.3182,0.57,0.4925,9,67,76,67
2179,4/5/2011,2,0,4,15,0,2,1,1,0.4,0.4091,0.46,0.4627,6,62,68,62
2180,4/5/2011,2,0,4,16,0,2,1,1,0.38,0.3939,0.46,0.4179,17,113,130,113
2181,4/5/2011,2,0,4,17,0,2,1,1,0.42,0.4242,0.38,0.4179,27,246,273,246
2182,4/5/2011,2,0,4,18,0,2,1,1,0.38,0.3939,0.4,0.4925,19,248,267,248
2183,4/5/2011,2,0,4,19,0,2,1,1,0.36,0.3333,0.43,0.2985,12,148,160,148
2184,4/5/2011,2,0,4,20,0,2,1,1,0.34,0.3182,0.46,0.2836,4,87,91,87
2185,4/5/2011,2,0,4,21,0,2,1,1,0.34,0.2879,0.46,0.5224,8,81,89,81
2186,4/5/2011,2,0,4,22,0,2,1,1,0.32,0.303,0.49,0.2985,3,43,46,43
2187,4/5/2011,2,0,4,23,0,2,1,1,0.3,0.2879,0.49,0.2836,3,23,26,23
2188,4/6/2011,2,0,4,0,0,3,1,1,0.3,0.3182,0.49,0.1045,0,15,15,15
2189,4/6/2011,2,0,4,1,0,3,1,1,0.26,0.2727,0.6,0.1343,0,2,2,2
2190,4/6/2011,2,0,4,2,0,3,1,1,0.24,0.2424,0.7,0.1343,0,5,5,5
2191,4/6/2011,2,0,4,3,0,3,1,1,0.26,0.2727,0.6,0.1343,0,4,4,4
2192,4/6/2011,2,0,4,4,0,3,1,1,0.24,0.2424,0.65,0.1343,0,1,1,1
2193,4/6/2011,2,0,4,5,0,3,1,1,0.24,0.2576,0.7,0.1045,1,12,13,12
2194,4/6/2011,2,0,4,6,0,3,1,1,0.24,0.2576,0.7,0.1045,4,52,56,52
2195,4/6/2011,2,0,4,7,0,3,1,1,0.26,0.2727,0.65,0.1045,3,130,133,130
2196,4/6/2011,2,0,4,8,0,3,1,1,0.32,0.303,0.61,0.2239,17,308,325,308
2197,4/6/2011,2,0,4,9,0,3,1,1,0.36,0.3333,0.46,0.2537,8,157,165,157
2198,4/6/2011,2,0,4,10,0,3,1,1,0.4,0.4091,0.37,0.3881,21,48,69,48
2199,4/6/2011,2,0,4,11,0,3,1,1,0.42,0.4242,0.38,0.3881,23,70,93,70
2200,4/6/2011,2,0,4,12,0,3,1,1,0.44,0.4394,0.41,0.2537,22,112,134,112
2201,4/6/2011,2,0,4,13,0,3,1,1,0.46,0.4545,0.38,0.4925,29,83,112,83
2202,4/6/2011,2,0,4,14,0,3,1,1,0.5,0.4848,0.34,0.4179,35,80,115,80
2203,4/6/2011,2,0,4,15,0,3,1,1,0.52,0.5,0.32,0.3284,34,83,117,83
2204,4/6/2011,2,0,4,16,0,3,1,1,0.54,0.5152,0.28,0.4179,27,142,169,142
2205,4/6/2011,2,0,4,17,0,3,1,1,0.52,0.5,0.32,0.4478,53,303,356,303
2206,4/6/2011,2,0,4,18,0,3,1,1,0.52,0.5,0.29,0.3582,43,282,325,282
2207,4/6/2011,2,0,4,19,0,3,1,1,0.5,0.4848,0.31,0.2985,36,196,232,196
2208,4/6/2011,2,0,4,20,0,3,1,1,0.46,0.4545,0.51,0.2239,15,126,141,126
2209,4/6/2011,2,0,4,21,0,3,1,1,0.46,0.4545,0.41,0.2836,18,84,102,84
2210,4/6/2011,2,0,4,22,0,3,1,1,0.46,0.4545,0.41,0.2836,13,71,84,71
2211,4/6/2011,2,0,4,23,0,3,1,1,0.46,0.4545,0.41,0.2985,11,29,40,29
2212,4/7/2011,2,0,4,0,0,4,1,1,0.46,0.4545,0.41,0.2836,5,15,20,15
2213,4/7/2011,2,0,4,1,0,4,1,1,0.42,0.4242,0.47,0.1343,2,11,13,11
2214,4/7/2011,2,0,4,2,0,4,1,1,0.42,0.4242,0.54,0,0,7,7,7
2215,4/7/2011,2,0,4,3,0,4,1,1,0.36,0.3485,0.66,0.194,0,3,3,3
2216,4/7/2011,2,0,4,4,0,4,1,1,0.34,0.3333,0.76,0.194,0,1,1,1
2217,4/7/2011,2,0,4,5,0,4,1,1,0.34,0.3182,0.76,0.2239,0,6,6,6
2218,4/7/2011,2,0,4,6,0,4,1,1,0.32,0.303,0.81,0.2537,5,59,64,59
2219,4/7/2011,2,0,4,7,0,4,1,2,0.34,0.3333,0.76,0.1642,8,152,160,152
2220,4/7/2011,2,0,4,8,0,4,1,1,0.36,0.3485,0.76,0.194,23,291,314,291
2221,4/7/2011,2,0,4,9,0,4,1,2,0.4,0.4091,0.66,0.1343,15,155,170,155
2222,4/7/2011,2,0,4,10,0,4,1,2,0.42,0.4242,0.67,0.1045,29,66,95,66
2223,4/7/2011,2,0,4,11,0,4,1,2,0.46,0.4545,0.55,0,36,86,122,86
2224,4/7/2011,2,0,4,12,0,4,1,2,0.46,0.4545,0.55,0,39,114,153,114
2225,4/7/2011,2,0,4,13,0,4,1,2,0.52,0.5,0.48,0.0896,36,99,135,99
2226,4/7/2011,2,0,4,14,0,4,1,1,0.56,0.5303,0.43,0.0896,46,111,157,111
2227,4/7/2011,2,0,4,15,0,4,1,1,0.6,0.6212,0.38,0.1045,27,133,160,133
2228,4/7/2011,2,0,4,16,0,4,1,1,0.6,0.6212,0.35,0,52,161,213,161
2229,4/7/2011,2,0,4,17,0,4,1,1,0.52,0.5,0.52,0.2836,63,280,343,280
2230,4/7/2011,2,0,4,18,0,4,1,1,0.48,0.4697,0.55,0.2537,68,265,333,265
2231,4/7/2011,2,0,4,19,0,4,1,1,0.46,0.4545,0.59,0.2985,34,192,226,192
2232,4/7/2011,2,0,4,20,0,4,1,1,0.44,0.4394,0.62,0.1642,37,166,203,166
2233,4/7/2011,2,0,4,21,0,4,1,2,0.44,0.4394,0.67,0.2836,19,89,108,89
2234,4/7/2011,2,0,4,22,0,4,1,2,0.4,0.4091,0.76,0.194,18,63,81,63
2235,4/7/2011,2,0,4,23,0,4,1,1,0.38,0.3939,0.76,0.2537,9,45,54,45
2236,4/8/2011,2,0,4,0,0,5,1,2,0.36,0.3485,0.76,0.2239,4,21,25,21
2237,4/8/2011,2,0,4,1,0,5,1,2,0.34,0.3333,0.76,0.1343,3,6,9,6
2238,4/8/2011,2,0,4,2,0,5,1,3,0.34,0.3333,0.76,0.1642,3,10,13,10
2239,4/8/2011,2,0,4,3,0,5,1,3,0.34,0.3333,0.76,0.1642,0,1,1,1
2240,4/8/2011,2,0,4,4,0,5,1,2,0.34,0.3333,0.86,0.1343,0,1,1,1
2241,4/8/2011,2,0,4,5,0,5,1,2,0.32,0.3182,0.87,0.194,1,8,9,8
2242,4/8/2011,2,0,4,6,0,5,1,2,0.34,0.3636,0.87,0,2,33,35,33
2243,4/8/2011,2,0,4,7,0,5,1,3,0.34,0.3333,0.87,0.1642,4,109,113,109
2244,4/8/2011,2,0,4,8,0,5,1,3,0.34,0.3333,0.87,0.1642,13,208,221,208
2245,4/8/2011,2,0,4,9,0,5,1,2,0.36,0.3485,0.76,0.194,17,168,185,168
2246,4/8/2011,2,0,4,10,0,5,1,2,0.36,0.3333,0.71,0.2836,10,63,73,63
2247,4/8/2011,2,0,4,11,0,5,1,2,0.4,0.4091,0.62,0.3881,19,79,98,79
2248,4/8/2011,2,0,4,12,0,5,1,3,0.38,0.3939,0.66,0.2239,29,51,80,51
2249,4/8/2011,2,0,4,13,0,5,1,3,0.36,0.3333,0.76,0.2836,7,35,42,35
2250,4/8/2011,2,0,4,14,0,5,1,3,0.34,0.3182,0.87,0.2239,2,13,15,13
2251,4/8/2011,2,0,4,15,0,5,1,3,0.34,0.3182,0.87,0.2239,1,24,25,24
2252,4/8/2011,2,0,4,16,0,5,1,2,0.32,0.303,0.93,0.2537,2,58,60,58
2253,4/8/2011,2,0,4,17,0,5,1,3,0.32,0.303,0.93,0.2537,10,138,148,138
2254,4/8/2011,2,0,4,18,0,5,1,3,0.32,0.303,0.93,0.2537,8,54,62,54
2255,4/8/2011,2,0,4,19,0,5,1,3,0.3,0.2727,0.93,0.4179,1,52,53,52
2256,4/8/2011,2,0,4,20,0,5,1,2,0.3,0.2727,0.93,0.3284,12,51,63,51
2257,4/8/2011,2,0,4,21,0,5,1,2,0.3,0.2879,0.93,0.2537,11,43,54,43
2258,4/8/2011,2,0,4,22,0,5,1,2,0.3,0.2727,0.93,0.2985,9,42,51,42
2259,4/8/2011,2,0,4,23,0,5,1,2,0.3,0.2879,0.93,0.2239,4,31,35,31
2260,4/9/2011,2,0,4,0,0,6,0,2,0.3,0.2879,0.87,0.2239,5,26,31,26
2261,4/9/2011,2,0,4,1,0,6,0,2,0.3,0.303,0.87,0.1343,3,17,20,17
2262,4/9/2011,2,0,4,2,0,6,0,2,0.32,0.303,0.87,0.2239,2,15,17,15
2263,4/9/2011,2,0,4,3,0,6,0,3,0.3,0.2879,1,0.2537,3,11,14,11
2264,4/9/2011,2,0,4,4,0,6,0,3,0.3,0.2727,1,0.2537,0,3,3,3
2265,4/9/2011,2,0,4,5,0,6,0,2,0.3,0.2879,0.93,0.2239,0,5,5,5
2266,4/9/2011,2,0,4,6,0,6,0,2,0.3,0.2879,0.93,0.194,0,13,13,13
2267,4/9/2011,2,0,4,7,0,6,0,2,0.3,0.303,0.93,0.1642,8,13,21,13
2268,4/9/2011,2,0,4,8,0,6,0,2,0.32,0.303,0.93,0.1642,7,47,54,47
2269,4/9/2011,2,0,4,9,0,6,0,2,0.34,0.3485,0.87,0.1045,27,71,98,71
2270,4/9/2011,2,0,4,10,0,6,0,2,0.34,0.3333,0.87,0.1343,43,90,133,90
2271,4/9/2011,2,0,4,11,0,6,0,2,0.36,0.3636,0.81,0,51,91,142,91
2272,4/9/2011,2,0,4,12,0,6,0,2,0.36,0.3485,0.81,0.1343,79,123,202,123
2273,4/9/2011,2,0,4,13,0,6,0,2,0.36,0.3788,0.81,0,114,108,222,108
2274,4/9/2011,2,0,4,14,0,6,0,2,0.36,0.3485,0.81,0.1343,94,118,212,118
2275,4/9/2011,2,0,4,15,0,6,0,2,0.36,0.3788,0.87,0,85,116,201,116
2276,4/9/2011,2,0,4,16,0,6,0,2,0.38,0.3939,0.82,0,73,118,191,118
2277,4/9/2011,2,0,4,17,0,6,0,2,0.38,0.3939,0.82,0.0896,128,129,257,129
2278,4/9/2011,2,0,4,18,0,6,0,2,0.38,0.3939,0.82,0.1045,48,129,177,129
2279,4/9/2011,2,0,4,19,0,6,0,2,0.38,0.3939,0.82,0.1343,47,83,130,83
2280,4/9/2011,2,0,4,20,0,6,0,2,0.38,0.3939,0.87,0.1642,19,74,93,74
2281,4/9/2011,2,0,4,21,0,6,0,2,0.36,0.3485,0.93,0.1343,10,65,75,65
2282,4/9/2011,2,0,4,22,0,6,0,2,0.36,0.3485,0.93,0.1343,21,66,87,66
2283,4/9/2011,2,0,4,23,0,6,0,2,0.38,0.3939,0.87,0.0896,12,45,57,45
2284,4/10/2011,2,0,4,0,0,0,0,2,0.38,0.3939,0.87,0.0896,5,48,53,48
2285,4/10/2011,2,0,4,1,0,0,0,2,0.38,0.3939,0.87,0.1343,6,31,37,31
2286,4/10/2011,2,0,4,2,0,0,0,2,0.38,0.3939,0.87,0.0896,12,24,36,24
2287,4/10/2011,2,0,4,3,0,0,0,2,0.38,0.3939,0.87,0.1343,5,11,16,11
2288,4/10/2011,2,0,4,4,0,0,0,2,0.36,0.3636,0.93,0.1045,3,2,5,2
2289,4/10/2011,2,0,4,5,0,0,0,2,0.36,0.3636,0.93,0.0896,0,4,4,4
2290,4/10/2011,2,0,4,6,0,0,0,2,0.36,0.3636,0.93,0.0896,0,4,4,4
2291,4/10/2011,2,0,4,7,0,0,0,2,0.36,0.3636,1,0.0896,3,7,10,7
2292,4/10/2011,2,0,4,8,0,0,0,2,0.38,0.3939,0.94,0.0896,17,38,55,38
2293,4/10/2011,2,0,4,9,0,0,0,2,0.38,0.3939,0.94,0.1343,31,50,81,50
2294,4/10/2011,2,0,4,10,0,0,0,2,0.4,0.4091,0.87,0,69,81,150,81
2295,4/10/2011,2,0,4,11,0,0,0,2,0.4,0.4091,0.87,0.1343,93,109,202,109
2296,4/10/2011,2,0,4,12,0,0,0,2,0.42,0.4242,0.88,0.1343,94,136,230,136
2297,4/10/2011,2,0,4,13,0,0,0,1,0.46,0.4545,0.82,0.1045,121,142,263,142
2298,4/10/2011,2,0,4,14,0,0,0,1,0.5,0.4848,0.72,0.194,148,133,281,133
2299,4/10/2011,2,0,4,15,0,0,0,1,0.5,0.4848,0.77,0.2239,156,141,297,141
2300,4/10/2011,2,0,4,16,0,0,0,2,0.52,0.5,0.72,0.1642,135,153,288,153
2301,4/10/2011,2,0,4,17,0,0,0,2,0.52,0.5,0.72,0.194,84,152,236,152
2302,4/10/2011,2,0,4,18,0,0,0,1,0.5,0.4848,0.77,0.194,103,137,240,137
2303,4/10/2011,2,0,4,19,0,0,0,1,0.5,0.4848,0.77,0.194,47,84,131,84
2304,4/10/2011,2,0,4,20,0,0,0,1,0.46,0.4545,0.82,0.1343,21,71,92,71
2305,4/10/2011,2,0,4,21,0,0,0,1,0.44,0.4394,0.88,0.194,18,77,95,77
2306,4/10/2011,2,0,4,22,0,0,0,1,0.44,0.4394,0.94,0.2537,12,45,57,45
2307,4/10/2011,2,0,4,23,0,0,0,1,0.46,0.4545,0.88,0.3582,5,27,32,27
2308,4/11/2011,2,0,4,0,0,1,1,1,0.48,0.4697,0.88,0.3284,7,16,23,16
2309,4/11/2011,2,0,4,1,0,1,1,1,0.46,0.4545,0.94,0.2836,1,3,4,3
2310,4/11/2011,2,0,4,2,0,1,1,1,0.46,0.4545,0.94,0.2836,7,2,9,2
2311,4/11/2011,2,0,4,4,0,1,1,1,0.46,0.4545,0.94,0.194,0,1,1,1
2312,4/11/2011,2,0,4,5,0,1,1,1,0.46,0.4545,0.94,0.194,1,12,13,12
2313,4/11/2011,2,0,4,6,0,1,1,2,0.46,0.4545,1,0.2239,2,59,61,59
2314,4/11/2011,2,0,4,7,0,1,1,2,0.5,0.4848,0.88,0.2239,12,164,176,164
2315,4/11/2011,2,0,4,8,0,1,1,2,0.52,0.5,0.88,0.2836,28,286,314,286
2316,4/11/2011,2,0,4,9,0,1,1,2,0.56,0.5303,0.83,0.2836,33,132,165,132
2317,4/11/2011,2,0,4,10,0,1,1,2,0.56,0.5303,0.83,0.2985,41,55,96,55
2318,4/11/2011,2,0,4,11,0,1,1,2,0.6,0.5909,0.73,0.2985,45,59,104,59
2319,4/11/2011,2,0,4,12,0,1,1,2,0.6,0.5909,0.73,0.3284,37,97,134,97
2320,4/11/2011,2,0,4,13,0,1,1,2,0.64,0.6061,0.69,0.4179,62,77,139,77
2321,4/11/2011,2,0,4,14,0,1,1,2,0.72,0.6667,0.54,0.3582,60,85,145,85
2322,4/11/2011,2,0,4,15,0,1,1,1,0.74,0.6667,0.48,0.5224,56,85,141,85
2323,4/11/2011,2,0,4,16,0,1,1,1,0.74,0.6667,0.48,0.5224,73,162,235,162
2324,4/11/2011,2,0,4,17,0,1,1,1,0.74,0.6667,0.48,0.5224,100,352,452,352
2325,4/11/2011,2,0,4,18,0,1,1,1,0.72,0.6667,0.51,0.3881,93,290,383,290
2326,4/11/2011,2,0,4,19,0,1,1,1,0.72,0.6667,0.51,0.4478,73,211,284,211
2327,4/11/2011,2,0,4,20,0,1,1,1,0.68,0.6364,0.57,0.5224,44,122,166,122
2328,4/11/2011,2,0,4,21,0,1,1,1,0.66,0.6212,0.61,0.2537,39,119,158,119
2329,4/11/2011,2,0,4,22,0,1,1,2,0.64,0.6212,0.5,0.2836,25,66,91,66
2330,4/11/2011,2,0,4,23,0,1,1,3,0.58,0.5455,0.6,0,16,38,54,38
2331,4/12/2011,2,0,4,0,0,2,1,2,0.62,0.6212,0.5,0.1045,11,13,24,13
2332,4/12/2011,2,0,4,1,0,2,1,2,0.62,0.6212,0.5,0.0896,6,7,13,7
2333,4/12/2011,2,0,4,2,0,2,1,2,0.6,0.6212,0.53,0.1343,7,7,14,7
2334,4/12/2011,2,0,4,3,0,2,1,2,0.58,0.5455,0.56,0.1343,0,1,1,1
2335,4/12/2011,2,0,4,4,0,2,1,2,0.56,0.5303,0.64,0.1343,4,2,6,2
2336,4/12/2011,2,0,4,5,0,2,1,2,0.54,0.5152,0.68,0.1343,1,15,16,15
2337,4/12/2011,2,0,4,6,0,2,1,2,0.54,0.5152,0.68,0.2836,3,55,58,55
2338,4/12/2011,2,0,4,7,0,2,1,2,0.54,0.5152,0.68,0.2239,12,177,189,177
2339,4/12/2011,2,0,4,8,0,2,1,3,0.48,0.4697,0.88,0.3881,15,211,226,211
2340,4/12/2011,2,0,4,9,0,2,1,3,0.46,0.4545,0.94,0.4925,4,50,54,50
2341,4/12/2011,2,0,4,10,0,2,1,3,0.5,0.4848,0.82,0.4179,6,34,40,34
2342,4/12/2011,2,0,4,11,0,2,1,1,0.52,0.5,0.77,0.3582,11,38,49,38
2343,4/12/2011,2,0,4,12,0,2,1,2,0.56,0.5303,0.64,0.4627,9,83,92,83
2344,4/12/2011,2,0,4,13,0,2,1,3,0.54,0.5152,0.68,0.2836,22,84,106,84
2345,4/12/2011,2,0,4,14,0,2,1,2,0.5,0.4848,0.82,0.2836,16,28,44,28
2346,4/12/2011,2,0,4,15,0,2,1,2,0.48,0.4697,0.77,0.5224,24,54,78,54
2347,4/12/2011,2,0,4,16,0,2,1,2,0.48,0.4697,0.77,0.3881,19,80,99,80
2348,4/12/2011,2,0,4,17,0,2,1,3,0.44,0.4394,0.77,0.2239,29,262,291,262
2349,4/12/2011,2,0,4,18,0,2,1,3,0.44,0.4394,0.77,0.2239,21,203,224,203
2350,4/12/2011,2,0,4,19,0,2,1,2,0.42,0.4242,0.82,0.2836,3,127,130,127
2351,4/12/2011,2,0,4,20,0,2,1,2,0.42,0.4242,0.82,0.2836,9,94,103,94
2352,4/12/2011,2,0,4,21,0,2,1,2,0.42,0.4242,0.82,0.194,10,74,84,74
2353,4/12/2011,2,0,4,22,0,2,1,2,0.4,0.4091,0.94,0.2985,7,47,54,47
2354,4/12/2011,2,0,4,23,0,2,1,2,0.4,0.4091,0.94,0.2537,8,31,39,31
2355,4/13/2011,2,0,4,0,0,3,1,2,0.4,0.4091,1,0.2985,3,12,15,12
2356,4/13/2011,2,0,4,1,0,3,1,2,0.4,0.4091,1,0.2985,0,1,1,1
2357,4/13/2011,2,0,4,2,0,3,1,3,0.4,0.4091,1,0.2985,0,2,2,2
2358,4/13/2011,2,0,4,3,0,3,1,3,0.4,0.4091,0.94,0.3284,0,2,2,2
2359,4/13/2011,2,0,4,4,0,3,1,3,0.4,0.4091,0.94,0.3284,1,2,3,2
2360,4/13/2011,2,0,4,5,0,3,1,3,0.38,0.3939,0.94,0.2537,1,4,5,4
2361,4/13/2011,2,0,4,6,0,3,1,3,0.38,0.3939,0.94,0.2239,1,33,34,33
2362,4/13/2011,2,0,4,7,0,3,1,3,0.36,0.3485,1,0.2239,3,67,70,67
2363,4/13/2011,2,0,4,8,0,3,1,3,0.38,0.3939,0.94,0.194,6,158,164,158
2364,4/13/2011,2,0,4,9,0,3,1,2,0.38,0.3939,0.94,0.2239,2,63,65,63
2365,4/13/2011,2,0,4,10,0,3,1,2,0.4,0.4091,0.87,0.194,4,42,46,42
2366,4/13/2011,2,0,4,11,0,3,1,2,0.42,0.4242,0.82,0.194,4,57,61,57
2367,4/13/2011,2,0,4,12,0,3,1,3,0.42,0.4242,0.82,0.2537,12,83,95,83
2368,4/13/2011,2,0,4,13,0,3,1,2,0.44,0.4394,0.77,0.194,6,55,61,55
2369,4/13/2011,2,0,4,14,0,3,1,2,0.42,0.4242,0.77,0.2537,24,82,106,82
2370,4/13/2011,2,0,4,15,0,3,1,2,0.44,0.4394,0.72,0.2836,12,69,81,69
2371,4/13/2011,2,0,4,16,0,3,1,1,0.46,0.4545,0.67,0.2836,23,119,142,119
2372,4/13/2011,2,0,4,17,0,3,1,1,0.46,0.4545,0.67,0.2985,25,284,309,284
2373,4/13/2011,2,0,4,18,0,3,1,1,0.44,0.4394,0.62,0.3881,28,293,321,293
2374,4/13/2011,2,0,4,19,0,3,1,1,0.44,0.4394,0.62,0.2537,15,160,175,160
2375,4/13/2011,2,0,4,20,0,3,1,1,0.44,0.4394,0.62,0.2537,7,119,126,119
2376,4/13/2011,2,0,4,21,0,3,1,1,0.42,0.4242,0.67,0.1642,17,100,117,100
2377,4/13/2011,2,0,4,22,0,3,1,1,0.42,0.4242,0.67,0.194,10,89,99,89
2378,4/13/2011,2,0,4,23,0,3,1,1,0.4,0.4091,0.71,0.1343,5,57,62,57
2379,4/14/2011,2,0,4,0,0,4,1,1,0.38,0.3939,0.76,0.1343,3,18,21,18
2380,4/14/2011,2,0,4,1,0,4,1,1,0.38,0.3939,0.76,0.2239,1,9,10,9
2381,4/14/2011,2,0,4,2,0,4,1,1,0.36,0.3485,0.76,0.1343,0,3,3,3
2382,4/14/2011,2,0,4,3,0,4,1,1,0.34,0.3333,0.81,0.1343,0,2,2,2
2383,4/14/2011,2,0,4,4,0,4,1,1,0.34,0.3636,0.76,0,1,8,9,8
2384,4/14/2011,2,0,4,5,0,4,1,1,0.34,0.3485,0.76,0.0896,2,12,14,12
2385,4/14/2011,2,0,4,6,0,4,1,1,0.34,0.3485,0.76,0.1045,4,66,70,66
2386,4/14/2011,2,0,4,7,0,4,1,1,0.38,0.3939,0.66,0,11,182,193,182
2387,4/14/2011,2,0,4,8,0,4,1,1,0.42,0.4242,0.58,0.1642,21,316,337,316
2388,4/14/2011,2,0,4,9,0,4,1,1,0.46,0.4545,0.51,0.1343,18,152,170,152
2389,4/14/2011,2,0,4,10,0,4,1,1,0.5,0.4848,0.51,0.194,21,68,89,68
2390,4/14/2011,2,0,4,11,0,4,1,1,0.52,0.5,0.45,0.1642,28,87,115,87
2391,4/14/2011,2,0,4,12,0,4,1,1,0.54,0.5152,0.42,0.1343,35,110,145,110
2392,4/14/2011,2,0,4,13,0,4,1,1,0.56,0.5303,0.37,0.2239,38,121,159,121
2393,4/14/2011,2,0,4,14,0,4,1,1,0.56,0.5303,0.35,0.0896,36,101,137,101
2394,4/14/2011,2,0,4,15,0,4,1,1,0.6,0.6212,0.31,0.0896,57,85,142,85
2395,4/14/2011,2,0,4,16,0,4,1,1,0.6,0.6061,0.26,0.1045,49,153,202,153
2396,4/14/2011,2,0,4,17,0,4,1,1,0.6,0.6061,0.28,0,50,338,388,338
2397,4/14/2011,2,0,4,18,0,4,1,1,0.56,0.5303,0.3,0,47,290,337,290
2398,4/14/2011,2,0,4,19,0,4,1,1,0.54,0.5152,0.32,0,37,222,259,222
2399,4/14/2011,2,0,4,20,0,4,1,1,0.5,0.4848,0.51,0.194,22,147,169,147
2400,4/14/2011,2,0,4,21,0,4,1,1,0.46,0.4545,0.63,0.1343,19,126,145,126
2401,4/14/2011,2,0,4,22,0,4,1,1,0.48,0.4697,0.55,0.1045,22,82,104,82
2402,4/14/2011,2,0,4,23,0,4,1,1,0.46,0.4545,0.59,0.1045,7,40,47,40
2403,4/15/2011,2,0,4,0,1,5,0,1,0.44,0.4394,0.67,0,6,21,27,21
2404,4/15/2011,2,0,4,1,1,5,0,1,0.44,0.4394,0.62,0,6,9,15,9
2405,4/15/2011,2,0,4,2,1,5,0,1,0.4,0.4091,0.76,0,8,10,18,10
2406,4/15/2011,2,0,4,3,1,5,0,1,0.4,0.4091,0.76,0,0,3,3,3
2407,4/15/2011,2,0,4,4,1,5,0,1,0.38,0.3939,0.82,0.0896,0,3,3,3
2408,4/15/2011,2,0,4,5,1,5,0,1,0.36,0.3636,0.81,0.1045,2,11,13,11
2409,4/15/2011,2,0,4,6,1,5,0,1,0.36,0.3636,0.81,0.0896,5,42,47,42
2410,4/15/2011,2,0,4,7,1,5,0,1,0.4,0.4091,0.71,0.1642,10,139,149,139
2411,4/15/2011,2,0,4,8,1,5,0,1,0.44,0.4394,0.62,0.2985,21,279,300,279
2412,4/15/2011,2,0,4,9,1,5,0,1,0.5,0.4848,0.55,0.194,16,162,178,162
2413,4/15/2011,2,0,4,10,1,5,0,1,0.5,0.4848,0.55,0.194,31,91,122,91
2414,4/15/2011,2,0,4,11,1,5,0,1,0.52,0.5,0.55,0.194,41,95,136,95
2415,4/15/2011,2,0,4,12,1,5,0,1,0.52,0.5,0.55,0.2836,45,155,200,155
2416,4/15/2011,2,0,4,13,1,5,0,1,0.54,0.5152,0.52,0.2537,47,133,180,133
2417,4/15/2011,2,0,4,14,1,5,0,1,0.54,0.5152,0.52,0.2537,57,106,163,106
2418,4/15/2011,2,0,4,15,1,5,0,1,0.54,0.5152,0.52,0.4478,50,112,162,112
2419,4/15/2011,2,0,4,16,1,5,0,1,0.52,0.5,0.55,0.4925,70,173,243,173
2420,4/15/2011,2,0,4,17,1,5,0,2,0.5,0.4848,0.63,0.3881,64,267,331,267
2421,4/15/2011,2,0,4,18,1,5,0,2,0.46,0.4545,0.67,0.3881,47,216,263,216
2422,4/15/2011,2,0,4,19,1,5,0,1,0.42,0.4242,0.77,0.3881,41,168,209,168
2423,4/15/2011,2,0,4,20,1,5,0,2,0.4,0.4091,0.76,0.3284,26,92,118,92
2424,4/15/2011,2,0,4,21,1,5,0,2,0.4,0.4091,0.76,0.2985,25,77,102,77
2425,4/15/2011,2,0,4,22,1,5,0,2,0.38,0.3939,0.82,0.3881,16,64,80,64
2426,4/15/2011,2,0,4,23,1,5,0,2,0.36,0.3485,0.81,0.194,8,56,64,56
2427,4/16/2011,2,0,4,0,0,6,0,2,0.36,0.3485,0.81,0.2239,7,36,43,36
2428,4/16/2011,2,0,4,1,0,6,0,2,0.36,0.3333,0.87,0.2836,5,28,33,28
2429,4/16/2011,2,0,4,2,0,6,0,2,0.36,0.3485,0.87,0.1343,5,19,24,19
2430,4/16/2011,2,0,4,3,0,6,0,2,0.36,0.3485,0.87,0.1642,5,9,14,9
2431,4/16/2011,2,0,4,4,0,6,0,2,0.36,0.3485,0.87,0.2239,1,4,5,4
2432,4/16/2011,2,0,4,5,0,6,0,2,0.38,0.3939,0.87,0.2836,1,3,4,3
2433,4/16/2011,2,0,4,6,0,6,0,3,0.4,0.4091,0.82,0.3284,1,9,10,9
2434,4/16/2011,2,0,4,7,0,6,0,2,0.4,0.4091,0.82,0.4179,3,18,21,18
2435,4/16/2011,2,0,4,8,0,6,0,3,0.4,0.4091,0.87,0.3582,7,38,45,38
2436,4/16/2011,2,0,4,9,0,6,0,3,0.4,0.4091,1,0.2985,2,27,29,27
2437,4/16/2011,2,0,4,10,0,6,0,3,0.42,0.4242,0.94,0.3881,1,21,22,21
2438,4/16/2011,2,0,4,11,0,6,0,3,0.42,0.4242,0.94,0.4478,4,27,31,27
2439,4/16/2011,2,0,4,12,0,6,0,2,0.46,0.4545,0.88,0.5821,6,26,32,26
2440,4/16/2011,2,0,4,13,0,6,0,3,0.46,0.4545,0.94,0.5224,9,49,58,49
2441,4/16/2011,2,0,4,14,0,6,0,3,0.52,0.5,0.83,0.5821,14,49,63,49
2442,4/16/2011,2,0,4,15,0,6,0,3,0.52,0.5,0.83,0.5821,16,62,78,62
2443,4/16/2011,2,0,4,16,0,6,0,3,0.5,0.4848,0.88,0.4627,6,27,33,27
2444,4/16/2011,2,0,4,17,0,6,0,3,0.5,0.4848,0.88,0.5821,1,14,15,14
2445,4/16/2011,2,0,4,18,0,6,0,2,0.5,0.4848,0.94,0.3881,6,32,38,32
2446,4/16/2011,2,0,4,19,0,6,0,2,0.52,0.5,0.94,0.4179,9,62,71,62
2447,4/16/2011,2,0,4,20,0,6,0,3,0.44,0.4394,0.94,0.2239,4,49,53,49
2448,4/16/2011,2,0,4,21,0,6,0,2,0.44,0.4394,0.94,0,1,13,14,13
2449,4/16/2011,2,0,4,22,0,6,0,3,0.42,0.4242,1,0,2,22,24,22
2450,4/16/2011,2,0,4,23,0,6,0,2,0.44,0.4394,0.77,0.2836,5,30,35,30
2451,4/17/2011,2,0,4,0,0,0,0,2,0.44,0.4394,0.77,0.2836,4,29,33,29
2452,4/17/2011,2,0,4,1,0,0,0,1,0.42,0.4242,0.67,0.2239,6,25,31,25
2453,4/17/2011,2,0,4,2,0,0,0,1,0.4,0.4091,0.62,0.194,4,25,29,25
2454,4/17/2011,2,0,4,3,0,0,0,1,0.4,0.4091,0.66,0.1343,12,13,25,13
2455,4/17/2011,2,0,4,4,0,0,0,1,0.36,0.3636,0.76,0.1045,2,5,7,5
2456,4/17/2011,2,0,4,5,0,0,0,1,0.36,0.3485,0.71,0.1642,2,1,3,1
2457,4/17/2011,2,0,4,6,0,0,0,1,0.36,0.3182,0.66,0.4478,3,5,8,5
2458,4/17/2011,2,0,4,7,0,0,0,1,0.36,0.3333,0.5,0.3582,2,14,16,14
2459,4/17/2011,2,0,4,8,0,0,0,1,0.38,0.3939,0.46,0.3881,7,36,43,36
2460,4/17/2011,2,0,4,9,0,0,0,1,0.4,0.4091,0.43,0.2836,31,71,102,71
2461,4/17/2011,2,0,4,10,0,0,0,1,0.42,0.4242,0.44,0.4478,91,120,211,120
2462,4/17/2011,2,0,4,11,0,0,0,1,0.46,0.4545,0.41,0.4179,119,185,304,185
2463,4/17/2011,2,0,4,12,0,0,0,1,0.46,0.4545,0.38,0.3881,167,187,354,187
2464,4/17/2011,2,0,4,13,0,0,0,1,0.5,0.4848,0.34,0.3881,181,162,343,162
2465,4/17/2011,2,0,4,14,0,0,0,1,0.52,0.5,0.34,0.3881,170,191,361,191
2466,4/17/2011,2,0,4,15,0,0,0,1,0.54,0.5152,0.32,0.5224,179,209,388,209
2467,4/17/2011,2,0,4,16,0,0,0,1,0.54,0.5152,0.3,0.3582,161,182,343,182
2468,4/17/2011,2,0,4,17,0,0,0,1,0.56,0.5303,0.3,0.4478,143,163,306,163
2469,4/17/2011,2,0,4,18,0,0,0,1,0.56,0.5303,0.3,0.3881,102,175,277,175
2470,4/17/2011,2,0,4,19,0,0,0,1,0.56,0.5303,0.3,0.2985,75,135,210,135
2471,4/17/2011,2,0,4,20,0,0,0,1,0.52,0.5,0.36,0.194,44,97,141,97
2472,4/17/2011,2,0,4,21,0,0,0,1,0.5,0.4848,0.42,0.194,13,70,83,70
2473,4/17/2011,2,0,4,22,0,0,0,1,0.5,0.4848,0.39,0.1045,21,49,70,49
2474,4/17/2011,2,0,4,23,0,0,0,1,0.44,0.4394,0.67,0.1642,19,37,56,37
2475,4/18/2011,2,0,4,0,0,1,1,1,0.46,0.4545,0.47,0.0896,15,24,39,24
2476,4/18/2011,2,0,4,1,0,1,1,1,0.46,0.4545,0.47,0.1343,11,8,19,8
2477,4/18/2011,2,0,4,2,0,1,1,1,0.42,0.4242,0.67,0.1045,14,2,16,2
2478,4/18/2011,2,0,4,3,0,1,1,1,0.42,0.4242,0.62,0.1045,6,1,7,1
2479,4/18/2011,2,0,4,4,0,1,1,1,0.4,0.4091,0.87,0.1642,2,4,6,4
2480,4/18/2011,2,0,4,5,0,1,1,1,0.4,0.4091,0.76,0.0896,0,16,16,16
2481,4/18/2011,2,0,4,6,0,1,1,1,0.4,0.4091,0.82,0,3,51,54,51
2482,4/18/2011,2,0,4,7,0,1,1,1,0.46,0.4545,0.63,0,12,156,168,156
2483,4/18/2011,2,0,4,8,0,1,1,1,0.46,0.4545,0.63,0,20,277,297,277
2484,4/18/2011,2,0,4,9,0,1,1,2,0.5,0.4848,0.55,0.1045,37,132,169,132
2485,4/18/2011,2,0,4,10,0,1,1,2,0.52,0.5,0.55,0.1045,41,68,109,68
2486,4/18/2011,2,0,4,11,0,1,1,2,0.54,0.5152,0.52,0.0896,36,87,123,87
2487,4/18/2011,2,0,4,12,0,1,1,2,0.56,0.5303,0.49,0.0896,60,124,184,124
2488,4/18/2011,2,0,4,13,0,1,1,2,0.56,0.5303,0.49,0.1642,41,128,169,128
2489,4/18/2011,2,0,4,14,0,1,1,2,0.58,0.5455,0.49,0.194,49,95,144,95
2490,4/18/2011,2,0,4,15,0,1,1,2,0.6,0.6212,0.43,0.194,64,112,176,112
2491,4/18/2011,2,0,4,16,0,1,1,1,0.6,0.6212,0.46,0.2836,40,165,205,165
2492,4/18/2011,2,0,4,17,0,1,1,1,0.58,0.5455,0.49,0.2836,66,362,428,362
2493,4/18/2011,2,0,4,18,0,1,1,1,0.64,0.6212,0.31,0.3582,41,321,362,321
2494,4/18/2011,2,0,4,19,0,1,1,1,0.56,0.5303,0.46,0.2537,42,244,286,244
2495,4/18/2011,2,0,4,20,0,1,1,1,0.6,0.6212,0.33,0.2985,29,136,165,136
2496,4/18/2011,2,0,4,21,0,1,1,1,0.56,0.5303,0.37,0.2836,20,131,151,131
2497,4/18/2011,2,0,4,22,0,1,1,1,0.52,0.5,0.55,0.2836,9,81,90,81
2498,4/18/2011,2,0,4,23,0,1,1,1,0.5,0.4848,0.59,0.2537,11,35,46,35
2499,4/19/2011,2,0,4,0,0,2,1,1,0.5,0.4848,0.55,0.2239,2,23,25,23
2500,4/19/2011,2,0,4,1,0,2,1,1,0.46,0.4545,0.63,0.2239,5,2,7,2
2501,4/19/2011,2,0,4,2,0,2,1,1,0.46,0.4545,0.67,0.2836,8,5,13,5
2502,4/19/2011,2,0,4,3,0,2,1,1,0.48,0.4697,0.63,0.2239,0,3,3,3
2503,4/19/2011,2,0,4,4,0,2,1,1,0.46,0.4545,0.67,0.0896,1,4,5,4
2504,4/19/2011,2,0,4,5,0,2,1,2,0.46,0.4545,0.72,0.194,1,17,18,17
2505,4/19/2011,2,0,4,6,0,2,1,2,0.48,0.4697,0.67,0,2,63,65,63
2506,4/19/2011,2,0,4,7,0,2,1,2,0.52,0.5,0.55,0,22,166,188,166
2507,4/19/2011,2,0,4,8,0,2,1,2,0.5,0.4848,0.68,0.1343,20,331,351,331
2508,4/19/2011,2,0,4,9,0,2,1,3,0.52,0.5,0.63,0.0896,23,139,162,139
2509,4/19/2011,2,0,4,10,0,2,1,2,0.5,0.4848,0.72,0.2239,15,60,75,60
2510,4/19/2011,2,0,4,11,0,2,1,2,0.54,0.5152,0.68,0.1642,19,53,72,53
2511,4/19/2011,2,0,4,12,0,2,1,2,0.54,0.5152,0.64,0.0896,19,84,103,84
2512,4/19/2011,2,0,4,13,0,2,1,2,0.54,0.5152,0.68,0.2239,26,103,129,103
2513,4/19/2011,2,0,4,14,0,2,1,2,0.54,0.5152,0.64,0.194,19,88,107,88
2514,4/19/2011,2,0,4,15,0,2,1,2,0.54,0.5152,0.65,0.1642,44,83,127,83
2515,4/19/2011,2,0,4,16,0,2,1,1,0.56,0.5303,0.52,0.2985,30,162,192,162
2516,4/19/2011,2,0,4,17,0,2,1,1,0.56,0.5303,0.6,0.1045,39,372,411,372
2517,4/19/2011,2,0,4,18,0,2,1,2,0.54,0.5152,0.64,0.1343,44,377,421,377
2518,4/19/2011,2,0,4,19,0,2,1,2,0.5,0.4848,0.72,0.194,28,248,276,248
2519,4/19/2011,2,0,4,20,0,2,1,2,0.5,0.4848,0.72,0.2239,20,148,168,148
2520,4/19/2011,2,0,4,21,0,2,1,2,0.5,0.4848,0.72,0.1343,8,114,122,114
2521,4/19/2011,2,0,4,22,0,2,1,1,0.48,0.4697,0.77,0.0896,3,109,112,109
2522,4/19/2011,2,0,4,23,0,2,1,1,0.46,0.4545,0.88,0.0896,11,41,52,41
2523,4/20/2011,2,0,4,0,0,3,1,1,0.44,0.4394,0.88,0.1343,4,29,33,29
2524,4/20/2011,2,0,4,1,0,3,1,1,0.42,0.4242,0.94,0.1642,2,5,7,5
2525,4/20/2011,2,0,4,2,0,3,1,1,0.42,0.4242,0.94,0.1642,0,2,2,2
2526,4/20/2011,2,0,4,3,0,3,1,1,0.42,0.4242,0.94,0,0,2,2,2
2527,4/20/2011,2,0,4,4,0,3,1,1,0.4,0.4091,1,0.1045,5,4,9,4
2528,4/20/2011,2,0,4,5,0,3,1,1,0.4,0.4091,0.94,0.194,1,14,15,14
2529,4/20/2011,2,0,4,6,0,3,1,1,0.42,0.4242,0.94,0.1642,2,62,64,62
2530,4/20/2011,2,0,4,7,0,3,1,1,0.44,0.4394,0.94,0,26,211,237,211
2531,4/20/2011,2,0,4,8,0,3,1,1,0.62,0.6061,0.69,0.4627,22,374,396,374
2532,4/20/2011,2,0,4,9,0,3,1,1,0.66,0.6212,0.61,0.2836,27,170,197,170
2533,4/20/2011,2,0,4,10,0,3,1,1,0.62,0.6061,0.69,0.0896,45,86,131,86
2534,4/20/2011,2,0,4,11,0,3,1,1,0.62,0.6061,0.69,0.0896,31,87,118,87
2535,4/20/2011,2,0,4,12,0,3,1,1,0.7,0.6515,0.48,0.3881,28,117,145,117
2536,4/20/2011,2,0,4,13,0,3,1,1,0.7,0.6515,0.48,0.3881,42,135,177,135
2537,4/20/2011,2,0,4,14,0,3,1,1,0.74,0.6515,0.4,0.4627,33,115,148,115
2538,4/20/2011,2,0,4,15,0,3,1,2,0.76,0.6667,0.35,0.3582,32,113,145,113
2539,4/20/2011,2,0,4,16,0,3,1,2,0.76,0.6667,0.35,0.3582,54,201,255,201
2540,4/20/2011,2,0,4,17,0,3,1,2,0.74,0.6515,0.37,0.4179,34,398,432,398
2541,4/20/2011,2,0,4,18,0,3,1,1,0.74,0.6515,0.3,0.3582,56,385,441,385
2542,4/20/2011,2,0,4,19,0,3,1,1,0.7,0.6364,0.32,0.2537,74,309,383,309
2543,4/20/2011,2,0,4,20,0,3,1,1,0.68,0.6212,0.32,0.1045,31,194,225,194
2544,4/20/2011,2,0,4,21,0,3,1,1,0.66,0.6212,0.36,0.2836,38,134,172,134
2545,4/20/2011,2,0,4,22,0,3,1,1,0.62,0.6212,0.41,0.2537,12,105,117,105
2546,4/20/2011,2,0,4,23,0,3,1,1,0.6,0.6212,0.4,0.3284,14,79,93,79
2547,4/21/2011,2,0,4,0,0,4,1,1,0.56,0.5303,0.43,0.3582,11,33,44,33
2548,4/21/2011,2,0,4,1,0,4,1,1,0.52,0.5,0.45,0.2239,6,20,26,20
2549,4/21/2011,2,0,4,2,0,4,1,1,0.5,0.4848,0.42,0.3881,3,10,13,10
2550,4/21/2011,2,0,4,3,0,4,1,2,0.46,0.4545,0.51,0.4627,4,3,7,3
2551,4/21/2011,2,0,4,4,0,4,1,2,0.44,0.4394,0.54,0.4478,2,4,6,4
2552,4/21/2011,2,0,4,5,0,4,1,2,0.42,0.4242,0.54,0.5522,0,14,14,14
2553,4/21/2011,2,0,4,6,0,4,1,2,0.4,0.4091,0.58,0.5821,2,73,75,73
2554,4/21/2011,2,0,4,7,0,4,1,2,0.42,0.4242,0.47,0.4627,15,183,198,183
2555,4/21/2011,2,0,4,8,0,4,1,2,0.4,0.4091,0.5,0.4925,19,346,365,346
2556,4/21/2011,2,0,4,9,0,4,1,2,0.42,0.4242,0.47,0.2836,18,178,196,178
2557,4/21/2011,2,0,4,10,0,4,1,1,0.42,0.4242,0.44,0.3582,25,73,98,73
2558,4/21/2011,2,0,4,11,0,4,1,1,0.44,0.4394,0.41,0.2836,34,99,133,99
2559,4/21/2011,2,0,4,12,0,4,1,1,0.46,0.4545,0.38,0.1642,49,150,199,150
2560,4/21/2011,2,0,4,13,0,4,1,1,0.48,0.4697,0.33,0.3284,55,122,177,122
2561,4/21/2011,2,0,4,14,0,4,1,1,0.5,0.4848,0.34,0.3881,68,160,228,160
2562,4/21/2011,2,0,4,15,0,4,1,1,0.52,0.5,0.29,0.4179,69,166,235,166
2563,4/21/2011,2,0,4,16,0,4,1,1,0.52,0.5,0.27,0.3582,66,228,294,228
2564,4/21/2011,2,0,4,17,0,4,1,1,0.5,0.4848,0.29,0.1642,79,402,481,402
2565,4/21/2011,2,0,4,18,0,4,1,1,0.5,0.4848,0.25,0.2836,71,381,452,381
2566,4/21/2011,2,0,4,19,0,4,1,1,0.46,0.4545,0.28,0.2836,52,272,324,272
2567,4/21/2011,2,0,4,20,0,4,1,1,0.44,0.4394,0.3,0.1343,28,176,204,176
2568,4/21/2011,2,0,4,21,0,4,1,1,0.42,0.4242,0.47,0.194,25,159,184,159
2569,4/21/2011,2,0,4,22,0,4,1,1,0.42,0.4242,0.38,0.0896,31,106,137,106
2570,4/21/2011,2,0,4,23,0,4,1,1,0.4,0.4091,0.43,0.1045,13,86,99,86
2571,4/22/2011,2,0,4,0,0,5,1,1,0.36,0.3485,0.62,0.194,3,30,33,30
2572,4/22/2011,2,0,4,1,0,5,1,1,0.36,0.3333,0.53,0.2537,2,22,24,22
2573,4/22/2011,2,0,4,2,0,5,1,1,0.36,0.3333,0.53,0.2985,2,7,9,7
2574,4/22/2011,2,0,4,3,0,5,1,1,0.36,0.3333,0.53,0.2985,0,2,2,2
2575,4/22/2011,2,0,4,4,0,5,1,1,0.34,0.3182,0.53,0.2836,1,2,3,2
2576,4/22/2011,2,0,4,5,0,5,1,1,0.34,0.3182,0.53,0.2239,0,16,16,16
2577,4/22/2011,2,0,4,6,0,5,1,1,0.34,0.3182,0.53,0.2836,2,47,49,47
2578,4/22/2011,2,0,4,7,0,5,1,2,0.34,0.3182,0.53,0.2836,5,175,180,175
2579,4/22/2011,2,0,4,8,0,5,1,2,0.34,0.3182,0.53,0.2537,15,331,346,331
2580,4/22/2011,2,0,4,9,0,5,1,3,0.34,0.303,0.61,0.2985,17,178,195,178
2581,4/22/2011,2,0,4,10,0,5,1,2,0.36,0.3485,0.62,0.194,32,104,136,104
2582,4/22/2011,2,0,4,11,0,5,1,3,0.34,0.3333,0.66,0.194,23,83,106,83
2583,4/22/2011,2,0,4,12,0,5,1,3,0.34,0.3333,0.76,0.1343,19,61,80,61
2584,4/22/2011,2,0,4,13,0,5,1,3,0.34,0.3333,0.87,0.194,3,37,40,37
2585,4/22/2011,2,0,4,14,0,5,1,3,0.34,0.3182,0.87,0.2537,3,33,36,33
2586,4/22/2011,2,0,4,15,0,5,1,3,0.34,0.3333,0.87,0.194,13,62,75,62
2587,4/22/2011,2,0,4,16,0,5,1,3,0.34,0.3333,0.87,0.1343,4,58,62,58
2588,4/22/2011,2,0,4,17,0,5,1,3,0.32,0.303,0.93,0.2239,6,63,69,63
2589,4/22/2011,2,0,4,18,0,5,1,3,0.32,0.303,0.93,0.2239,4,47,51,47
2590,4/22/2011,2,0,4,19,0,5,1,3,0.32,0.303,0.93,0.2239,7,48,55,48
2591,4/22/2011,2,0,4,20,0,5,1,3,0.32,0.303,0.87,0.2239,8,39,47,39
2592,4/22/2011,2,0,4,21,0,5,1,3,0.3,0.303,0.93,0.1642,5,23,28,23
2593,4/22/2011,2,0,4,22,0,5,1,3,0.3,0.303,1,0.1343,3,21,24,21
2594,4/22/2011,2,0,4,23,0,5,1,3,0.32,0.3333,0.93,0.1045,0,17,17,17
2595,4/23/2011,2,0,4,0,0,6,0,2,0.32,0.3182,1,0.194,0,18,18,18
2596,4/23/2011,2,0,4,1,0,6,0,2,0.32,0.3182,1,0.194,5,11,16,11
2597,4/23/2011,2,0,4,2,0,6,0,3,0.32,0.3333,1,0.1343,3,14,17,14
2598,4/23/2011,2,0,4,3,0,6,0,3,0.32,0.3333,1,0.0896,0,4,4,4
2599,4/23/2011,2,0,4,4,0,6,0,3,0.34,0.3636,1,0,2,3,5,3
2600,4/23/2011,2,0,4,5,0,6,0,3,0.34,0.3636,1,0,1,6,7,6
2601,4/23/2011,2,0,4,6,0,6,0,2,0.34,0.3333,1,0.1642,0,11,11,11
2602,4/23/2011,2,0,4,7,0,6,0,3,0.34,0.3333,1,0.1642,2,17,19,17
2603,4/23/2011,2,0,4,8,0,6,0,2,0.36,0.3333,1,0.2537,15,32,47,32
2604,4/23/2011,2,0,4,9,0,6,0,2,0.38,0.3939,0.94,0.2985,13,55,68,55
2605,4/23/2011,2,0,4,10,0,6,0,2,0.42,0.4242,0.88,0.2239,36,93,129,93
2606,4/23/2011,2,0,4,11,0,6,0,2,0.46,0.4545,0.88,0.2239,68,164,232,164
2607,4/23/2011,2,0,4,12,0,6,0,1,0.52,0.5,0.83,0.4179,94,197,291,197
2608,4/23/2011,2,0,4,13,0,6,0,1,0.52,0.5,0.83,0.3881,126,186,312,186
2609,4/23/2011,2,0,4,14,0,6,0,1,0.58,0.5455,0.78,0.3582,182,209,391,209
2610,4/23/2011,2,0,4,15,0,6,0,1,0.6,0.5909,0.73,0.3881,171,226,397,226
2611,4/23/2011,2,0,4,16,0,6,0,1,0.6,0.5909,0.73,0.2836,180,246,426,246
2612,4/23/2011,2,0,4,17,0,6,0,1,0.6,0.5909,0.73,0.3284,168,215,383,215
2613,4/23/2011,2,0,4,18,0,6,0,1,0.58,0.5455,0.78,0.194,149,227,376,227
2614,4/23/2011,2,0,4,19,0,6,0,1,0.56,0.5303,0.83,0.2836,84,199,283,199
2615,4/23/2011,2,0,4,20,0,6,0,2,0.54,0.5152,0.88,0.2537,45,138,183,138
2616,4/23/2011,2,0,4,21,0,6,0,2,0.56,0.5303,0.83,0.2836,32,103,135,103
2617,4/23/2011,2,0,4,22,0,6,0,2,0.58,0.5455,0.78,0.2537,55,114,169,114
2618,4/23/2011,2,0,4,23,0,6,0,2,0.54,0.5152,0.88,0.1642,31,86,117,86
2619,4/24/2011,2,0,4,0,0,0,0,1,0.52,0.5,0.83,0.2239,30,66,96,66
2620,4/24/2011,2,0,4,1,0,0,0,1,0.5,0.4848,0.88,0.194,14,40,54,40
2621,4/24/2011,2,0,4,2,0,0,0,1,0.5,0.4848,0.88,0.194,27,45,72,45
2622,4/24/2011,2,0,4,3,0,0,0,1,0.5,0.4848,0.94,0.0896,4,20,24,20
2623,4/24/2011,2,0,4,4,0,0,0,1,0.5,0.4848,0.94,0.0896,0,5,5,5
2624,4/24/2011,2,0,4,5,0,0,0,1,0.5,0.4848,0.94,0.0896,5,7,12,7
2625,4/24/2011,2,0,4,6,0,0,0,2,0.5,0.4848,1,0,10,3,13,3
2626,4/24/2011,2,0,4,7,0,0,0,2,0.5,0.4848,1,0,16,11,27,11
2627,4/24/2011,2,0,4,8,0,0,0,1,0.52,0.5,0.94,0.2239,38,42,80,42
2628,4/24/2011,2,0,4,9,0,0,0,1,0.56,0.5303,0.88,0.2537,73,104,177,104
2629,4/24/2011,2,0,4,10,0,0,0,1,0.6,0.5758,0.78,0.1642,118,171,289,171
2630,4/24/2011,2,0,4,11,0,0,0,1,0.66,0.6212,0.65,0.1343,124,193,317,193
2631,4/24/2011,2,0,4,12,0,0,0,1,0.68,0.6364,0.65,0.2537,168,220,388,220
2632,4/24/2011,2,0,4,13,0,0,0,1,0.7,0.6515,0.58,0.2836,205,236,441,236
2633,4/24/2011,2,0,4,14,0,0,0,1,0.7,0.6515,0.54,0.3284,197,223,420,223
2634,4/24/2011,2,0,4,15,0,0,0,1,0.66,0.6212,0.61,0.2537,167,202,369,202
2635,4/24/2011,2,0,4,16,0,0,0,1,0.74,0.6667,0.48,0.3881,162,197,359,197
2636,4/24/2011,2,0,4,17,0,0,0,1,0.66,0.6212,0.65,0.2985,142,189,331,189
2637,4/24/2011,2,0,4,18,0,0,0,1,0.64,0.6061,0.69,0.1642,96,174,270,174
2638,4/24/2011,2,0,4,19,0,0,0,3,0.6,0.5606,0.83,0.2836,62,132,194,132
2639,4/24/2011,2,0,4,20,0,0,0,3,0.6,0.5606,0.83,0.2836,34,71,105,71
2640,4/24/2011,2,0,4,21,0,0,0,3,0.54,0.5152,0.94,0.1642,8,53,61,53
2641,4/24/2011,2,0,4,22,0,0,0,3,0.54,0.5152,1,0.1642,5,40,45,40
2642,4/24/2011,2,0,4,23,0,0,0,3,0.54,0.5152,1,0.0896,5,37,42,37
2643,4/25/2011,2,0,4,0,0,1,1,3,0.52,0.5,1,0,2,10,12,10
2644,4/25/2011,2,0,4,1,0,1,1,1,0.54,0.5152,1,0.0896,2,8,10,8
2645,4/25/2011,2,0,4,2,0,1,1,1,0.54,0.5152,1,0.0896,1,9,10,9
2646,4/25/2011,2,0,4,3,0,1,1,2,0.5,0.4848,1,0.1045,2,8,10,8
2647,4/25/2011,2,0,4,4,0,1,1,2,0.52,0.5,1,0,1,4,5,4
2648,4/25/2011,2,0,4,5,0,1,1,2,0.46,0.4545,1,0,3,14,17,14
2649,4/25/2011,2,0,4,6,0,1,1,2,0.5,0.4848,1,0,7,59,66,59
2650,4/25/2011,2,0,4,7,0,1,1,2,0.52,0.5,1,0.0896,13,183,196,183
2651,4/25/2011,2,0,4,8,0,1,1,1,0.56,0.5303,0.88,0.1045,27,326,353,326
2652,4/25/2011,2,0,4,9,0,1,1,1,0.6,0.5606,0.83,0.1343,27,147,174,147
2653,4/25/2011,2,0,4,10,0,1,1,1,0.64,0.6061,0.73,0.2239,61,64,125,64
2654,4/25/2011,2,0,4,11,0,1,1,1,0.64,0.6061,0.73,0.2239,53,94,147,94
2655,4/25/2011,2,0,4,12,0,1,1,1,0.66,0.6212,0.74,0.2537,48,140,188,140
2656,4/25/2011,2,0,4,13,0,1,1,1,0.7,0.6515,0.65,0.2239,57,146,203,146
2657,4/25/2011,2,0,4,14,0,1,1,1,0.72,0.6667,0.54,0.2239,47,99,146,99
2658,4/25/2011,2,0,4,15,0,1,1,1,0.74,0.6667,0.51,0.2239,50,125,175,125
2659,4/25/2011,2,0,4,16,0,1,1,1,0.7,0.6515,0.54,0.3582,41,198,239,198
2660,4/25/2011,2,0,4,17,0,1,1,1,0.7,0.6515,0.54,0.2985,80,441,521,441
2661,4/25/2011,2,0,4,18,0,1,1,1,0.68,0.6364,0.57,0.3582,74,425,499,425
2662,4/25/2011,2,0,4,19,0,1,1,1,0.66,0.6212,0.57,0.3284,62,320,382,320
2663,4/25/2011,2,0,4,20,0,1,1,1,0.66,0.6212,0.61,0.2836,42,195,237,195
2664,4/25/2011,2,0,4,21,0,1,1,1,0.62,0.6061,0.69,0.2537,41,149,190,149
2665,4/25/2011,2,0,4,22,0,1,1,1,0.6,0.5909,0.73,0.2985,23,83,106,83
2666,4/25/2011,2,0,4,23,0,1,1,1,0.58,0.5455,0.78,0.2836,9,53,62,53
2667,4/26/2011,2,0,4,0,0,2,1,1,0.62,0.6061,0.69,0.2836,10,17,27,17
2668,4/26/2011,2,0,4,1,0,2,1,1,0.62,0.5909,0.73,0.2836,16,5,21,5
2669,4/26/2011,2,0,4,2,0,2,1,1,0.56,0.5303,0.83,0.3284,17,9,26,9
2670,4/26/2011,2,0,4,3,0,2,1,1,0.54,0.5152,0.88,0.2836,17,4,21,4
2671,4/26/2011,2,0,4,4,0,2,1,1,0.56,0.5303,0.83,0.2537,2,4,6,4
2672,4/26/2011,2,0,4,5,0,2,1,1,0.54,0.5152,0.88,0.2537,0,16,16,16
2673,4/26/2011,2,0,4,6,0,2,1,1,0.56,0.5303,0.88,0.2239,0,80,80,80
2674,4/26/2011,2,0,4,7,0,2,1,1,0.58,0.5455,0.83,0.2985,16,254,270,254
2675,4/26/2011,2,0,4,8,0,2,1,1,0.58,0.5455,0.83,0.2985,32,417,449,417
2676,4/26/2011,2,0,4,9,0,2,1,1,0.64,0.6061,0.73,0.3582,35,164,199,164
2677,4/26/2011,2,0,4,10,0,2,1,1,0.66,0.6212,0.69,0.3582,22,98,120,98
2678,4/26/2011,2,0,4,11,0,2,1,1,0.68,0.6364,0.65,0.3881,40,132,172,132
2679,4/26/2011,2,0,4,12,0,2,1,1,0.7,0.6515,0.61,0.4179,40,146,186,146
2680,4/26/2011,2,0,4,13,0,2,1,1,0.74,0.6667,0.51,0.4478,37,139,176,139
2681,4/26/2011,2,0,4,14,0,2,1,1,0.72,0.6667,0.58,0.3284,40,115,155,115
2682,4/26/2011,2,0,4,15,0,2,1,1,0.7,0.6515,0.61,0.3582,34,119,153,119
2683,4/26/2011,2,0,4,16,0,2,1,1,0.7,0.6515,0.58,0.3881,40,251,291,251
2684,4/26/2011,2,0,4,17,0,2,1,1,0.68,0.6364,0.61,0.3582,66,455,521,455
2685,4/26/2011,2,0,4,18,0,2,1,1,0.68,0.6364,0.65,0.4478,65,463,528,463
2686,4/26/2011,2,0,4,19,0,2,1,1,0.64,0.6061,0.73,0.4179,42,286,328,286
2687,4/26/2011,2,0,4,20,0,2,1,1,0.64,0.6061,0.73,0.3582,35,199,234,199
2688,4/26/2011,2,0,4,21,0,2,1,1,0.62,0.5909,0.78,0.2836,33,162,195,162
2689,4/26/2011,2,0,4,22,0,2,1,2,0.6,0.5606,0.83,0.194,32,116,148,116
2690,4/26/2011,2,0,4,23,0,2,1,2,0.6,0.5606,0.83,0.2239,7,71,78,71
2691,4/27/2011,2,0,4,0,0,3,1,1,0.6,0.5606,0.83,0.2239,3,24,27,24
2692,4/27/2011,2,0,4,1,0,3,1,1,0.6,0.5606,0.83,0.2537,2,15,17,15
2693,4/27/2011,2,0,4,2,0,3,1,1,0.58,0.5455,0.88,0.2537,0,5,5,5
2694,4/27/2011,2,0,4,3,0,3,1,2,0.58,0.5455,0.88,0.2836,3,4,7,4
2695,4/27/2011,2,0,4,4,0,3,1,1,0.56,0.5303,0.94,0.2239,0,6,6,6
2696,4/27/2011,2,0,4,5,0,3,1,2,0.56,0.5303,0.94,0.2537,1,16,17,16
2697,4/27/2011,2,0,4,6,0,3,1,1,0.56,0.5303,0.94,0.2537,5,79,84,79
2698,4/27/2011,2,0,4,7,0,3,1,2,0.58,0.5455,0.88,0.2836,17,229,246,229
2699,4/27/2011,2,0,4,8,0,3,1,2,0.58,0.5455,0.88,0.3284,31,413,444,413
2700,4/27/2011,2,0,4,9,0,3,1,2,0.6,0.5455,0.88,0.4179,20,161,181,161
2701,4/27/2011,2,0,4,10,0,3,1,2,0.62,0.5758,0.83,0.2836,26,66,92,66
2702,4/27/2011,2,0,4,11,0,3,1,2,0.64,0.5909,0.78,0.2836,53,103,156,103
2703,4/27/2011,2,0,4,12,0,3,1,1,0.66,0.6061,0.78,0.3284,38,135,173,135
2704,4/27/2011,2,0,4,13,0,3,1,1,0.64,0.5909,0.78,0.2985,31,119,150,119
2705,4/27/2011,2,0,4,14,0,3,1,1,0.68,0.6364,0.74,0.2836,29,119,148,119
2706,4/27/2011,2,0,4,15,0,3,1,1,0.7,0.6515,0.65,0.4925,18,120,138,120
2707,4/27/2011,2,0,4,16,0,3,1,1,0.7,0.6515,0.7,0.3881,29,189,218,189
2708,4/27/2011,2,0,4,17,0,3,1,3,0.66,0.6061,0.83,0.3881,63,458,521,458
2709,4/27/2011,2,0,4,18,0,3,1,3,0.66,0.6061,0.83,0.3881,46,366,412,366
2710,4/27/2011,2,0,4,19,0,3,1,1,0.62,0.5909,0.78,0.2836,40,220,260,220
2711,4/27/2011,2,0,4,20,0,3,1,1,0.64,0.5758,0.83,0.3284,30,188,218,188
2712,4/27/2011,2,0,4,21,0,3,1,1,0.62,0.5606,0.88,0.2836,19,126,145,126
2713,4/27/2011,2,0,4,22,0,3,1,2,0.62,0.5606,0.88,0.3284,18,111,129,111
2714,4/27/2011,2,0,4,23,0,3,1,2,0.62,0.5606,0.88,0.3582,25,53,78,53
2715,4/28/2011,2,0,4,0,0,4,1,1,0.64,0.5909,0.78,0.3582,13,41,54,41
2716,4/28/2011,2,0,4,1,0,4,1,2,0.62,0.5758,0.83,0.3881,8,12,20,12
2717,4/28/2011,2,0,4,2,0,4,1,2,0.62,0.5758,0.83,0.4478,14,7,21,7
2718,4/28/2011,2,0,4,3,0,4,1,2,0.64,0.5909,0.78,0.3881,2,1,3,1
2719,4/28/2011,2,0,4,4,0,4,1,2,0.62,0.5758,0.83,0.4179,4,5,9,5
2720,4/28/2011,2,0,4,5,0,4,1,2,0.62,0.5758,0.83,0.3881,0,13,13,13
2721,4/28/2011,2,0,4,6,0,4,1,2,0.64,0.5909,0.78,0.4627,7,79,86,79
2722,4/28/2011,2,0,4,7,0,4,1,2,0.64,0.5909,0.78,0.4478,14,201,215,201
2723,4/28/2011,2,0,4,8,0,4,1,2,0.66,0.6061,0.78,0.4478,31,367,398,367
2724,4/28/2011,2,0,4,9,0,4,1,3,0.62,0.5606,0.88,0.3284,18,165,183,165
2725,4/28/2011,2,0,4,10,0,4,1,2,0.62,0.5606,0.88,0.2836,9,45,54,45
2726,4/28/2011,2,0,4,11,0,4,1,2,0.62,0.5758,0.83,0.2836,10,74,84,74
2727,4/28/2011,2,0,4,12,0,4,1,2,0.62,0.5909,0.78,0.2537,23,84,107,84
2728,4/28/2011,2,0,4,13,0,4,1,2,0.62,0.5758,0.83,0.2985,18,103,121,103
2729,4/28/2011,2,0,4,14,0,4,1,1,0.62,0.5758,0.83,0.2985,21,121,142,121
2730,4/28/2011,2,0,4,15,0,4,1,1,0.66,0.6212,0.69,0.3284,46,117,163,117
2731,4/28/2011,2,0,4,16,0,4,1,1,0.62,0.5909,0.78,0.2537,42,228,270,228
2732,4/28/2011,2,0,4,17,0,4,1,1,0.64,0.6212,0.47,0.3582,49,406,455,406
2733,4/28/2011,2,0,4,18,0,4,1,1,0.64,0.6212,0.47,0.3582,44,486,530,486
2734,4/28/2011,2,0,4,19,0,4,1,1,0.62,0.6212,0.43,0.2985,57,347,404,347
2735,4/28/2011,2,0,4,20,0,4,1,1,0.58,0.5455,0.43,0.2239,49,220,269,220
2736,4/28/2011,2,0,4,21,0,4,1,1,0.56,0.5303,0.46,0.1343,27,167,194,167
2737,4/28/2011,2,0,4,22,0,4,1,1,0.54,0.5152,0.45,0.1642,34,119,153,119
2738,4/28/2011,2,0,4,23,0,4,1,1,0.54,0.5152,0.39,0.0896,29,81,110,81
2739,4/29/2011,2,0,4,0,0,5,1,1,0.52,0.5,0.39,0.2836,11,37,48,37
2740,4/29/2011,2,0,4,1,0,5,1,1,0.5,0.4848,0.45,0.0896,10,21,31,21
2741,4/29/2011,2,0,4,2,0,5,1,1,0.46,0.4545,0.63,0.1045,2,8,10,8
2742,4/29/2011,2,0,4,3,0,5,1,1,0.46,0.4545,0.59,0.0896,1,4,5,4
2743,4/29/2011,2,0,4,4,0,5,1,1,0.46,0.4545,0.51,0.1343,0,6,6,6
2744,4/29/2011,2,0,4,5,0,5,1,1,0.46,0.4545,0.47,0.1343,0,25,25,25
2745,4/29/2011,2,0,4,6,0,5,1,1,0.5,0.4848,0.45,0.2836,4,67,71,67
2746,4/29/2011,2,0,4,7,0,5,1,1,0.52,0.5,0.42,0.194,18,222,240,222
2747,4/29/2011,2,0,4,8,0,5,1,1,0.54,0.5152,0.39,0.2985,35,386,421,386
2748,4/29/2011,2,0,4,9,0,5,1,1,0.54,0.5152,0.39,0.3284,45,185,230,185
2749,4/29/2011,2,0,4,10,0,5,1,1,0.56,0.5303,0.4,0.2836,57,99,156,99
2750,4/29/2011,2,0,4,11,0,5,1,1,0.6,0.6212,0.38,0.2239,49,108,157,108
2751,4/29/2011,2,0,4,12,0,5,1,1,0.56,0.5303,0.37,0.2836,63,160,223,160
2752,4/29/2011,2,0,4,13,0,5,1,1,0.56,0.5303,0.37,0.2985,74,234,308,234
2753,4/29/2011,2,0,4,14,0,5,1,1,0.6,0.6212,0.35,0.3284,58,190,248,190
2754,4/29/2011,2,0,4,15,0,5,1,2,0.56,0.5303,0.4,0.2985,77,175,252,175
2755,4/29/2011,2,0,4,16,0,5,1,2,0.54,0.5152,0.42,0.3582,59,240,299,240
2756,4/29/2011,2,0,4,17,0,5,1,2,0.52,0.5,0.45,0.3881,75,433,508,433
2757,4/29/2011,2,0,4,18,0,5,1,1,0.52,0.5,0.48,0.3582,55,384,439,384
2758,4/29/2011,2,0,4,19,0,5,1,1,0.46,0.4545,0.55,0.3284,40,230,270,230
2759,4/29/2011,2,0,4,20,0,5,1,1,0.48,0.4697,0.48,0.2239,34,160,194,160
2760,4/29/2011,2,0,4,21,0,5,1,1,0.46,0.4545,0.51,0.194,50,145,195,145
2761,4/29/2011,2,0,4,22,0,5,1,1,0.42,0.4242,0.58,0.1642,36,110,146,110
2762,4/29/2011,2,0,4,23,0,5,1,2,0.44,0.4394,0.54,0.0896,25,88,113,88
2763,4/30/2011,2,0,4,0,0,6,0,2,0.44,0.4394,0.54,0.2537,33,73,106,73
2764,4/30/2011,2,0,4,1,0,6,0,2,0.44,0.4394,0.54,0.1642,15,59,74,59
2765,4/30/2011,2,0,4,2,0,6,0,2,0.44,0.4394,0.54,0.2239,12,53,65,53
2766,4/30/2011,2,0,4,3,0,6,0,2,0.42,0.4242,0.54,0.194,4,13,17,13
2767,4/30/2011,2,0,4,4,0,6,0,2,0.42,0.4242,0.54,0.2239,2,5,7,5
2768,4/30/2011,2,0,4,5,0,6,0,1,0.42,0.4242,0.54,0.3881,3,4,7,4
2769,4/30/2011,2,0,4,6,0,6,0,1,0.4,0.4091,0.58,0.2836,10,11,21,11
2770,4/30/2011,2,0,4,7,0,6,0,1,0.4,0.4091,0.54,0.3881,21,27,48,27
2771,4/30/2011,2,0,4,8,0,6,0,1,0.4,0.4091,0.54,0.2985,21,70,91,70
2772,4/30/2011,2,0,4,9,0,6,0,1,0.44,0.4394,0.51,0.3582,35,121,156,121
2773,4/30/2011,2,0,4,10,0,6,0,1,0.48,0.4697,0.44,0.3881,94,185,279,185
2774,4/30/2011,2,0,4,11,0,6,0,1,0.5,0.4848,0.42,0.3582,120,201,321,201
2775,4/30/2011,2,0,4,12,0,6,0,1,0.52,0.5,0.42,0.3881,178,238,416,238
2776,4/30/2011,2,0,4,13,0,6,0,1,0.54,0.5152,0.39,0.2985,185,270,455,270
2777,4/30/2011,2,0,4,14,0,6,0,1,0.54,0.5152,0.39,0.2239,184,268,452,268
2778,4/30/2011,2,0,4,15,0,6,0,1,0.56,0.5303,0.37,0.1343,217,282,499,282
2779,4/30/2011,2,0,4,16,0,6,0,1,0.58,0.5455,0.37,0.194,191,273,464,273
2780,4/30/2011,2,0,4,17,0,6,0,1,0.56,0.5303,0.43,0.1343,162,245,407,245
2781,4/30/2011,2,0,4,18,0,6,0,1,0.54,0.5152,0.43,0.1343,134,237,371,237
2782,4/30/2011,2,0,4,19,0,6,0,1,0.54,0.5152,0.43,0.1343,150,237,387,237
2783,4/30/2011,2,0,4,20,0,6,0,1,0.44,0.4394,0.62,0.1343,65,159,224,159
2784,4/30/2011,2,0,4,21,0,6,0,1,0.44,0.4394,0.62,0.1343,58,119,177,119
2785,4/30/2011,2,0,4,22,0,6,0,1,0.44,0.4394,0.67,0.1045,37,106,143,106
2786,4/30/2011,2,0,4,23,0,6,0,1,0.44,0.4394,0.67,0.1045,34,91,125,91
2787,5/1/2011,2,0,5,0,0,0,0,1,0.42,0.4242,0.67,0.0896,19,77,96,77
2788,5/1/2011,2,0,5,1,0,0,0,1,0.42,0.4242,0.69,0.1045,9,50,59,50
2789,5/1/2011,2,0,5,2,0,0,0,1,0.42,0.4242,0.77,0.1045,7,43,50,43
2790,5/1/2011,2,0,5,3,0,0,0,1,0.4,0.4091,0.82,0.1045,8,15,23,15
2791,5/1/2011,2,0,5,4,0,0,0,1,0.4,0.4091,0.76,0.1045,6,11,17,11
2792,5/1/2011,2,0,5,5,0,0,0,1,0.4,0.4091,0.82,0.0896,0,10,10,10
2793,5/1/2011,2,0,5,6,0,0,0,2,0.4,0.4091,0.82,0.0896,4,9,13,9
2794,5/1/2011,2,0,5,7,0,0,0,2,0.42,0.4242,0.77,0.0896,7,26,33,26
2795,5/1/2011,2,0,5,8,0,0,0,2,0.44,0.4394,0.77,0.1343,16,43,59,43
2796,5/1/2011,2,0,5,9,0,0,0,2,0.46,0.4545,0.72,0.1343,45,96,141,96
2797,5/1/2011,2,0,5,10,0,0,0,2,0.48,0.4697,0.63,0.194,109,155,264,155
2798,5/1/2011,2,0,5,11,0,0,0,1,0.46,0.4545,0.82,0.1045,109,141,250,141
2799,5/1/2011,2,0,5,12,0,0,0,2,0.48,0.4697,0.77,0.1045,109,172,281,172
2800,5/1/2011,2,0,5,13,0,0,0,2,0.5,0.4848,0.63,0.1642,123,209,332,209
2801,5/1/2011,2,0,5,14,0,0,0,2,0.5,0.4848,0.68,0.1045,85,153,238,153
2802,5/1/2011,2,0,5,15,0,0,0,2,0.5,0.4848,0.72,0,113,153,266,153
2803,5/1/2011,2,0,5,16,0,0,0,2,0.5,0.4848,0.72,0.194,75,139,214,139
2804,5/1/2011,2,0,5,17,0,0,0,2,0.48,0.4697,0.82,0.2537,60,136,196,136
2805,5/1/2011,2,0,5,18,0,0,0,2,0.46,0.4545,0.82,0.0896,33,126,159,126
2806,5/1/2011,2,0,5,19,0,0,0,2,0.46,0.4545,0.84,0.1045,47,131,178,131
2807,5/1/2011,2,0,5,20,0,0,0,2,0.46,0.4545,0.82,0,35,86,121,86
2808,5/1/2011,2,0,5,21,0,0,0,2,0.46,0.4545,0.82,0,23,82,105,82
2809,5/1/2011,2,0,5,22,0,0,0,2,0.46,0.4545,0.82,0,32,68,100,68
2810,5/1/2011,2,0,5,23,0,0,0,1,0.46,0.4545,0.77,0.194,64,82,146,82
2811,5/2/2011,2,0,5,0,0,1,1,1,0.46,0.4545,0.72,0.1343,68,109,177,109
2812,5/2/2011,2,0,5,1,0,1,1,1,0.46,0.4545,0.72,0.1343,41,73,114,73
2813,5/2/2011,2,0,5,2,0,1,1,2,0.44,0.4394,0.77,0.2239,16,19,35,19
2814,5/2/2011,2,0,5,3,0,1,1,1,0.44,0.4394,0.77,0.1343,9,7,16,7
2815,5/2/2011,2,0,5,4,0,1,1,1,0.44,0.4394,0.77,0.1642,9,8,17,8
2816,5/2/2011,2,0,5,5,0,1,1,2,0.44,0.4394,0.77,0.1343,4,16,20,16
2817,5/2/2011,2,0,5,6,0,1,1,1,0.44,0.4394,0.88,0.1045,3,59,62,59
2818,5/2/2011,2,0,5,7,0,1,1,2,0.46,0.4545,0.82,0.3284,16,193,209,193
2819,5/2/2011,2,0,5,8,0,1,1,2,0.48,0.4697,0.77,0.2239,21,350,371,350
2820,5/2/2011,2,0,5,9,0,1,1,2,0.5,0.4848,0.77,0.2836,41,131,172,131
2821,5/2/2011,2,0,5,10,0,1,1,2,0.54,0.5152,0.77,0.2239,31,77,108,77
2822,5/2/2011,2,0,5,11,0,1,1,1,0.58,0.5455,0.73,0.2985,34,96,130,96
2823,5/2/2011,2,0,5,12,0,1,1,1,0.62,0.6061,0.69,0.2239,40,147,187,147
2824,5/2/2011,2,0,5,13,0,1,1,2,0.62,0.6061,0.69,0.194,51,119,170,119
2825,5/2/2011,2,0,5,14,0,1,1,1,0.64,0.6061,0.69,0.2239,48,133,181,133
2826,5/2/2011,2,0,5,15,0,1,1,1,0.66,0.6212,0.61,0.194,45,110,155,110
2827,5/2/2011,2,0,5,16,0,1,1,1,0.66,0.6212,0.61,0.2239,49,220,269,220
2828,5/2/2011,2,0,5,17,0,1,1,1,0.66,0.6212,0.65,0.194,65,472,537,472
2829,5/2/2011,2,0,5,18,0,1,1,2,0.64,0.6061,0.65,0.194,68,450,518,450
2830,5/2/2011,2,0,5,19,0,1,1,2,0.62,0.6061,0.69,0.1343,46,268,314,268
2831,5/2/2011,2,0,5,20,0,1,1,2,0.62,0.6061,0.69,0.1343,44,174,218,174
2832,5/2/2011,2,0,5,21,0,1,1,2,0.6,0.5909,0.73,0.1045,54,178,232,178
2833,5/2/2011,2,0,5,22,0,1,1,2,0.6,0.5909,0.73,0,28,97,125,97
2834,5/2/2011,2,0,5,23,0,1,1,2,0.56,0.5303,0.83,0.194,16,48,64,48
2835,5/3/2011,2,0,5,0,0,2,1,2,0.56,0.5303,0.83,0.2239,0,16,16,16
2836,5/3/2011,2,0,5,1,0,2,1,2,0.56,0.5303,0.78,0.2537,0,14,14,14
2837,5/3/2011,2,0,5,2,0,2,1,2,0.56,0.5303,0.78,0.2537,0,5,5,5
2838,5/3/2011,2,0,5,3,0,2,1,1,0.54,0.5152,0.83,0.2836,0,2,2,2
2839,5/3/2011,2,0,5,4,0,2,1,1,0.52,0.5,0.88,0.2239,3,1,4,1
2840,5/3/2011,2,0,5,5,0,2,1,1,0.52,0.5,0.88,0.1343,0,14,14,14
2841,5/3/2011,2,0,5,6,0,2,1,2,0.52,0.5,0.94,0.1642,7,102,109,102
2842,5/3/2011,2,0,5,7,0,2,1,2,0.54,0.5152,0.88,0.2239,17,248,265,248
2843,5/3/2011,2,0,5,8,0,2,1,2,0.56,0.5303,0.83,0.2836,24,435,459,435
2844,5/3/2011,2,0,5,9,0,2,1,2,0.6,0.5758,0.78,0.3582,29,157,186,157
2845,5/3/2011,2,0,5,10,0,2,1,2,0.64,0.6061,0.69,0.3582,36,91,127,91
2846,5/3/2011,2,0,5,11,0,2,1,2,0.66,0.6212,0.65,0.3284,20,120,140,120
2847,5/3/2011,2,0,5,12,0,2,1,2,0.68,0.6364,0.61,0.4925,48,169,217,169
2848,5/3/2011,2,0,5,13,0,2,1,2,0.7,0.6515,0.58,0.6119,50,144,194,144
2849,5/3/2011,2,0,5,14,0,2,1,2,0.7,0.6515,0.58,0.5224,36,122,158,122
2850,5/3/2011,2,0,5,15,0,2,1,2,0.7,0.6515,0.58,0.4478,37,117,154,117
2851,5/3/2011,2,0,5,16,0,2,1,1,0.72,0.6667,0.54,0.4627,46,225,271,225
2852,5/3/2011,2,0,5,17,0,2,1,1,0.7,0.6515,0.54,0.4627,53,464,517,464
2853,5/3/2011,2,0,5,18,0,2,1,1,0.7,0.6515,0.48,0.4179,59,485,544,485
2854,5/3/2011,2,0,5,19,0,2,1,1,0.68,0.6364,0.57,0.3582,42,323,365,323
2855,5/3/2011,2,0,5,20,0,2,1,1,0.66,0.6212,0.61,0.194,28,262,290,262
2856,5/3/2011,2,0,5,21,0,2,1,2,0.64,0.6212,0.61,0.4478,42,183,225,183
2857,5/3/2011,2,0,5,22,0,2,1,2,0.58,0.5455,0.6,0.3881,14,99,113,99
2858,5/3/2011,2,0,5,23,0,2,1,2,0.56,0.5303,0.68,0.3284,12,50,62,50
2859,5/4/2011,2,0,5,0,0,3,1,3,0.52,0.5,0.77,0.1642,5,22,27,22
2860,5/4/2011,2,0,5,1,0,3,1,3,0.5,0.4848,0.82,0.2836,1,6,7,6
2861,5/4/2011,2,0,5,2,0,3,1,3,0.5,0.4848,0.82,0.2836,0,4,4,4
2862,5/4/2011,2,0,5,3,0,3,1,3,0.42,0.4242,0.88,0.5224,0,1,1,1
2863,5/4/2011,2,0,5,4,0,3,1,3,0.38,0.3939,0.94,0.3284,1,2,3,2
2864,5/4/2011,2,0,5,5,0,3,1,3,0.36,0.3333,0.87,0.3284,1,8,9,8
2865,5/4/2011,2,0,5,6,0,3,1,3,0.34,0.303,0.93,0.3881,0,21,21,21
2866,5/4/2011,2,0,5,7,0,3,1,3,0.34,0.303,0.93,0.3582,6,46,52,46
2867,5/4/2011,2,0,5,8,0,3,1,3,0.34,0.303,0.93,0.3881,5,74,79,74
2868,5/4/2011,2,0,5,9,0,3,1,3,0.34,0.303,0.93,0.3582,5,35,40,35
2869,5/4/2011,2,0,5,10,0,3,1,2,0.34,0.3182,0.93,0.2836,5,26,31,26
2870,5/4/2011,2,0,5,11,0,3,1,1,0.4,0.4091,0.82,0.3284,3,69,72,69
2871,5/4/2011,2,0,5,12,0,3,1,2,0.44,0.4394,0.62,0.3582,19,105,124,105
2872,5/4/2011,2,0,5,13,0,3,1,2,0.46,0.4545,0.59,0.4478,15,128,143,128
2873,5/4/2011,2,0,5,14,0,3,1,1,0.5,0.4848,0.51,0.3881,13,94,107,94
2874,5/4/2011,2,0,5,15,0,3,1,1,0.48,0.4697,0.51,0.4179,22,107,129,107
2875,5/4/2011,2,0,5,16,0,3,1,1,0.5,0.4848,0.45,0.4627,22,173,195,173
2876,5/4/2011,2,0,5,17,0,3,1,1,0.4,0.4091,0.71,0.2537,22,388,410,388
2877,5/4/2011,2,0,5,18,0,3,1,1,0.42,0.4242,0.67,0.2537,29,367,396,367
2878,5/4/2011,2,0,5,19,0,3,1,1,0.42,0.4242,0.58,0.3582,30,266,296,266
2879,5/4/2011,2,0,5,20,0,3,1,1,0.4,0.4091,0.62,0.3284,17,174,191,174
2880,5/4/2011,2,0,5,21,0,3,1,1,0.4,0.4091,0.62,0.1642,17,133,150,133
2881,5/4/2011,2,0,5,22,0,3,1,1,0.38,0.3939,0.62,0.2239,9,80,89,80
2882,5/4/2011,2,0,5,23,0,3,1,1,0.36,0.3485,0.62,0.2239,8,49,57,49
2883,5/5/2011,2,0,5,0,0,4,1,1,0.36,0.3485,0.66,0.194,4,23,27,23
2884,5/5/2011,2,0,5,1,0,4,1,1,0.34,0.3333,0.71,0.194,4,6,10,6
2885,5/5/2011,2,0,5,2,0,4,1,1,0.34,0.3182,0.66,0.2239,1,4,5,4
2886,5/5/2011,2,0,5,3,0,4,1,1,0.34,0.3182,0.66,0.2537,0,4,4,4
2887,5/5/2011,2,0,5,4,0,4,1,1,0.34,0.3182,0.66,0.2537,4,3,7,3
2888,5/5/2011,2,0,5,5,0,4,1,1,0.34,0.3182,0.66,0.2537,1,29,30,29
2889,5/5/2011,2,0,5,6,0,4,1,1,0.34,0.3182,0.66,0.2537,3,86,89,86
2890,5/5/2011,2,0,5,7,0,4,1,1,0.38,0.3939,0.58,0.2537,16,255,271,255
2891,5/5/2011,2,0,5,8,0,4,1,1,0.42,0.4242,0.5,0.2537,25,415,440,415
2892,5/5/2011,2,0,5,9,0,4,1,1,0.46,0.4545,0.44,0.2836,20,164,184,164
2893,5/5/2011,2,0,5,10,0,4,1,1,0.5,0.4848,0.39,0.2836,30,98,128,98
2894,5/5/2011,2,0,5,11,0,4,1,1,0.52,0.5,0.36,0.4478,43,105,148,105
2895,5/5/2011,2,0,5,12,0,4,1,1,0.52,0.5,0.34,0.3582,27,169,196,169
2896,5/5/2011,2,0,5,13,0,4,1,1,0.54,0.5152,0.3,0.5821,50,142,192,142
2897,5/5/2011,2,0,5,14,0,4,1,1,0.54,0.5152,0.28,0.4478,19,135,154,135
2898,5/5/2011,2,0,5,15,0,4,1,1,0.56,0.5303,0.26,0.4925,27,120,147,120
2899,5/5/2011,2,0,5,16,0,4,1,1,0.58,0.5455,0.24,0.4179,36,233,269,233
2900,5/5/2011,2,0,5,17,0,4,1,1,0.56,0.5303,0.26,0.3881,66,467,533,467
2901,5/5/2011,2,0,5,18,0,4,1,1,0.56,0.5303,0.26,0.2836,64,456,520,456
2902,5/5/2011,2,0,5,19,0,4,1,1,0.54,0.5152,0.28,0.2239,56,305,361,305
2903,5/5/2011,2,0,5,20,0,4,1,1,0.5,0.4848,0.34,0.1642,33,225,258,225
2904,5/5/2011,2,0,5,21,0,4,1,1,0.5,0.4848,0.36,0.194,39,141,180,141
2905,5/5/2011,2,0,5,22,0,4,1,1,0.48,0.4697,0.39,0.194,30,135,165,135
2906,5/5/2011,2,0,5,23,0,4,1,1,0.46,0.4545,0.41,0.194,16,99,115,99
2907,5/6/2011,2,0,5,0,0,5,1,1,0.44,0.4394,0.44,0.1642,13,43,56,43
2908,5/6/2011,2,0,5,1,0,5,1,1,0.4,0.4091,0.62,0.1642,8,24,32,24
2909,5/6/2011,2,0,5,2,0,5,1,1,0.38,0.3939,0.62,0.1045,1,15,16,15
2910,5/6/2011,2,0,5,3,0,5,1,1,0.36,0.3636,0.71,0.1045,3,6,9,6
2911,5/6/2011,2,0,5,4,0,5,1,1,0.36,0.3636,0.71,0.1045,0,1,1,1
2912,5/6/2011,2,0,5,5,0,5,1,1,0.34,0.3485,0.81,0.1045,0,16,16,16
2913,5/6/2011,2,0,5,6,0,5,1,1,0.36,0.3636,0.81,0.0896,8,74,82,74
2914,5/6/2011,2,0,5,7,0,5,1,1,0.4,0.4091,0.82,0,20,202,222,202
2915,5/6/2011,2,0,5,8,0,5,1,1,0.42,0.4242,0.77,0.2537,35,415,450,415
2916,5/6/2011,2,0,5,9,0,5,1,1,0.46,0.4545,0.67,0.2836,27,161,188,161
2917,5/6/2011,2,0,5,10,0,5,1,2,0.54,0.5152,0.49,0.3284,30,97,127,97
2918,5/6/2011,2,0,5,11,0,5,1,2,0.54,0.5152,0.49,0.3284,42,123,165,123
2919,5/6/2011,2,0,5,12,0,5,1,1,0.56,0.5303,0.49,0.3582,48,198,246,198
2920,5/6/2011,2,0,5,13,0,5,1,1,0.58,0.5455,0.4,0.3284,71,182,253,182
2921,5/6/2011,2,0,5,14,0,5,1,1,0.6,0.6212,0.4,0.4478,86,127,213,127
2922,5/6/2011,2,0,5,15,0,5,1,1,0.6,0.6212,0.38,0.3881,89,171,260,171
2923,5/6/2011,2,0,5,16,0,5,1,1,0.6,0.6212,0.4,0.2537,82,262,344,262
2924,5/6/2011,2,0,5,17,0,5,1,1,0.58,0.5455,0.4,0.3582,83,470,553,470
2925,5/6/2011,2,0,5,18,0,5,1,3,0.54,0.5152,0.52,0.3582,85,385,470,385
2926,5/6/2011,2,0,5,19,0,5,1,3,0.54,0.5152,0.52,0.3582,39,253,292,253
2927,5/6/2011,2,0,5,20,0,5,1,1,0.52,0.5,0.48,0.1045,29,161,190,161
2928,5/6/2011,2,0,5,21,0,5,1,1,0.48,0.4697,0.67,0.1343,22,130,152,130
2929,5/6/2011,2,0,5,22,0,5,1,1,0.46,0.4545,0.72,0.2239,46,105,151,105
2930,5/6/2011,2,0,5,23,0,5,1,1,0.44,0.4394,0.82,0.1343,27,93,120,93
2931,5/7/2011,2,0,5,0,0,6,0,1,0.42,0.4242,0.82,0.1343,10,76,86,76
2932,5/7/2011,2,0,5,1,0,6,0,1,0.42,0.4242,0.82,0.1045,8,50,58,50
2933,5/7/2011,2,0,5,2,0,6,0,1,0.42,0.4242,0.82,0.0896,5,47,52,47
2934,5/7/2011,2,0,5,3,0,6,0,1,0.42,0.4242,0.77,0.0896,9,9,18,9
2935,5/7/2011,2,0,5,4,0,6,0,1,0.4,0.4091,0.82,0.1045,1,4,5,4
2936,5/7/2011,2,0,5,5,0,6,0,1,0.46,0.4545,0.59,0.1343,4,3,7,3
2937,5/7/2011,2,0,5,6,0,6,0,1,0.42,0.4242,0.77,0.0896,1,12,13,12
2938,5/7/2011,2,0,5,7,0,6,0,1,0.48,0.4697,0.59,0,8,32,40,32
2939,5/7/2011,2,0,5,8,0,6,0,1,0.52,0.5,0.52,0.194,19,96,115,96
2940,5/7/2011,2,0,5,9,0,6,0,1,0.54,0.5152,0.49,0.2836,54,164,218,164
2941,5/7/2011,2,0,5,10,0,6,0,1,0.56,0.5303,0.49,0.2985,90,208,298,208
2942,5/7/2011,2,0,5,11,0,6,0,1,0.56,0.5303,0.43,0,132,215,347,215
2943,5/7/2011,2,0,5,12,0,6,0,1,0.6,0.6212,0.4,0.194,129,244,373,244
2944,5/7/2011,2,0,5,13,0,6,0,1,0.6,0.6212,0.35,0.2836,196,240,436,240
2945,5/7/2011,2,0,5,14,0,6,0,3,0.6,0.6212,0.35,0.1642,143,235,378,235
2946,5/7/2011,2,0,5,15,0,6,0,1,0.6,0.6212,0.38,0.2537,148,230,378,230
2947,5/7/2011,2,0,5,16,0,6,0,1,0.6,0.6212,0.38,0.194,119,223,342,223
2948,5/7/2011,2,0,5,17,0,6,0,1,0.58,0.5455,0.4,0.2239,138,216,354,216
2949,5/7/2011,2,0,5,18,0,6,0,1,0.58,0.5455,0.37,0.1642,114,175,289,175
2950,5/7/2011,2,0,5,19,0,6,0,1,0.56,0.5303,0.43,0.194,88,179,267,179
2951,5/7/2011,2,0,5,20,0,6,0,1,0.56,0.5303,0.43,0.1343,82,137,219,137
2952,5/7/2011,2,0,5,21,0,6,0,1,0.54,0.5152,0.49,0.2239,58,124,182,124
2953,5/7/2011,2,0,5,22,0,6,0,1,0.54,0.5152,0.49,0.194,26,94,120,94
2954,5/7/2011,2,0,5,23,0,6,0,1,0.5,0.4848,0.59,0.1045,30,89,119,89
2955,5/8/2011,2,0,5,0,0,0,0,2,0.5,0.4848,0.59,0.1045,22,78,100,78
2956,5/8/2011,2,0,5,1,0,0,0,2,0.52,0.5,0.55,0,8,56,64,56
2957,5/8/2011,2,0,5,2,0,0,0,1,0.48,0.4697,0.63,0,17,42,59,42
2958,5/8/2011,2,0,5,3,0,0,0,1,0.46,0.4545,0.72,0.0896,10,21,31,21
2959,5/8/2011,2,0,5,4,0,0,0,1,0.42,0.4242,0.82,0,2,8,10,8
2960,5/8/2011,2,0,5,5,0,0,0,2,0.44,0.4394,0.77,0,0,5,5,5
2961,5/8/2011,2,0,5,6,0,0,0,2,0.44,0.4394,0.82,0,2,4,6,4
2962,5/8/2011,2,0,5,7,0,0,0,2,0.46,0.4545,0.82,0,8,15,23,15
2963,5/8/2011,2,0,5,8,0,0,0,1,0.52,0.5,0.63,0.1343,28,58,86,58
2964,5/8/2011,2,0,5,9,0,0,0,1,0.56,0.5303,0.52,0.2239,48,112,160,112
2965,5/8/2011,2,0,5,10,0,0,0,1,0.58,0.5455,0.49,0.1343,91,153,244,153
2966,5/8/2011,2,0,5,11,0,0,0,1,0.58,0.5455,0.49,0.0896,142,198,340,198
2967,5/8/2011,2,0,5,12,0,0,0,1,0.6,0.6212,0.46,0.0896,139,243,382,243
2968,5/8/2011,2,0,5,13,0,0,0,1,0.6,0.6212,0.49,0.1343,166,224,390,224
2969,5/8/2011,2,0,5,14,0,0,0,1,0.6,0.6212,0.49,0,126,240,366,240
2970,5/8/2011,2,0,5,15,0,0,0,1,0.6,0.6212,0.49,0,128,230,358,230
2971,5/8/2011,2,0,5,16,0,0,0,1,0.6,0.6212,0.46,0.1045,122,263,385,263
2972,5/8/2011,2,0,5,17,0,0,0,3,0.58,0.5455,0.49,0.2836,106,245,351,245
2973,5/8/2011,2,0,5,18,0,0,0,1,0.58,0.5455,0.49,0,63,205,268,205
2974,5/8/2011,2,0,5,19,0,0,0,1,0.56,0.5303,0.64,0,61,178,239,178
2975,5/8/2011,2,0,5,20,0,0,0,1,0.52,0.5,0.77,0.1343,42,132,174,132
2976,5/8/2011,2,0,5,21,0,0,0,1,0.52,0.5,0.77,0.0896,32,95,127,95
2977,5/8/2011,2,0,5,22,0,0,0,1,0.5,0.4848,0.88,0.0896,29,86,115,86
2978,5/8/2011,2,0,5,23,0,0,0,1,0.46,0.4545,0.88,0.0896,9,41,50,41
2979,5/9/2011,2,0,5,0,0,1,1,1,0.46,0.4545,0.82,0.0896,31,22,53,22
2980,5/9/2011,2,0,5,1,0,1,1,1,0.44,0.4394,0.88,0,25,8,33,8
2981,5/9/2011,2,0,5,2,0,1,1,1,0.44,0.4394,0.94,0,6,2,8,2
2982,5/9/2011,2,0,5,3,0,1,1,1,0.46,0.4545,0.82,0.0896,0,7,7,7
2983,5/9/2011,2,0,5,4,0,1,1,1,0.42,0.4242,0.82,0.1642,0,4,4,4
2984,5/9/2011,2,0,5,5,0,1,1,1,0.42,0.4242,0.77,0.1642,0,23,23,23
2985,5/9/2011,2,0,5,6,0,1,1,1,0.44,0.4394,0.72,0.2537,2,87,89,87
2986,5/9/2011,2,0,5,7,0,1,1,1,0.48,0.4697,0.63,0.2537,16,221,237,221
2987,5/9/2011,2,0,5,8,0,1,1,1,0.52,0.5,0.55,0.2239,23,351,374,351
2988,5/9/2011,2,0,5,9,0,1,1,1,0.54,0.5152,0.56,0.1642,36,142,178,142
2989,5/9/2011,2,0,5,10,0,1,1,1,0.56,0.5303,0.52,0.194,24,95,119,95
2990,5/9/2011,2,0,5,11,0,1,1,1,0.6,0.6212,0.46,0.2239,26,99,125,99
2991,5/9/2011,2,0,5,12,0,1,1,1,0.6,0.6212,0.43,0.194,35,160,195,160
2992,5/9/2011,2,0,5,13,0,1,1,1,0.62,0.6212,0.38,0.2836,36,138,174,138
2993,5/9/2011,2,0,5,14,0,1,1,1,0.62,0.6212,0.41,0.2239,44,118,162,118
2994,5/9/2011,2,0,5,15,0,1,1,1,0.62,0.6212,0.41,0.2239,51,148,199,148
2995,5/9/2011,2,0,5,16,0,1,1,1,0.64,0.6212,0.38,0.2239,49,255,304,255
2996,5/9/2011,2,0,5,17,0,1,1,1,0.62,0.6212,0.38,0.2537,59,539,598,539
2997,5/9/2011,2,0,5,18,0,1,1,1,0.62,0.6212,0.38,0.2985,66,458,524,458
2998,5/9/2011,2,0,5,19,0,1,1,1,0.58,0.5455,0.43,0.194,45,339,384,339
2999,5/9/2011,2,0,5,20,0,1,1,1,0.54,0.5152,0.49,0.194,25,214,239,214
3000,5/9/2011,2,0,5,21,0,1,1,1,0.52,0.5,0.59,0.1343,28,128,156,128
3001,5/9/2011,2,0,5,22,0,1,1,1,0.52,0.5,0.68,0.0896,21,95,116,95
3002,5/9/2011,2,0,5,23,0,1,1,1,0.5,0.4848,0.68,0.0896,16,45,61,45
3003,5/10/2011,2,0,5,0,0,2,1,1,0.48,0.4697,0.63,0,6,12,18,12
3004,5/10/2011,2,0,5,1,0,2,1,1,0.46,0.4545,0.59,0.0896,3,12,15,12
3005,5/10/2011,2,0,5,2,0,2,1,1,0.44,0.4394,0.58,0.1343,1,4,5,4
3006,5/10/2011,2,0,5,3,0,2,1,1,0.44,0.4394,0.54,0.194,1,3,4,3
3007,5/10/2011,2,0,5,4,0,2,1,1,0.42,0.4242,0.62,0.2537,0,2,2,2
3008,5/10/2011,2,0,5,5,0,2,1,1,0.4,0.4091,0.66,0.2239,1,28,29,28
3009,5/10/2011,2,0,5,6,0,2,1,1,0.42,0.4242,0.67,0.1343,9,103,112,103
3010,5/10/2011,2,0,5,7,0,2,1,2,0.44,0.4394,0.62,0.1343,13,301,314,301
3011,5/10/2011,2,0,5,8,0,2,1,2,0.5,0.4848,0.51,0.1045,28,397,425,397
3012,5/10/2011,2,0,5,9,0,2,1,2,0.52,0.5,0.48,0.1045,29,176,205,176
3013,5/10/2011,2,0,5,10,0,2,1,2,0.56,0.5303,0.37,0.0896,27,100,127,100
3014,5/10/2011,2,0,5,11,0,2,1,2,0.56,0.5303,0.43,0.1343,17,108,125,108
3015,5/10/2011,2,0,5,12,0,2,1,2,0.6,0.6212,0.38,0,47,170,217,170
3016,5/10/2011,2,0,5,13,0,2,1,2,0.62,0.6212,0.38,0.2537,50,152,202,152
3017,5/10/2011,2,0,5,14,0,2,1,2,0.62,0.6212,0.33,0,42,134,176,134
3018,5/10/2011,2,0,5,15,0,2,1,2,0.64,0.6212,0.33,0.0896,28,152,180,152
3019,5/10/2011,2,0,5,16,0,2,1,1,0.66,0.6212,0.31,0.1045,56,271,327,271
3020,5/10/2011,2,0,5,17,0,2,1,1,0.64,0.6212,0.33,0,79,532,611,532
3021,5/10/2011,2,0,5,18,0,2,1,1,0.64,0.6212,0.29,0.1343,70,480,550,480
3022,5/10/2011,2,0,5,19,0,2,1,1,0.6,0.6212,0.43,0.2239,69,365,434,365
3023,5/10/2011,2,0,5,20,0,2,1,1,0.54,0.5152,0.6,0.1343,50,241,291,241
3024,5/10/2011,2,0,5,21,0,2,1,1,0.54,0.5152,0.52,0,30,173,203,173
3025,5/10/2011,2,0,5,22,0,2,1,1,0.52,0.5,0.55,0.1045,29,121,150,121
3026,5/10/2011,2,0,5,23,0,2,1,2,0.52,0.5,0.59,0.1343,9,72,81,72
3027,5/11/2011,2,0,5,0,0,3,1,2,0.52,0.5,0.55,0.1343,8,30,38,30
3028,5/11/2011,2,0,5,1,0,3,1,2,0.5,0.4848,0.59,0.1045,4,16,20,16
3029,5/11/2011,2,0,5,2,0,3,1,1,0.52,0.5,0.59,0,6,4,10,4
3030,5/11/2011,2,0,5,3,0,3,1,1,0.5,0.4848,0.63,0.2239,0,3,3,3
3031,5/11/2011,2,0,5,4,0,3,1,2,0.48,0.4697,0.88,0.1343,0,2,2,2
3032,5/11/2011,2,0,5,5,0,3,1,1,0.46,0.4545,0.88,0.1343,0,20,20,20
3033,5/11/2011,2,0,5,6,0,3,1,1,0.46,0.4545,0.82,0.1343,6,93,99,93
3034,5/11/2011,2,0,5,7,0,3,1,1,0.48,0.4697,0.72,0.194,25,293,318,293
3035,5/11/2011,2,0,5,8,0,3,1,1,0.48,0.4697,0.77,0.2537,21,421,442,421
3036,5/11/2011,2,0,5,9,0,3,1,1,0.52,0.5,0.72,0.1343,21,182,203,182
3037,5/11/2011,2,0,5,10,0,3,1,1,0.54,0.5152,0.68,0.0896,30,124,154,124
3038,5/11/2011,2,0,5,11,0,3,1,1,0.56,0.5303,0.64,0.0896,18,123,141,123
3039,5/11/2011,2,0,5,12,0,3,1,1,0.6,0.6212,0.56,0,41,185,226,185
3040,5/11/2011,2,0,5,13,0,3,1,1,0.62,0.6212,0.5,0,36,157,193,157
3041,5/11/2011,2,0,5,14,0,3,1,1,0.62,0.6212,0.53,0.0896,36,141,177,141
3042,5/11/2011,2,0,5,15,0,3,1,1,0.64,0.6212,0.41,0,48,131,179,131
3043,5/11/2011,2,0,5,16,0,3,1,1,0.66,0.6212,0.39,0,49,240,289,240
3044,5/11/2011,2,0,5,17,0,3,1,1,0.64,0.6212,0.47,0.1045,17,242,259,242
3045,5/11/2011,2,0,5,18,0,3,1,1,0.62,0.6212,0.5,0.2985,40,234,274,234
3046,5/11/2011,2,0,5,19,0,3,1,1,0.56,0.5303,0.52,0.1343,60,341,401,341
3047,5/11/2011,2,0,5,20,0,3,1,1,0.54,0.5152,0.64,0.1343,28,245,273,245
3048,5/11/2011,2,0,5,21,0,3,1,1,0.54,0.5152,0.6,0,32,202,234,202
3049,5/11/2011,2,0,5,22,0,3,1,1,0.5,0.4848,0.72,0.2537,12,134,146,134
3050,5/11/2011,2,0,5,23,0,3,1,1,0.46,0.4545,0.88,0.2537,12,69,81,69
3051,5/12/2011,2,0,5,0,0,4,1,2,0.46,0.4545,0.88,0.2239,5,39,44,39
3052,5/12/2011,2,0,5,1,0,4,1,1,0.46,0.4545,0.88,0.2239,1,16,17,16
3053,5/12/2011,2,0,5,2,0,4,1,1,0.44,0.4394,0.94,0.194,1,14,15,14
3054,5/12/2011,2,0,5,3,0,4,1,1,0.44,0.4394,0.88,0.1343,0,5,5,5
3055,5/12/2011,2,0,5,4,0,4,1,1,0.42,0.4242,0.94,0,1,5,6,5
3056,5/12/2011,2,0,5,5,0,4,1,1,0.42,0.4242,0.94,0.1343,2,27,29,27
3057,5/12/2011,2,0,5,6,0,4,1,1,0.44,0.4394,0.88,0,9,103,112,103
3058,5/12/2011,2,0,5,7,0,4,1,1,0.46,0.4545,0.88,0.1343,14,283,297,283
3059,5/12/2011,2,0,5,8,0,4,1,1,0.48,0.4697,0.82,0.194,27,394,421,394
3060,5/12/2011,2,0,5,9,0,4,1,2,0.5,0.4848,0.77,0.2836,21,191,212,191
3061,5/12/2011,2,0,5,10,0,4,1,2,0.54,0.5152,0.68,0.2239,28,119,147,119
3062,5/12/2011,2,0,5,11,0,4,1,1,0.58,0.5455,0.6,0.2239,43,136,179,136
3063,5/12/2011,2,0,5,12,0,4,1,1,0.58,0.5455,0.6,0.2239,43,164,207,164
3064,5/12/2011,2,0,5,13,0,4,1,2,0.62,0.6212,0.57,0.2985,48,170,218,170
3065,5/12/2011,2,0,5,14,0,4,1,2,0.62,0.6061,0.61,0.2239,43,148,191,148
3066,5/12/2011,2,0,5,15,0,4,1,2,0.64,0.6212,0.53,0.2537,54,163,217,163
3067,5/12/2011,2,0,5,16,0,4,1,2,0.64,0.6212,0.57,0.2537,50,238,288,238
3068,5/12/2011,2,0,5,17,0,4,1,2,0.64,0.6212,0.57,0.194,54,540,594,540
3069,5/12/2011,2,0,5,18,0,4,1,1,0.62,0.6061,0.69,0.2239,64,463,527,463
3070,5/12/2011,2,0,5,19,0,4,1,2,0.6,0.6061,0.64,0.194,59,305,364,305
3071,5/12/2011,2,0,5,20,0,4,1,1,0.6,0.6061,0.64,0.194,56,220,276,220
3072,5/12/2011,2,0,5,21,0,4,1,1,0.56,0.5303,0.83,0.1343,31,192,223,192
3073,5/12/2011,2,0,5,22,0,4,1,1,0.54,0.5152,0.83,0.194,25,147,172,147
3074,5/12/2011,2,0,5,23,0,4,1,2,0.54,0.5152,0.77,0.194,16,87,103,87
3075,5/13/2011,2,0,5,0,0,5,1,2,0.52,0.5,0.83,0.1642,6,46,52,46
3076,5/13/2011,2,0,5,1,0,5,1,1,0.52,0.5,0.83,0.1642,5,15,20,15
3077,5/13/2011,2,0,5,2,0,5,1,2,0.5,0.4848,0.88,0.1343,3,8,11,8
3078,5/13/2011,2,0,5,3,0,5,1,2,0.5,0.4848,0.88,0.1343,2,2,4,2
3079,5/13/2011,2,0,5,4,0,5,1,3,0.5,0.4848,0.88,0.1642,2,3,5,3
3080,5/13/2011,2,0,5,5,0,5,1,2,0.5,0.4848,0.88,0.194,1,24,25,24
3081,5/13/2011,2,0,5,6,0,5,1,3,0.5,0.4848,0.88,0.1343,6,76,82,76
3082,5/13/2011,2,0,5,7,0,5,1,3,0.5,0.4848,0.88,0.1642,16,141,157,141
3083,5/13/2011,2,0,5,8,0,5,1,2,0.5,0.4848,0.88,0.194,26,361,387,361
3084,5/13/2011,2,0,5,9,0,5,1,2,0.5,0.4848,0.88,0.194,18,215,233,215
3085,5/13/2011,2,0,5,10,0,5,1,2,0.52,0.5,0.83,0.1343,31,99,130,99
3086,5/13/2011,2,0,5,11,0,5,1,2,0.52,0.5,0.83,0.1642,56,90,146,90
3087,5/13/2011,2,0,5,12,0,5,1,2,0.52,0.5,0.88,0.194,53,170,223,170
3088,5/13/2011,2,0,5,13,0,5,1,2,0.52,0.5,0.88,0.3881,69,157,226,157
3089,5/13/2011,2,0,5,14,0,5,1,2,0.52,0.5,0.87,0.2836,70,120,190,120
3090,5/13/2011,2,0,5,15,0,5,1,2,0.52,0.5,0.88,0.1642,56,142,198,142
3091,5/13/2011,2,0,5,16,0,5,1,2,0.52,0.5,0.88,0.1343,44,256,300,256
3092,5/13/2011,2,0,5,17,0,5,1,3,0.52,0.5,0.88,0.1642,62,429,491,429
3093,5/13/2011,2,0,5,18,0,5,1,3,0.52,0.5,0.88,0.1642,39,359,398,359
3094,5/13/2011,2,0,5,19,0,5,1,2,0.52,0.5,0.83,0.194,25,245,270,245
3095,5/13/2011,2,0,5,20,0,5,1,2,0.52,0.5,0.83,0.1343,22,130,152,130
3096,5/13/2011,2,0,5,21,0,5,1,2,0.52,0.5,0.84,0.1642,24,130,154,130
3097,5/13/2011,2,0,5,22,0,5,1,2,0.52,0.5,0.83,0.2239,25,107,132,107
3098,5/13/2011,2,0,5,23,0,5,1,3,0.5,0.4848,0.88,0.1642,31,88,119,88
3099,5/14/2011,2,0,5,0,0,6,0,2,0.5,0.4848,0.88,0.1343,24,78,102,78
3100,5/14/2011,2,0,5,1,0,6,0,2,0.5,0.4848,0.88,0.1343,18,64,82,64
3101,5/14/2011,2,0,5,2,0,6,0,2,0.5,0.4848,0.88,0.1343,15,37,52,37
3102,5/14/2011,2,0,5,3,0,6,0,2,0.5,0.4848,0.88,0.1343,5,30,35,30
3103,5/14/2011,2,0,5,4,0,6,0,2,0.5,0.4848,0.82,0.1642,1,4,5,4
3104,5/14/2011,2,0,5,5,0,6,0,2,0.5,0.4848,0.82,0.1045,7,7,14,7
3105,5/14/2011,2,0,5,6,0,6,0,2,0.5,0.4848,0.88,0.1045,2,9,11,9
3106,5/14/2011,2,0,5,7,0,6,0,3,0.48,0.4697,1,0,4,28,32,28
3107,5/14/2011,2,0,5,8,0,6,0,3,0.5,0.4848,0.94,0,16,72,88,72
3108,5/14/2011,2,0,5,9,0,6,0,2,0.52,0.5,0.94,0.0896,14,86,100,86
3109,5/14/2011,2,0,5,10,0,6,0,2,0.52,0.5,0.94,0.1642,34,133,167,133
3110,5/14/2011,2,0,5,11,0,6,0,2,0.52,0.5,0.94,0.1343,72,207,279,207
3111,5/14/2011,2,0,5,12,0,6,0,3,0.52,0.5,1,0.0896,75,204,279,204
3112,5/14/2011,2,0,5,13,0,6,0,3,0.52,0.5,1,0.0896,68,180,248,180
3113,5/14/2011,2,0,5,14,0,6,0,2,0.54,0.5152,0.94,0.1343,57,159,216,159
3114,5/14/2011,2,0,5,15,0,6,0,2,0.54,0.5152,0.94,0.1642,73,221,294,221
3115,5/14/2011,2,0,5,16,0,6,0,2,0.54,0.5152,0.94,0.194,107,188,295,188
3116,5/14/2011,2,0,5,17,0,6,0,2,0.56,0.5303,0.88,0.194,78,194,272,194
3117,5/14/2011,2,0,5,18,0,6,0,2,0.56,0.5303,0.88,0.2239,88,216,304,216
3118,5/14/2011,2,0,5,19,0,6,0,3,0.54,0.5152,0.94,0.1343,69,179,248,179
3119,5/14/2011,2,0,5,20,0,6,0,3,0.54,0.5152,0.94,0.1343,42,115,157,115
3120,5/14/2011,2,0,5,21,0,6,0,3,0.54,0.5152,0.94,0.2239,15,44,59,44
3121,5/14/2011,2,0,5,22,0,6,0,3,0.54,0.5152,0.94,0.1642,7,19,26,19
3122,5/14/2011,2,0,5,23,0,6,0,3,0.52,0.5,1,0.194,11,33,44,33
3123,5/15/2011,2,0,5,0,0,0,0,2,0.52,0.5,1,0,5,34,39,34
3124,5/15/2011,2,0,5,1,0,0,0,2,0.52,0.5,1,0.1045,4,43,47,43
3125,5/15/2011,2,0,5,2,0,0,0,2,0.52,0.5,1,0.1343,13,37,50,37
3126,5/15/2011,2,0,5,3,0,0,0,2,0.52,0.5,1,0,11,21,32,21
3127,5/15/2011,2,0,5,4,0,0,0,2,0.52,0.5,1,0,5,8,13,8
3128,5/15/2011,2,0,5,5,0,0,0,3,0.52,0.5,1,0.1045,3,11,14,11
3129,5/15/2011,2,0,5,6,0,0,0,2,0.52,0.5,1,0.1343,3,14,17,14
3130,5/15/2011,2,0,5,7,0,0,0,2,0.52,0.5,1,0.1343,4,38,42,38
3131,5/15/2011,2,0,5,8,0,0,0,2,0.54,0.5152,0.94,0.1343,24,46,70,46
3132,5/15/2011,2,0,5,9,0,0,0,1,0.58,0.5455,0.83,0.2537,36,98,134,98
3133,5/15/2011,2,0,5,10,0,0,0,1,0.58,0.5455,0.83,0.2239,73,153,226,153
3134,5/15/2011,2,0,5,11,0,0,0,1,0.6,0.5758,0.78,0.2239,120,202,322,202
3135,5/15/2011,2,0,5,12,0,0,0,1,0.62,0.5909,0.73,0.2985,120,247,367,247
3136,5/15/2011,2,0,5,13,0,0,0,1,0.62,0.5909,0.73,0.2836,195,261,456,261
3137,5/15/2011,2,0,5,14,0,0,0,1,0.64,0.6061,0.73,0.194,183,254,437,254
3138,5/15/2011,2,0,5,15,0,0,0,1,0.66,0.6212,0.69,0.2537,206,253,459,253
3139,5/15/2011,2,0,5,16,0,0,0,1,0.64,0.6061,0.69,0.2537,158,282,440,282
3140,5/15/2011,2,0,5,17,0,0,0,3,0.56,0.5303,0.78,0.3582,137,255,392,255
3141,5/15/2011,2,0,5,18,0,0,0,1,0.56,0.5303,0.78,0.2537,60,177,237,177
3142,5/15/2011,2,0,5,19,0,0,0,1,0.56,0.5303,0.83,0.1045,78,153,231,153
3143,5/15/2011,2,0,5,20,0,0,0,1,0.54,0.5152,0.88,0,53,138,191,138
3144,5/15/2011,2,0,5,21,0,0,0,1,0.54,0.5152,0.88,0,44,107,151,107
3145,5/15/2011,2,0,5,22,0,0,0,1,0.56,0.5303,0.83,0,29,88,117,88
3146,5/15/2011,2,0,5,23,0,0,0,1,0.54,0.5152,0.88,0.2239,18,51,69,51
3147,5/16/2011,2,0,5,0,0,1,1,1,0.52,0.5,0.94,0.1045,17,21,38,21
3148,5/16/2011,2,0,5,1,0,1,1,1,0.52,0.5,0.94,0.1343,6,8,14,8
3149,5/16/2011,2,0,5,2,0,1,1,1,0.5,0.4848,1,0.0896,4,9,13,9
3150,5/16/2011,2,0,5,3,0,1,1,1,0.5,0.4848,0.94,0.1642,1,3,4,3
3151,5/16/2011,2,0,5,4,0,1,1,1,0.5,0.4848,1,0.1343,1,5,6,5
3152,5/16/2011,2,0,5,5,0,1,1,1,0.5,0.4848,0.93,0.194,1,20,21,20
3153,5/16/2011,2,0,5,6,0,1,1,1,0.52,0.5,0.88,0.1642,11,93,104,93
3154,5/16/2011,2,0,5,7,0,1,1,1,0.52,0.5,0.83,0.2836,27,245,272,245
3155,5/16/2011,2,0,5,8,0,1,1,1,0.56,0.5303,0.73,0.2985,28,366,394,366
3156,5/16/2011,2,0,5,9,0,1,1,1,0.6,0.5909,0.69,0.194,38,156,194,156
3157,5/16/2011,2,0,5,10,0,1,1,1,0.62,0.6061,0.65,0.0896,37,75,112,75
3158,5/16/2011,2,0,5,11,0,1,1,1,0.64,0.6212,0.57,0,56,129,185,129
3159,5/16/2011,2,0,5,12,0,1,1,1,0.66,0.6212,0.54,0.0896,72,137,209,137
3160,5/16/2011,2,0,5,13,0,1,1,1,0.68,0.6364,0.51,0,61,153,214,153
3161,5/16/2011,2,0,5,14,0,1,1,1,0.68,0.6364,0.51,0,76,117,193,117
3162,5/16/2011,2,0,5,15,0,1,1,1,0.72,0.6667,0.51,0,55,110,165,110
3163,5/16/2011,2,0,5,16,0,1,1,3,0.6,0.5758,0.78,0.2537,45,181,226,181
3164,5/16/2011,2,0,5,17,0,1,1,1,0.58,0.5455,0.88,0.2239,47,227,274,227
3165,5/16/2011,2,0,5,18,0,1,1,3,0.58,0.5455,0.83,0.194,55,398,453,398
3166,5/16/2011,2,0,5,19,0,1,1,1,0.58,0.5455,0.83,0.2537,36,272,308,272
3167,5/16/2011,2,0,5,20,0,1,1,1,0.58,0.5455,0.83,0,31,167,198,167
3168,5/16/2011,2,0,5,21,0,1,1,1,0.58,0.5455,0.83,0,28,149,177,149
3169,5/16/2011,2,0,5,22,0,1,1,1,0.56,0.5303,0.88,0.0896,22,105,127,105
3170,5/16/2011,2,0,5,23,0,1,1,1,0.56,0.5303,0.88,0.0896,18,39,57,39
3171,5/17/2011,2,0,5,0,0,2,1,2,0.56,0.5303,0.88,0,13,18,31,18
3172,5/17/2011,2,0,5,1,0,2,1,3,0.56,0.5303,0.88,0,7,6,13,6
3173,5/17/2011,2,0,5,2,0,2,1,3,0.56,0.5303,0.88,0,4,4,8,4
3174,5/17/2011,2,0,5,3,0,2,1,3,0.54,0.5152,0.94,0.2537,1,3,4,3
3175,5/17/2011,2,0,5,4,0,2,1,3,0.54,0.5152,0.94,0.2537,2,2,4,2
3176,5/17/2011,2,0,5,5,0,2,1,3,0.52,0.5,0.94,0.2537,0,22,22,22
3177,5/17/2011,2,0,5,6,0,2,1,3,0.52,0.5,0.94,0.2537,0,49,49,49
3178,5/17/2011,2,0,5,7,0,2,1,2,0.52,0.5,0.94,0.2537,13,138,151,138
3179,5/17/2011,2,0,5,8,0,2,1,2,0.52,0.5,0.94,0.2985,22,325,347,325
3180,5/17/2011,2,0,5,9,0,2,1,2,0.54,0.5152,0.88,0.2537,17,190,207,190
3181,5/17/2011,2,0,5,10,0,2,1,3,0.54,0.5152,0.88,0.2537,31,73,104,73
3182,5/17/2011,2,0,5,11,0,2,1,2,0.56,0.5303,0.83,0.4179,26,104,130,104
3183,5/17/2011,2,0,5,12,0,2,1,3,0.56,0.5303,0.83,0.4179,38,115,153,115
3184,5/17/2011,2,0,5,13,0,2,1,2,0.56,0.5303,0.88,0.3284,31,141,172,141
3185,5/17/2011,2,0,5,14,0,2,1,1,0.62,0.5909,0.73,0.4627,61,123,184,123
3186,5/17/2011,2,0,5,15,0,2,1,1,0.62,0.6061,0.69,0.4478,79,131,210,131
3187,5/17/2011,2,0,5,16,0,2,1,1,0.62,0.6061,0.61,0.3284,73,217,290,217
3188,5/17/2011,2,0,5,17,0,2,1,1,0.62,0.6061,0.65,0.4179,83,521,604,521
3189,5/17/2011,2,0,5,18,0,2,1,1,0.6,0.5909,0.69,0.2985,54,426,480,426
3190,5/17/2011,2,0,5,19,0,2,1,1,0.6,0.5909,0.69,0.2537,51,298,349,298
3191,5/17/2011,2,0,5,20,0,2,1,1,0.58,0.5455,0.83,0.4179,30,253,283,253
3192,5/17/2011,2,0,5,21,0,2,1,1,0.54,0.5152,0.88,0.2537,23,151,174,151
3193,5/17/2011,2,0,5,22,0,2,1,2,0.54,0.5152,0.88,0.2836,12,86,98,86
3194,5/17/2011,2,0,5,23,0,2,1,2,0.54,0.5152,0.88,0.2537,7,49,56,49
3195,5/18/2011,2,0,5,0,0,3,1,2,0.54,0.5152,0.88,0.2239,8,15,23,15
3196,5/18/2011,2,0,5,1,0,3,1,2,0.54,0.5152,0.88,0.2537,3,9,12,9
3197,5/18/2011,2,0,5,2,0,3,1,3,0.52,0.5,0.94,0.2239,1,5,6,5
3198,5/18/2011,2,0,5,3,0,3,1,3,0.52,0.5,0.94,0.2985,6,3,9,3
3199,5/18/2011,2,0,5,4,0,3,1,3,0.52,0.5,0.94,0.2985,1,2,3,2
3200,5/18/2011,2,0,5,5,0,3,1,1,0.52,0.5,1,0.2239,0,9,9,9
3201,5/18/2011,2,0,5,6,0,3,1,1,0.52,0.5,1,0.1343,2,99,101,99
3202,5/18/2011,2,0,5,7,0,3,1,1,0.54,0.5152,0.88,0.194,14,260,274,260
3203,5/18/2011,2,0,5,8,0,3,1,1,0.56,0.5303,0.88,0.2836,25,428,453,428
3204,5/18/2011,2,0,5,9,0,3,1,3,0.56,0.5303,0.83,0.2537,26,176,202,176
3205,5/18/2011,2,0,5,10,0,3,1,3,0.54,0.5152,0.88,0.2836,33,73,106,73
3206,5/18/2011,2,0,5,11,0,3,1,2,0.54,0.5152,0.94,0.0896,6,17,23,17
3207,5/18/2011,2,0,5,12,0,3,1,1,0.56,0.5303,0.94,0.2985,12,42,54,42
3208,5/18/2011,2,0,5,13,0,3,1,2,0.56,0.5303,0.83,0.3284,30,92,122,92
3209,5/18/2011,2,0,5,14,0,3,1,2,0.58,0.5455,0.78,0.2836,44,94,138,94
3210,5/18/2011,2,0,5,15,0,3,1,1,0.6,0.5758,0.78,0.2537,34,133,167,133
3211,5/18/2011,2,0,5,16,0,3,1,1,0.6,0.5909,0.73,0.194,53,241,294,241
3212,5/18/2011,2,0,5,17,0,3,1,1,0.6,0.5909,0.69,0.1343,78,487,565,487
3213,5/18/2011,2,0,5,18,0,3,1,1,0.6,0.5909,0.73,0.2239,58,431,489,431
3214,5/18/2011,2,0,5,19,0,3,1,3,0.56,0.5303,0.88,0.1343,43,288,331,288
3215,5/18/2011,2,0,5,20,0,3,1,3,0.56,0.5303,0.88,0.1343,24,189,213,189
3216,5/18/2011,2,0,5,21,0,3,1,1,0.52,0.5,0.88,0,11,74,85,74
3217,5/18/2011,2,0,5,22,0,3,1,1,0.52,0.5,0.83,0,14,103,117,103
3218,5/18/2011,2,0,5,23,0,3,1,1,0.52,0.5,0.94,0.0896,10,49,59,49
3219,5/19/2011,2,0,5,0,0,4,1,1,0.52,0.5,0.94,0.1045,6,23,29,23
3220,5/19/2011,2,0,5,1,0,4,1,1,0.5,0.4848,0.94,0,2,4,6,4
3221,5/19/2011,2,0,5,2,0,4,1,1,0.5,0.4848,0.94,0,3,12,15,12
3222,5/19/2011,2,0,5,3,0,4,1,1,0.48,0.4697,1,0,1,3,4,3
3223,5/19/2011,2,0,5,4,0,4,1,1,0.48,0.4697,0.94,0,2,3,5,3
3224,5/19/2011,2,0,5,5,0,4,1,1,0.48,0.4697,0.94,0,2,24,26,24
3225,5/19/2011,2,0,5,6,0,4,1,2,0.5,0.4848,0.94,0,17,86,103,86
3226,5/19/2011,2,0,5,7,0,4,1,2,0.5,0.4848,1,0,18,239,257,239
3227,5/19/2011,2,0,5,8,0,4,1,2,0.52,0.5,0.88,0,34,453,487,453
3228,5/19/2011,2,0,5,9,0,4,1,2,0.54,0.5152,0.88,0.0896,40,176,216,176
3229,5/19/2011,2,0,5,10,0,4,1,2,0.54,0.5152,0.83,0,35,95,130,95
3230,5/19/2011,2,0,5,11,0,4,1,3,0.54,0.5152,0.88,0.1642,53,111,164,111
3231,5/19/2011,2,0,5,12,0,4,1,2,0.58,0.5455,0.78,0.1045,38,130,168,130
3232,5/19/2011,2,0,5,13,0,4,1,3,0.58,0.5455,0.64,0.2537,44,139,183,139
3233,5/19/2011,2,0,5,14,0,4,1,3,0.54,0.5152,0.73,0.194,43,137,180,137
3234,5/19/2011,2,0,5,15,0,4,1,1,0.56,0.5303,0.78,0.1642,63,125,188,125
3235,5/19/2011,2,0,5,16,0,4,1,1,0.58,0.5455,0.64,0.194,55,247,302,247
3236,5/19/2011,2,0,5,17,0,4,1,1,0.56,0.5303,0.78,0.1642,60,487,547,487
3237,5/19/2011,2,0,5,18,0,4,1,1,0.6,0.6212,0.55,0.1642,59,454,513,454
3238,5/19/2011,2,0,5,19,0,4,1,1,0.58,0.5455,0.6,0.1343,65,345,410,345
3239,5/19/2011,2,0,5,20,0,4,1,1,0.54,0.5152,0.77,0.2836,46,236,282,236
3240,5/19/2011,2,0,5,21,0,4,1,1,0.54,0.5152,0.77,0.2836,29,180,209,180
3241,5/19/2011,2,0,5,22,0,4,1,3,0.5,0.4848,0.82,0.2985,11,68,79,68
3242,5/19/2011,2,0,5,23,0,4,1,1,0.48,0.4697,0.94,0,9,63,72,63
3243,5/20/2011,2,0,5,0,0,5,1,1,0.46,0.4545,0.94,0.0896,15,33,48,33
3244,5/20/2011,2,0,5,1,0,5,1,1,0.46,0.4545,1,0,8,17,25,17
3245,5/20/2011,2,0,5,2,0,5,1,1,0.44,0.4394,1,0.0896,4,4,8,4
3246,5/20/2011,2,0,5,3,0,5,1,1,0.44,0.4394,1,0,1,4,5,4
3247,5/20/2011,2,0,5,4,0,5,1,1,0.44,0.4394,0.94,0.0896,1,4,5,4
3248,5/20/2011,2,0,5,5,0,5,1,1,0.44,0.4394,0.94,0.1045,0,28,28,28
3249,5/20/2011,2,0,5,6,0,5,1,1,0.46,0.4545,0.88,0.1045,15,102,117,102
3250,5/20/2011,2,0,5,7,0,5,1,1,0.5,0.4848,0.77,0.1642,30,289,319,289
3251,5/20/2011,2,0,5,8,0,5,1,1,0.54,0.5152,0.68,0,41,476,517,476
3252,5/20/2011,2,0,5,9,0,5,1,1,0.54,0.5152,0.68,0.2239,35,199,234,199
3253,5/20/2011,2,0,5,10,0,5,1,1,0.56,0.5303,0.64,0.194,44,104,148,104
3254,5/20/2011,2,0,5,11,0,5,1,2,0.58,0.5455,0.6,0.194,63,133,196,133
3255,5/20/2011,2,0,5,12,0,5,1,2,0.6,0.6212,0.56,0.2537,69,186,255,186
3256,5/20/2011,2,0,5,13,0,5,1,3,0.6,0.6212,0.56,0.2836,60,172,232,172
3257,5/20/2011,2,0,5,14,0,5,1,1,0.62,0.6212,0.53,0.2239,66,131,197,131
3258,5/20/2011,2,0,5,15,0,5,1,2,0.6,0.6212,0.56,0.194,74,168,242,168
3259,5/20/2011,2,0,5,16,0,5,1,2,0.6,0.6212,0.53,0.1642,61,269,330,269
3260,5/20/2011,2,0,5,17,0,5,1,1,0.62,0.6212,0.53,0,71,483,554,483
3261,5/20/2011,2,0,5,18,0,5,1,1,0.6,0.6212,0.56,0.1642,79,394,473,394
3262,5/20/2011,2,0,5,19,0,5,1,1,0.58,0.5455,0.64,0.0896,49,253,302,253
3263,5/20/2011,2,0,5,20,0,5,1,1,0.58,0.5455,0.64,0.1045,40,180,220,180
3264,5/20/2011,2,0,5,21,0,5,1,1,0.56,0.5303,0.64,0.1045,40,155,195,155
3265,5/20/2011,2,0,5,22,0,5,1,1,0.54,0.5152,0.73,0,28,124,152,124
3266,5/20/2011,2,0,5,23,0,5,1,1,0.52,0.5,0.72,0.1642,15,100,115,100
3267,5/21/2011,2,0,5,0,0,6,0,1,0.52,0.5,0.77,0.1045,20,78,98,78
3268,5/21/2011,2,0,5,1,0,6,0,1,0.52,0.5,0.72,0,8,64,72,64
3269,5/21/2011,2,0,5,2,0,6,0,1,0.52,0.5,0.72,0.1045,5,35,40,35
3270,5/21/2011,2,0,5,3,0,6,0,1,0.48,0.4697,0.82,0.1045,7,12,19,12
3271,5/21/2011,2,0,5,4,0,6,0,1,0.46,0.4545,0.88,0.1343,1,6,7,6
3272,5/21/2011,2,0,5,5,0,6,0,1,0.46,0.4545,0.88,0.1045,1,4,5,4
3273,5/21/2011,2,0,5,6,0,6,0,1,0.5,0.4848,0.82,0.1343,6,22,28,22
3274,5/21/2011,2,0,5,7,0,6,0,1,0.54,0.5152,0.73,0.1343,10,33,43,33
3275,5/21/2011,2,0,5,8,0,6,0,1,0.56,0.5303,0.68,0.2836,29,97,126,97
3276,5/21/2011,2,0,5,9,0,6,0,1,0.6,0.6061,0.64,0.2239,60,165,225,165
3277,5/21/2011,2,0,5,10,0,6,0,1,0.62,0.6061,0.61,0.1045,122,201,323,201
3278,5/21/2011,2,0,5,11,0,6,0,1,0.64,0.6212,0.53,0.1343,173,245,418,245
3279,5/21/2011,2,0,5,12,0,6,0,1,0.66,0.6212,0.5,0,222,271,493,271
3280,5/21/2011,2,0,5,13,0,6,0,1,0.7,0.6364,0.45,0,191,271,462,271
3281,5/21/2011,2,0,5,14,0,6,0,1,0.72,0.6515,0.42,0,187,269,456,269
3282,5/21/2011,2,0,5,15,0,6,0,1,0.72,0.6515,0.45,0.2537,232,274,506,274
3283,5/21/2011,2,0,5,16,0,6,0,2,0.72,0.6515,0.39,0.2537,204,267,471,267
3284,5/21/2011,2,0,5,17,0,6,0,2,0.72,0.6515,0.42,0.1642,191,253,444,253
3285,5/21/2011,2,0,5,18,0,6,0,2,0.7,0.6364,0.45,0.1642,191,253,444,253
3286,5/21/2011,2,0,5,19,0,6,0,1,0.68,0.6364,0.47,0.1642,117,184,301,184
3287,5/21/2011,2,0,5,20,0,6,0,1,0.62,0.6061,0.61,0,84,164,248,164
3288,5/21/2011,2,0,5,21,0,6,0,1,0.62,0.6061,0.61,0.1045,77,150,227,150
3289,5/21/2011,2,0,5,22,0,6,0,1,0.6,0.5909,0.69,0.1343,78,126,204,126
3290,5/21/2011,2,0,5,23,0,6,0,1,0.58,0.5455,0.78,0.0896,42,103,145,103
3291,5/22/2011,2,0,5,0,0,0,0,1,0.54,0.5152,0.88,0.1642,31,100,131,100
3292,5/22/2011,2,0,5,1,0,0,0,1,0.52,0.5,0.94,0.1343,17,81,98,81
3293,5/22/2011,2,0,5,2,0,0,0,1,0.52,0.5,0.94,0.1045,18,50,68,50
3294,5/22/2011,2,0,5,3,0,0,0,1,0.5,0.4848,1,0.1045,10,23,33,23
3295,5/22/2011,2,0,5,4,0,0,0,1,0.5,0.4848,1,0,3,9,12,9
3296,5/22/2011,2,0,5,5,0,0,0,1,0.5,0.4848,1,0.1045,1,5,6,5
3297,5/22/2011,2,0,5,6,0,0,0,1,0.52,0.5,0.94,0.1045,5,13,18,13
3298,5/22/2011,2,0,5,7,0,0,0,1,0.54,0.5152,0.88,0.1045,13,27,40,27
3299,5/22/2011,2,0,5,8,0,0,0,1,0.6,0.5909,0.73,0.0896,29,65,94,65
3300,5/22/2011,2,0,5,9,0,0,0,1,0.62,0.6061,0.69,0.1045,59,130,189,130
3301,5/22/2011,2,0,5,10,0,0,0,1,0.64,0.6061,0.65,0.1343,135,170,305,170
3302,5/22/2011,2,0,5,11,0,0,0,1,0.7,0.6515,0.54,0.194,164,209,373,209
3303,5/22/2011,2,0,5,12,0,0,0,2,0.72,0.6667,0.51,0.194,146,255,401,255
3304,5/22/2011,2,0,5,13,0,0,0,2,0.66,0.6212,0.54,0.2239,180,275,455,275
3305,5/22/2011,2,0,5,14,0,0,0,3,0.62,0.6061,0.69,0.194,125,191,316,191
3306,5/22/2011,2,0,5,15,0,0,0,2,0.66,0.6212,0.61,0.1642,110,221,331,221
3307,5/22/2011,2,0,5,16,0,0,0,1,0.68,0.6364,0.61,0.1343,72,201,273,201
3308,5/22/2011,2,0,5,17,0,0,0,1,0.7,0.6515,0.58,0.2537,93,213,306,213
3309,5/22/2011,2,0,5,18,0,0,0,1,0.66,0.6212,0.61,0.2239,120,238,358,238
3310,5/22/2011,2,0,5,19,0,0,0,1,0.66,0.6212,0.61,0.194,107,193,300,193
3311,5/22/2011,2,0,5,20,0,0,0,1,0.64,0.6061,0.65,0.1642,57,174,231,174
3312,5/22/2011,2,0,5,21,0,0,0,1,0.62,0.5909,0.73,0.194,27,109,136,109
3313,5/22/2011,2,0,5,22,0,0,0,1,0.6,0.5606,0.83,0.1343,35,86,121,86
3314,5/22/2011,2,0,5,23,0,0,0,2,0.58,0.5455,0.83,0.1343,19,46,65,46
3315,5/23/2011,2,0,5,0,0,1,1,2,0.56,0.5303,0.88,0.1343,23,18,41,18
3316,5/23/2011,2,0,5,1,0,1,1,1,0.56,0.5303,0.88,0.1045,4,5,9,5
3317,5/23/2011,2,0,5,2,0,1,1,3,0.56,0.5303,0.88,0.1642,2,3,5,3
3318,5/23/2011,2,0,5,3,0,1,1,3,0.54,0.5152,0.94,0.1642,0,4,4,4
3319,5/23/2011,2,0,5,4,0,1,1,2,0.54,0.5152,0.94,0,2,2,4,2
3320,5/23/2011,2,0,5,5,0,1,1,2,0.54,0.5152,0.94,0,0,11,11,11
3321,5/23/2011,2,0,5,6,0,1,1,2,0.54,0.5152,1,0,4,92,96,92
3322,5/23/2011,2,0,5,7,0,1,1,2,0.56,0.5303,0.94,0.1045,13,223,236,223
3323,5/23/2011,2,0,5,8,0,1,1,1,0.6,0.5455,0.88,0.194,50,359,409,359
3324,5/23/2011,2,0,5,9,0,1,1,1,0.6,0.5455,0.88,0.2239,36,131,167,131
3325,5/23/2011,2,0,5,10,0,1,1,1,0.66,0.6212,0.74,0.2985,49,72,121,72
3326,5/23/2011,2,0,5,11,0,1,1,1,0.68,0.6364,0.69,0.3881,73,107,180,107
3327,5/23/2011,2,0,5,12,0,1,1,1,0.68,0.6364,0.69,0.3881,65,139,204,139
3328,5/23/2011,2,0,5,13,0,1,1,2,0.74,0.6818,0.58,0.4179,49,155,204,155
3329,5/23/2011,2,0,5,14,0,1,1,2,0.72,0.6818,0.62,0.5224,57,130,187,130
3330,5/23/2011,2,0,5,15,0,1,1,2,0.72,0.6818,0.62,0.4478,57,119,176,119
3331,5/23/2011,2,0,5,16,0,1,1,2,0.72,0.6818,0.62,0.2985,56,223,279,223
3332,5/23/2011,2,0,5,17,0,1,1,3,0.72,0.6818,0.7,0.3881,56,373,429,373
3333,5/23/2011,2,0,5,18,0,1,1,1,0.7,0.6667,0.74,0.2836,68,385,453,385
3334,5/23/2011,2,0,5,19,0,1,1,1,0.7,0.6667,0.74,0.2239,56,302,358,302
3335,5/23/2011,2,0,5,20,0,1,1,1,0.64,0.5758,0.83,0.2239,39,271,310,271
3336,5/23/2011,2,0,5,21,0,1,1,1,0.64,0.5758,0.89,0.2239,33,155,188,155
3337,5/23/2011,2,0,5,22,0,1,1,1,0.62,0.5455,0.94,0.2239,25,106,131,106
3338,5/23/2011,2,0,5,23,0,1,1,2,0.62,0.5606,0.88,0.194,19,53,72,53
3339,5/24/2011,2,0,5,0,0,2,1,2,0.6,0.5152,0.94,0.194,12,23,35,23
3340,5/24/2011,2,0,5,1,0,2,1,2,0.6,0.5152,0.94,0.1642,6,9,15,9
3341,5/24/2011,2,0,5,2,0,2,1,2,0.6,0.5152,0.94,0.194,2,8,10,8
3342,5/24/2011,2,0,5,3,0,2,1,2,0.58,0.5455,0.94,0.1045,0,2,2,2
3343,5/24/2011,2,0,5,4,0,2,1,1,0.6,0.5455,0.88,0.1045,1,3,4,3
3344,5/24/2011,2,0,5,5,0,2,1,2,0.58,0.5455,0.94,0.2537,2,22,24,22
3345,5/24/2011,2,0,5,6,0,2,1,2,0.58,0.5455,0.94,0.194,10,102,112,102
3346,5/24/2011,2,0,5,7,0,2,1,3,0.64,0.5909,0.78,0.194,26,288,314,288
3347,5/24/2011,2,0,5,8,0,2,1,3,0.62,0.5758,0.83,0.2239,31,403,434,403
3348,5/24/2011,2,0,5,9,0,2,1,2,0.64,0.6061,0.73,0.194,27,111,138,111
3349,5/24/2011,2,0,5,10,0,2,1,1,0.7,0.6515,0.61,0.3284,18,90,108,90
3350,5/24/2011,2,0,5,11,0,2,1,1,0.74,0.6667,0.51,0.2239,33,142,175,142
3351,5/24/2011,2,0,5,12,0,2,1,1,0.76,0.6818,0.45,0.3881,41,129,170,129
3352,5/24/2011,2,0,5,13,0,2,1,1,0.78,0.697,0.46,0.2537,38,152,190,152
3353,5/24/2011,2,0,5,14,0,2,1,1,0.78,0.697,0.46,0.2836,27,126,153,126
3354,5/24/2011,2,0,5,15,0,2,1,3,0.74,0.6818,0.55,0.4179,59,129,188,129
3355,5/24/2011,2,0,5,16,0,2,1,1,0.66,0.6212,0.69,0.194,52,225,277,225
3356,5/24/2011,2,0,5,17,0,2,1,1,0.7,0.6515,0.61,0.1045,56,492,548,492
3357,5/24/2011,2,0,5,18,0,2,1,1,0.7,0.6515,0.7,0.194,74,490,564,490
3358,5/24/2011,2,0,5,19,0,2,1,1,0.66,0.6212,0.74,0.194,45,310,355,310
3359,5/24/2011,2,0,5,20,0,2,1,1,0.66,0.6212,0.74,0.0896,39,241,280,241
3360,5/24/2011,2,0,5,21,0,2,1,1,0.64,0.5909,0.78,0.0896,21,168,189,168
3361,5/24/2011,2,0,5,22,0,2,1,3,0.62,0.5606,0.88,0.2239,26,115,141,115
3362,5/24/2011,2,0,5,23,0,2,1,3,0.66,0.6212,0.74,0.1642,13,53,66,53
3363,5/25/2011,2,0,5,0,0,3,1,3,0.6,0.5606,0.83,0.2239,3,32,35,32
3364,5/25/2011,2,0,5,1,0,3,1,3,0.58,0.5455,0.83,0.194,6,2,8,2
3365,5/25/2011,2,0,5,2,0,3,1,2,0.56,0.5303,0.94,0,0,8,8,8
3366,5/25/2011,2,0,5,3,0,3,1,1,0.54,0.5152,1,0.1343,0,9,9,9
3367,5/25/2011,2,0,5,4,0,3,1,1,0.54,0.5152,1,0.1045,0,3,3,3
3368,5/25/2011,2,0,5,5,0,3,1,1,0.56,0.5303,0.88,0.0896,2,23,25,23
3369,5/25/2011,2,0,5,6,0,3,1,1,0.56,0.5303,0.94,0.0896,4,113,117,113
3370,5/25/2011,2,0,5,7,0,3,1,1,0.62,0.5909,0.73,0.1343,29,284,313,284
3371,5/25/2011,2,0,5,8,0,3,1,1,0.64,0.6061,0.69,0.2239,36,495,531,495
3372,5/25/2011,2,0,5,9,0,3,1,1,0.68,0.6364,0.65,0.0896,27,207,234,207
3373,5/25/2011,2,0,5,10,0,3,1,1,0.7,0.6515,0.61,0.0896,30,105,135,105
3374,5/25/2011,2,0,5,11,0,3,1,1,0.74,0.6667,0.51,0.0896,36,104,140,104
3375,5/25/2011,2,0,5,12,0,3,1,1,0.74,0.6818,0.55,0.1343,32,178,210,178
3376,5/25/2011,2,0,5,13,0,3,1,1,0.74,0.6818,0.55,0.1343,39,163,202,163
3377,5/25/2011,2,0,5,14,0,3,1,1,0.74,0.6818,0.55,0.1642,47,121,168,121
3378,5/25/2011,2,0,5,15,0,3,1,1,0.76,0.697,0.52,0.2537,37,145,182,145
3379,5/25/2011,2,0,5,16,0,3,1,1,0.74,0.6667,0.51,0.2836,61,238,299,238
3380,5/25/2011,2,0,5,17,0,3,1,1,0.74,0.6667,0.51,0.2239,77,524,601,524
3381,5/25/2011,2,0,5,18,0,3,1,1,0.72,0.6667,0.58,0.2239,66,451,517,451
3382,5/25/2011,2,0,5,19,0,3,1,1,0.7,0.6515,0.61,0.1343,73,332,405,332
3383,5/25/2011,2,0,5,20,0,3,1,1,0.7,0.6515,0.61,0.1642,56,284,340,284
3384,5/25/2011,2,0,5,21,0,3,1,1,0.66,0.6212,0.69,0.1343,33,203,236,203
3385,5/25/2011,2,0,5,22,0,3,1,1,0.66,0.6212,0.69,0.2537,34,140,174,140
3386,5/25/2011,2,0,5,23,0,3,1,1,0.64,0.6061,0.73,0.1343,12,74,86,74
3387,5/26/2011,2,0,5,0,0,4,1,1,0.64,0.6061,0.73,0.1343,11,34,45,34
3388,5/26/2011,2,0,5,1,0,4,1,1,0.64,0.6061,0.73,0.1343,3,13,16,13
3389,5/26/2011,2,0,5,2,0,4,1,1,0.62,0.5758,0.83,0.1045,7,7,14,7
3390,5/26/2011,2,0,5,3,0,4,1,1,0.6,0.5455,0.88,0.0896,0,4,4,4
3391,5/26/2011,2,0,5,4,0,4,1,1,0.6,0.5455,0.88,0,0,2,2,2
3392,5/26/2011,2,0,5,5,0,4,1,2,0.6,0.5455,0.88,0.0896,2,25,27,25
3393,5/26/2011,2,0,5,6,0,4,1,2,0.6,0.5,1,0.0896,4,94,98,94
3394,5/26/2011,2,0,5,7,0,4,1,2,0.62,0.5455,0.94,0.2537,16,270,286,270
3395,5/26/2011,2,0,5,8,0,4,1,2,0.66,0.6061,0.83,0.1642,31,458,489,458
3396,5/26/2011,2,0,5,9,0,4,1,1,0.72,0.6818,0.7,0.1642,22,194,216,194
3397,5/26/2011,2,0,5,10,0,4,1,1,0.7,0.6667,0.74,0.2836,49,94,143,94
3398,5/26/2011,2,0,5,11,0,4,1,1,0.74,0.697,0.66,0.2239,36,124,160,124
3399,5/26/2011,2,0,5,12,0,4,1,1,0.78,0.7424,0.59,0.3284,53,141,194,141
3400,5/26/2011,2,0,5,13,0,4,1,1,0.82,0.7727,0.52,0.2836,52,145,197,145
3401,5/26/2011,2,0,5,14,0,4,1,1,0.82,0.7727,0.52,0.2836,44,145,189,145
3402,5/26/2011,2,0,5,15,0,4,1,2,0.82,0.7576,0.46,0.2836,40,101,141,101
3403,5/26/2011,2,0,5,16,0,4,1,2,0.8,0.7424,0.49,0.3582,58,233,291,233
3404,5/26/2011,2,0,5,17,0,4,1,1,0.8,0.7273,0.46,0.2836,49,445,494,445
3405,5/26/2011,2,0,5,18,0,4,1,1,0.8,0.7273,0.46,0.3284,74,404,478,404
3406,5/26/2011,2,0,5,19,0,4,1,1,0.78,0.697,0.46,0.3284,67,311,378,311
3407,5/26/2011,2,0,5,20,0,4,1,1,0.72,0.6667,0.58,0.1642,55,267,322,267
3408,5/26/2011,2,0,5,21,0,4,1,1,0.72,0.6818,0.62,0.0896,45,178,223,178
3409,5/26/2011,2,0,5,22,0,4,1,1,0.7,0.6515,0.65,0.1343,23,157,180,157
3410,5/26/2011,2,0,5,23,0,4,1,1,0.7,0.6515,0.65,0.194,17,73,90,73
3411,5/27/2011,2,0,5,0,0,5,1,1,0.68,0.6364,0.69,0.2537,14,55,69,55
3412,5/27/2011,2,0,5,1,0,5,1,1,0.7,0.6515,0.58,0.2985,14,36,50,36
3413,5/27/2011,2,0,5,2,0,5,1,1,0.68,0.6364,0.61,0.2239,6,12,18,12
3414,5/27/2011,2,0,5,3,0,5,1,1,0.66,0.6212,0.65,0.0896,1,11,12,11
3415,5/27/2011,2,0,5,4,0,5,1,1,0.64,0.6061,0.69,0.1343,2,5,7,5
3416,5/27/2011,2,0,5,5,0,5,1,1,0.64,0.6061,0.65,0.2836,2,29,31,29
3417,5/27/2011,2,0,5,6,0,5,1,1,0.64,0.6061,0.69,0.0896,8,73,81,73
3418,5/27/2011,2,0,5,7,0,5,1,1,0.64,0.6061,0.73,0.1642,20,229,249,229
3419,5/27/2011,2,0,5,8,0,5,1,1,0.66,0.6212,0.74,0.2836,25,393,418,393
3420,5/27/2011,2,0,5,9,0,5,1,1,0.7,0.6515,0.65,0.2836,37,190,227,190
3421,5/27/2011,2,0,5,10,0,5,1,1,0.72,0.6667,0.54,0.3881,42,111,153,111
3422,5/27/2011,2,0,5,11,0,5,1,2,0.74,0.6818,0.55,0.3284,40,126,166,126
3423,5/27/2011,2,0,5,12,0,5,1,2,0.76,0.697,0.55,0.2985,53,190,243,190
3424,5/27/2011,2,0,5,13,0,5,1,1,0.74,0.6818,0.58,0.194,51,158,209,158
3425,5/27/2011,2,0,5,14,0,5,1,1,0.76,0.697,0.55,0.2537,51,188,239,188
3426,5/27/2011,2,0,5,15,0,5,1,1,0.78,0.7121,0.49,0.2836,98,258,356,258
3427,5/27/2011,2,0,5,16,0,5,1,2,0.76,0.697,0.55,0.3881,63,356,419,356
3428,5/27/2011,2,0,5,17,0,5,1,1,0.74,0.6818,0.58,0.3881,77,414,491,414
3429,5/27/2011,2,0,5,18,0,5,1,2,0.72,0.6818,0.62,0.2985,89,310,399,310
3430,5/27/2011,2,0,5,19,0,5,1,3,0.6,0.5758,0.78,0.2537,69,210,279,210
3431,5/27/2011,2,0,5,20,0,5,1,2,0.62,0.5909,0.73,0.2239,24,120,144,120
3432,5/27/2011,2,0,5,21,0,5,1,1,0.6,0.5606,0.83,0.1045,37,114,151,114
3433,5/27/2011,2,0,5,22,0,5,1,1,0.6,0.5758,0.78,0.1343,25,116,141,116
3434,5/27/2011,2,0,5,23,0,5,1,1,0.58,0.5455,0.88,0.1343,23,104,127,104
3435,5/28/2011,2,0,5,0,0,6,0,1,0.58,0.5455,0.88,0.1343,15,79,94,79
3436,5/28/2011,2,0,5,1,0,6,0,1,0.58,0.5455,0.88,0.194,8,47,55,47
3437,5/28/2011,2,0,5,2,0,6,0,1,0.56,0.5303,0.94,0.194,13,35,48,35
3438,5/28/2011,2,0,5,3,0,6,0,1,0.56,0.5303,0.88,0.2239,2,13,15,13
3439,5/28/2011,2,0,5,4,0,6,0,1,0.56,0.5303,0.88,0.2537,0,4,4,4
3440,5/28/2011,2,0,5,5,0,6,0,1,0.56,0.5303,0.88,0.2239,4,3,7,3
3441,5/28/2011,2,0,5,6,0,6,0,1,0.58,0.5455,0.83,0.2537,3,16,19,16
3442,5/28/2011,2,0,5,7,0,6,0,1,0.6,0.5606,0.83,0.2537,17,33,50,33
3443,5/28/2011,2,0,5,8,0,6,0,1,0.62,0.5909,0.78,0.194,27,75,102,75
3444,5/28/2011,2,0,5,9,0,6,0,1,0.64,0.6061,0.73,0.2537,61,116,177,116
3445,5/28/2011,2,0,5,10,0,6,0,1,0.7,0.6515,0.65,0.2239,110,166,276,166
3446,5/28/2011,2,0,5,11,0,6,0,1,0.7,0.6515,0.65,0.2239,171,178,349,178
3447,5/28/2011,2,0,5,12,0,6,0,1,0.72,0.6667,0.58,0.2537,145,213,358,213
3448,5/28/2011,2,0,5,13,0,6,0,1,0.72,0.6818,0.62,0.2239,168,217,385,217
3449,5/28/2011,2,0,5,14,0,6,0,1,0.74,0.6818,0.58,0.2239,172,210,382,210
3450,5/28/2011,2,0,5,15,0,6,0,1,0.74,0.6818,0.55,0.2239,187,187,374,187
3451,5/28/2011,2,0,5,16,0,6,0,1,0.76,0.697,0.55,0.2836,201,201,402,201
3452,5/28/2011,2,0,5,17,0,6,0,1,0.74,0.6818,0.55,0.2985,180,161,341,161
3453,5/28/2011,2,0,5,18,0,6,0,1,0.72,0.6818,0.62,0.2537,173,212,385,212
3454,5/28/2011,2,0,5,19,0,6,0,1,0.7,0.6515,0.65,0.194,99,153,252,153
3455,5/28/2011,2,0,5,20,0,6,0,1,0.7,0.6515,0.65,0.2239,68,128,196,128
3456,5/28/2011,2,0,5,21,0,6,0,1,0.66,0.6212,0.74,0.2985,87,114,201,114
3457,5/28/2011,2,0,5,22,0,6,0,1,0.66,0.6061,0.78,0.2239,46,115,161,115
3458,5/28/2011,2,0,5,23,0,6,0,1,0.64,0.5758,0.83,0.194,44,81,125,81
3459,5/29/2011,2,0,5,0,0,0,0,1,0.64,0.5758,0.83,0.2239,32,51,83,51
3460,5/29/2011,2,0,5,1,0,0,0,1,0.62,0.5606,0.88,0.1642,17,49,66,49
3461,5/29/2011,2,0,5,2,0,0,0,1,0.62,0.5606,0.88,0.1045,12,49,61,49
3462,5/29/2011,2,0,5,3,0,0,0,1,0.62,0.5606,0.88,0.1045,2,24,26,24
3463,5/29/2011,2,0,5,4,0,0,0,1,0.6,0.5455,0.88,0.0896,13,10,23,10
3464,5/29/2011,2,0,5,5,0,0,0,1,0.6,0.5152,0.94,0.1642,3,3,6,3
3465,5/29/2011,2,0,5,6,0,0,0,2,0.62,0.5606,0.88,0.194,5,10,15,10
3466,5/29/2011,2,0,5,7,0,0,0,2,0.62,0.5606,0.88,0.2537,13,17,30,17
3467,5/29/2011,2,0,5,8,0,0,0,2,0.62,0.5606,0.88,0.2239,34,62,96,62
3468,5/29/2011,2,0,5,9,0,0,0,2,0.62,0.5455,0.94,0.2537,74,78,152,78
3469,5/29/2011,2,0,5,10,0,0,0,2,0.66,0.6061,0.83,0.2239,130,121,251,121
3470,5/29/2011,2,0,5,11,0,0,0,2,0.66,0.6061,0.83,0.2836,139,180,319,180
3471,5/29/2011,2,0,5,12,0,0,0,2,0.7,0.6667,0.74,0.2239,216,186,402,186
3472,5/29/2011,2,0,5,13,0,0,0,1,0.72,0.6818,0.7,0.2836,237,181,418,181
3473,5/29/2011,2,0,5,14,0,0,0,1,0.74,0.697,0.7,0.2836,183,168,351,168
3474,5/29/2011,2,0,5,15,0,0,0,1,0.74,0.697,0.7,0.2985,221,155,376,155
3475,5/29/2011,2,0,5,16,0,0,0,1,0.74,0.697,0.7,0.2836,194,167,361,167
3476,5/29/2011,2,0,5,17,0,0,0,1,0.74,0.697,0.7,0.2836,214,169,383,169
3477,5/29/2011,2,0,5,18,0,0,0,1,0.72,0.697,0.74,0.2836,151,177,328,177
3478,5/29/2011,2,0,5,19,0,0,0,1,0.72,0.697,0.74,0.2537,141,146,287,146
3479,5/29/2011,2,0,5,20,0,0,0,1,0.7,0.6667,0.79,0.194,91,128,219,128
3480,5/29/2011,2,0,5,21,0,0,0,1,0.68,0.6364,0.83,0.1642,107,122,229,122
3481,5/29/2011,2,0,5,22,0,0,0,1,0.66,0.5909,0.89,0.1343,78,93,171,93
3482,5/29/2011,2,0,5,23,0,0,0,1,0.66,0.5909,0.89,0.1642,48,87,135,87
3483,5/30/2011,2,0,5,0,1,1,0,1,0.64,0.5606,0.94,0.194,38,65,103,65
3484,5/30/2011,2,0,5,1,1,1,0,1,0.64,0.5606,0.94,0.1343,26,53,79,53
3485,5/30/2011,2,0,5,2,1,1,0,1,0.64,0.5606,0.94,0.194,17,28,45,28
3486,5/30/2011,2,0,5,3,1,1,0,1,0.64,0.5606,0.94,0.194,10,8,18,8
3487,5/30/2011,2,0,5,4,1,1,0,1,0.62,0.5455,0.94,0.1642,2,4,6,4
3488,5/30/2011,2,0,5,5,1,1,0,2,0.62,0.5455,0.94,0.1045,1,6,7,6
3489,5/30/2011,2,0,5,6,1,1,0,2,0.64,0.5606,0.94,0.0896,6,10,16,10
3490,5/30/2011,2,0,5,7,1,1,0,2,0.64,0.5606,0.94,0,12,19,31,19
3491,5/30/2011,2,0,5,8,1,1,0,2,0.66,0.5909,0.89,0.1045,36,58,94,58
3492,5/30/2011,2,0,5,9,1,1,0,1,0.72,0.697,0.74,0.0896,47,81,128,81
3493,5/30/2011,2,0,5,10,1,1,0,1,0.8,0.7576,0.55,0.2537,116,153,269,153
3494,5/30/2011,2,0,5,11,1,1,0,1,0.82,0.7727,0.52,0,153,168,321,168
3495,5/30/2011,2,0,5,12,1,1,0,1,0.86,0.803,0.47,0.1045,179,187,366,187
3496,5/30/2011,2,0,5,13,1,1,0,1,0.86,0.7879,0.44,0.0896,133,217,350,217
3497,5/30/2011,2,0,5,14,1,1,0,1,0.88,0.803,0.39,0,142,185,327,185
3498,5/30/2011,2,0,5,15,1,1,0,1,0.88,0.803,0.39,0.2537,132,179,311,179
3499,5/30/2011,2,0,5,16,1,1,0,1,0.88,0.7879,0.37,0.2836,101,208,309,208
3500,5/30/2011,2,0,5,17,1,1,0,1,0.86,0.7879,0.41,0.2239,102,202,304,202
3501,5/30/2011,2,0,5,18,1,1,0,1,0.86,0.7879,0.41,0.1642,77,172,249,172
3502,5/30/2011,2,0,5,19,1,1,0,2,0.52,0.5,0.48,0.1045,68,157,225,157
3503,5/30/2011,2,0,5,20,1,1,0,1,0.76,0.7121,0.58,0,69,168,237,168
3504,5/30/2011,2,0,5,21,1,1,0,1,0.74,0.697,0.7,0.1343,42,107,149,107
3505,5/30/2011,2,0,5,22,1,1,0,1,0.72,0.697,0.74,0.1642,26,80,106,80
3506,5/30/2011,2,0,5,23,1,1,0,1,0.7,0.6667,0.84,0.1045,14,34,48,34
3507,5/31/2011,2,0,5,0,0,2,1,1,0.7,0.6667,0.79,0.0896,9,20,29,20
3508,5/31/2011,2,0,5,1,0,2,1,1,0.68,0.6364,0.89,0.0896,8,9,17,9
3509,5/31/2011,2,0,5,2,0,2,1,2,0.66,0.5909,0.94,0.1343,5,7,12,7
3510,5/31/2011,2,0,5,3,0,2,1,2,0.64,0.5606,0.94,0,1,3,4,3
3511,5/31/2011,2,0,5,4,0,2,1,1,0.66,0.6061,0.83,0.0896,0,3,3,3
3512,5/31/2011,2,0,5,5,0,2,1,1,0.66,0.6061,0.83,0.0896,0,26,26,26
3513,5/31/2011,2,0,5,6,0,2,1,1,0.68,0.6364,0.79,0.0896,11,98,109,98
3514,5/31/2011,2,0,5,7,0,2,1,1,0.74,0.697,0.66,0.1045,16,219,235,219
3515,5/31/2011,2,0,5,8,0,2,1,1,0.78,0.7424,0.59,0.1343,34,372,406,372
3516,5/31/2011,2,0,5,9,0,2,1,1,0.8,0.7576,0.55,0.1343,22,153,175,153
3517,5/31/2011,2,0,5,10,0,2,1,1,0.82,0.7879,0.56,0.1343,37,72,109,72
3518,5/31/2011,2,0,5,11,0,2,1,1,0.86,0.803,0.47,0,28,78,106,78
3519,5/31/2011,2,0,5,12,0,2,1,1,0.86,0.803,0.47,0.1343,37,125,162,125
3520,5/31/2011,2,0,5,13,0,2,1,1,0.9,0.8333,0.39,0.1642,37,110,147,110
3521,5/31/2011,2,0,5,14,0,2,1,1,0.9,0.8182,0.37,0,41,99,140,99
3522,5/31/2011,2,0,5,15,0,2,1,1,0.9,0.8182,0.37,0.1642,42,133,175,133
3523,5/31/2011,2,0,5,16,0,2,1,1,0.9,0.8333,0.39,0.1343,44,205,249,205
3524,5/31/2011,2,0,5,17,0,2,1,1,0.84,0.803,0.53,0.2239,67,428,495,428
3525,5/31/2011,2,0,5,18,0,2,1,1,0.84,0.803,0.53,0.194,55,362,417,362
3526,5/31/2011,2,0,5,19,0,2,1,1,0.78,0.7424,0.62,0.1045,39,246,285,246
3527,5/31/2011,2,0,5,20,0,2,1,1,0.78,0.7424,0.62,0.1045,38,213,251,213
3528,5/31/2011,2,0,5,21,0,2,1,1,0.76,0.7273,0.66,0.1045,45,165,210,165
3529,5/31/2011,2,0,5,22,0,2,1,1,0.74,0.697,0.7,0.1642,42,117,159,117
3530,5/31/2011,2,0,5,23,0,2,1,1,0.72,0.697,0.79,0.0896,15,46,61,46
3531,6/1/2011,2,0,6,0,0,3,1,1,0.7,0.6667,0.79,0.1642,9,25,34,25
3532,6/1/2011,2,0,6,1,0,3,1,1,0.7,0.6667,0.84,0.2537,8,9,17,9
3533,6/1/2011,2,0,6,2,0,3,1,1,0.7,0.6667,0.79,0.1642,0,3,3,3
3534,6/1/2011,2,0,6,3,0,3,1,1,0.68,0.6364,0.89,0.194,0,6,6,6
3535,6/1/2011,2,0,6,4,0,3,1,2,0.68,0.6364,0.89,0.2239,0,4,4,4
3536,6/1/2011,2,0,6,5,0,3,1,2,0.66,0.5909,0.89,0.0896,2,19,21,19
3537,6/1/2011,2,0,6,6,0,3,1,2,0.68,0.6364,0.89,0.0896,7,121,128,121
3538,6/1/2011,2,0,6,7,0,3,1,2,0.7,0.6667,0.79,0.1642,19,265,284,265
3539,6/1/2011,2,0,6,8,0,3,1,2,0.72,0.697,0.79,0.194,37,417,454,417
3540,6/1/2011,2,0,6,9,0,3,1,2,0.74,0.7121,0.74,0.2239,34,173,207,173
3541,6/1/2011,2,0,6,10,0,3,1,2,0.76,0.7424,0.75,0.2537,31,84,115,84
3542,6/1/2011,2,0,6,11,0,3,1,2,0.82,0.803,0.59,0.2239,26,86,112,86
3543,6/1/2011,2,0,6,12,0,3,1,1,0.86,0.8333,0.53,0,32,137,169,137
3544,6/1/2011,2,0,6,13,0,3,1,1,0.9,0.8182,0.37,0.194,29,125,154,125
3545,6/1/2011,2,0,6,14,0,3,1,1,0.9,0.8182,0.37,0.2537,40,105,145,105
3546,6/1/2011,2,0,6,15,0,3,1,1,0.9,0.8333,0.39,0.2985,25,127,152,127
3547,6/1/2011,2,0,6,16,0,3,1,1,0.86,0.803,0.47,0.2985,39,227,266,227
3548,6/1/2011,2,0,6,17,0,3,1,1,0.86,0.803,0.47,0.2985,52,434,486,434
3549,6/1/2011,2,0,6,18,0,3,1,3,0.82,0.7879,0.56,0.3881,31,278,309,278
3550,6/1/2011,2,0,6,19,0,3,1,2,0.74,0.7121,0.79,0.1642,16,248,264,248
3551,6/1/2011,2,0,6,20,0,3,1,2,0.74,0.7121,0.79,0.2537,23,233,256,233
3552,6/1/2011,2,0,6,21,0,3,1,1,0.74,0.697,0.7,0.2836,29,161,190,161
3553,6/1/2011,2,0,6,22,0,3,1,1,0.74,0.697,0.66,0.1343,14,115,129,115
3554,6/1/2011,2,0,6,23,0,3,1,1,0.74,0.6667,0.51,0.1642,10,59,69,59
3555,6/2/2011,2,0,6,0,0,4,1,1,0.74,0.6515,0.4,0.3582,11,31,42,31
3556,6/2/2011,2,0,6,1,0,4,1,1,0.72,0.6515,0.38,0.1045,3,12,15,12
3557,6/2/2011,2,0,6,2,0,4,1,1,0.7,0.6364,0.39,0,0,6,6,6
3558,6/2/2011,2,0,6,3,0,4,1,1,0.66,0.6212,0.44,0.1045,0,4,4,4
3559,6/2/2011,2,0,6,4,0,4,1,1,0.66,0.6212,0.41,0.194,0,3,3,3
3560,6/2/2011,2,0,6,5,0,4,1,1,0.66,0.6212,0.39,0.2239,3,28,31,28
3561,6/2/2011,2,0,6,6,0,4,1,1,0.66,0.6212,0.39,0.1343,7,106,113,106
3562,6/2/2011,2,0,6,7,0,4,1,1,0.7,0.6364,0.34,0.2537,19,285,304,285
3563,6/2/2011,2,0,6,8,0,4,1,1,0.7,0.6364,0.32,0.2985,25,442,467,442
3564,6/2/2011,2,0,6,9,0,4,1,1,0.72,0.6364,0.26,0.3582,28,197,225,197
3565,6/2/2011,2,0,6,10,0,4,1,1,0.72,0.6515,0.28,0.4925,33,106,139,106
3566,6/2/2011,2,0,6,11,0,4,1,1,0.74,0.6515,0.28,0.3881,42,123,165,123
3567,6/2/2011,2,0,6,12,0,4,1,1,0.76,0.6667,0.25,0.4627,39,193,232,193
3568,6/2/2011,2,0,6,13,0,4,1,1,0.8,0.6818,0.24,0.3582,35,168,203,168
3569,6/2/2011,2,0,6,14,0,4,1,1,0.78,0.6667,0.24,0.3284,43,142,185,142
3570,6/2/2011,2,0,6,15,0,4,1,1,0.8,0.6818,0.21,0.3881,44,144,188,144
3571,6/2/2011,2,0,6,16,0,4,1,1,0.8,0.6818,0.22,0.4925,63,255,318,255
3572,6/2/2011,2,0,6,17,0,4,1,1,0.76,0.6515,0.2,0.5224,88,484,572,484
3573,6/2/2011,2,0,6,18,0,4,1,1,0.74,0.6515,0.22,0.3881,74,451,525,451
3574,6/2/2011,2,0,6,19,0,4,1,1,0.72,0.6364,0.23,0.2985,58,321,379,321
3575,6/2/2011,2,0,6,20,0,4,1,1,0.7,0.6364,0.24,0.194,51,286,337,286
3576,6/2/2011,2,0,6,21,0,4,1,1,0.66,0.6212,0.31,0.194,33,215,248,215
3577,6/2/2011,2,0,6,22,0,4,1,1,0.64,0.6212,0.33,0.2537,14,141,155,141
3578,6/2/2011,2,0,6,23,0,4,1,1,0.62,0.6212,0.35,0.2239,23,89,112,89
3579,6/3/2011,2,0,6,0,0,5,1,1,0.62,0.6212,0.38,0.2836,15,53,68,53
3580,6/3/2011,2,0,6,1,0,5,1,1,0.6,0.6212,0.38,0.3582,7,15,22,15
3581,6/3/2011,2,0,6,2,0,5,1,1,0.56,0.5303,0.43,0.2239,0,12,12,12
3582,6/3/2011,2,0,6,3,0,5,1,1,0.54,0.5152,0.49,0.2239,0,5,5,5
3583,6/3/2011,2,0,6,4,0,5,1,1,0.52,0.5,0.48,0.3284,1,5,6,5
3584,6/3/2011,2,0,6,5,0,5,1,1,0.52,0.5,0.48,0.3582,4,24,28,24
3585,6/3/2011,2,0,6,6,0,5,1,1,0.54,0.5152,0.45,0.2985,8,98,106,98
3586,6/3/2011,2,0,6,7,0,5,1,1,0.54,0.5152,0.45,0.2537,25,252,277,252
3587,6/3/2011,2,0,6,8,0,5,1,2,0.56,0.5303,0.43,0.3284,31,471,502,471
3588,6/3/2011,2,0,6,9,0,5,1,1,0.58,0.5455,0.4,0.1642,36,194,230,194
3589,6/3/2011,2,0,6,10,0,5,1,1,0.62,0.6212,0.33,0.2537,54,107,161,107
3590,6/3/2011,2,0,6,11,0,5,1,1,0.64,0.6212,0.31,0.3284,57,135,192,135
3591,6/3/2011,2,0,6,12,0,5,1,1,0.66,0.6212,0.27,0.2836,51,208,259,208
3592,6/3/2011,2,0,6,13,0,5,1,1,0.68,0.6212,0.26,0.2537,58,190,248,190
3593,6/3/2011,2,0,6,14,0,5,1,1,0.7,0.6364,0.28,0.2836,66,174,240,174
3594,6/3/2011,2,0,6,15,0,5,1,1,0.7,0.6364,0.28,0.2836,56,156,212,156
3595,6/3/2011,2,0,6,16,0,5,1,1,0.72,0.6364,0.26,0.3284,63,286,349,286
3596,6/3/2011,2,0,6,17,0,5,1,1,0.72,0.6364,0.25,0.2836,73,485,558,485
3597,6/3/2011,2,0,6,18,0,5,1,1,0.7,0.6364,0.24,0.2985,76,488,564,488
3598,6/3/2011,2,0,6,19,0,5,1,1,0.68,0.6212,0.26,0.2836,53,338,391,338
3599,6/3/2011,2,0,6,20,0,5,1,1,0.64,0.6212,0.29,0.1642,57,236,293,236
3600,6/3/2011,2,0,6,21,0,5,1,1,0.64,0.6212,0.29,0.1045,51,196,247,196
3601,6/3/2011,2,0,6,22,0,5,1,1,0.62,0.6212,0.35,0,26,145,171,145
3602,6/3/2011,2,0,6,23,0,5,1,1,0.58,0.5455,0.46,0.1045,30,141,171,141
3603,6/4/2011,2,0,6,0,0,6,0,1,0.56,0.5303,0.52,0,24,69,93,69
3604,6/4/2011,2,0,6,1,0,6,0,1,0.54,0.5152,0.64,0.1045,14,80,94,80
3605,6/4/2011,2,0,6,2,0,6,0,1,0.54,0.5152,0.56,0.194,18,41,59,41
3606,6/4/2011,2,0,6,3,0,6,0,1,0.52,0.5,0.59,0.1045,8,10,18,10
3607,6/4/2011,2,0,6,4,0,6,0,1,0.52,0.5,0.59,0.0896,4,11,15,11
3608,6/4/2011,2,0,6,5,0,6,0,1,0.5,0.4848,0.64,0,3,5,8,5
3609,6/4/2011,2,0,6,6,0,6,0,1,0.54,0.5152,0.6,0,11,17,28,17
3610,6/4/2011,2,0,6,7,0,6,0,1,0.56,0.5303,0.56,0,27,60,87,60
3611,6/4/2011,2,0,6,8,0,6,0,1,0.6,0.6212,0.46,0.0896,29,96,125,96
3612,6/4/2011,2,0,6,9,0,6,0,1,0.62,0.6212,0.43,0.1343,55,169,224,169
3613,6/4/2011,2,0,6,10,0,6,0,1,0.64,0.6212,0.38,0.1045,115,202,317,202
3614,6/4/2011,2,0,6,11,0,6,0,1,0.66,0.6212,0.36,0.1343,120,249,369,249
3615,6/4/2011,2,0,6,12,0,6,0,1,0.7,0.6364,0.32,0.1642,150,270,420,270
3616,6/4/2011,2,0,6,13,0,6,0,1,0.74,0.6515,0.28,0.1343,188,268,456,268
3617,6/4/2011,2,0,6,14,0,6,0,1,0.74,0.6515,0.33,0.2239,193,258,451,258
3618,6/4/2011,2,0,6,15,0,6,0,2,0.74,0.6515,0.27,0.4179,180,224,404,224
3619,6/4/2011,2,0,6,16,0,6,0,2,0.72,0.6515,0.3,0.1343,168,272,440,272
3620,6/4/2011,2,0,6,17,0,6,0,2,0.72,0.6515,0.34,0.2537,142,202,344,202
3621,6/4/2011,2,0,6,18,0,6,0,2,0.74,0.6515,0.3,0.1642,127,214,341,214
3622,6/4/2011,2,0,6,19,0,6,0,2,0.7,0.6364,0.39,0.0896,79,206,285,206
3623,6/4/2011,2,0,6,20,0,6,0,2,0.7,0.6515,0.48,0.0896,90,149,239,149
3624,6/4/2011,2,0,6,21,0,6,0,2,0.66,0.6212,0.47,0.1045,46,139,185,139
3625,6/4/2011,2,0,6,22,0,6,0,1,0.64,0.6212,0.57,0.2239,49,141,190,141
3626,6/4/2011,2,0,6,23,0,6,0,2,0.64,0.6212,0.57,0,29,121,150,121
3627,6/5/2011,2,0,6,0,0,0,0,1,0.64,0.6212,0.57,0.0896,23,90,113,90
3628,6/5/2011,2,0,6,1,0,0,0,2,0.64,0.6212,0.61,0.1642,26,70,96,70
3629,6/5/2011,2,0,6,2,0,0,0,2,0.64,0.6212,0.61,0.1642,16,48,64,48
3630,6/5/2011,2,0,6,3,0,0,0,2,0.62,0.6061,0.65,0.1642,22,25,47,25
3631,6/5/2011,2,0,6,4,0,0,0,2,0.62,0.6061,0.65,0.1642,4,8,12,8
3632,6/5/2011,2,0,6,5,0,0,0,2,0.62,0.6061,0.61,0.1343,1,5,6,5
3633,6/5/2011,2,0,6,6,0,0,0,2,0.62,0.6061,0.61,0.1045,10,11,21,11
3634,6/5/2011,2,0,6,7,0,0,0,2,0.6,0.5909,0.73,0.2537,8,19,27,19
3635,6/5/2011,2,0,6,8,0,0,0,2,0.6,0.5909,0.73,0.2537,24,74,98,74
3636,6/5/2011,2,0,6,9,0,0,0,2,0.6,0.5758,0.78,0.194,53,111,164,111
3637,6/5/2011,2,0,6,10,0,0,0,2,0.62,0.5909,0.73,0.0896,83,168,251,168
3638,6/5/2011,2,0,6,11,0,0,0,2,0.64,0.6061,0.69,0.1045,121,214,335,214
3639,6/5/2011,2,0,6,12,0,0,0,2,0.64,0.6061,0.69,0.1045,123,212,335,212
3640,6/5/2011,2,0,6,13,0,0,0,1,0.66,0.6212,0.65,0.1045,154,213,367,213
3641,6/5/2011,2,0,6,14,0,0,0,1,0.7,0.6515,0.58,0.1642,161,224,385,224
3642,6/5/2011,2,0,6,15,0,0,0,1,0.7,0.6515,0.54,0,161,256,417,256
3643,6/5/2011,2,0,6,16,0,0,0,1,0.72,0.6667,0.51,0.0896,138,260,398,260
3644,6/5/2011,2,0,6,17,0,0,0,1,0.74,0.6667,0.51,0,126,264,390,264
3645,6/5/2011,2,0,6,18,0,0,0,1,0.7,0.6515,0.58,0.1045,124,239,363,239
3646,6/5/2011,2,0,6,19,0,0,0,1,0.68,0.6364,0.65,0.1642,108,249,357,249
3647,6/5/2011,2,0,6,20,0,0,0,1,0.66,0.6212,0.69,0.194,84,195,279,195
3648,6/5/2011,2,0,6,21,0,0,0,1,0.64,0.6061,0.73,0.1642,54,111,165,111
3649,6/5/2011,2,0,6,22,0,0,0,1,0.64,0.5909,0.78,0.2239,36,94,130,94
3650,6/5/2011,2,0,6,23,0,0,0,1,0.62,0.5909,0.78,0.1343,25,61,86,61
3651,6/6/2011,2,0,6,0,0,1,1,1,0.62,0.5909,0.78,0.1343,11,18,29,18
3652,6/6/2011,2,0,6,1,0,1,1,1,0.6,0.5606,0.83,0.1343,9,5,14,5
3653,6/6/2011,2,0,6,2,0,1,1,1,0.58,0.5455,0.88,0.1045,4,4,8,4
3654,6/6/2011,2,0,6,3,0,1,1,1,0.58,0.5455,0.88,0,2,3,5,3
3655,6/6/2011,2,0,6,4,0,1,1,1,0.56,0.5303,0.94,0.1045,4,4,8,4
3656,6/6/2011,2,0,6,5,0,1,1,1,0.56,0.5303,0.88,0.0896,7,24,31,24
3657,6/6/2011,2,0,6,6,0,1,1,1,0.58,0.5455,0.88,0,11,101,112,101
3658,6/6/2011,2,0,6,7,0,1,1,1,0.62,0.5909,0.78,0.1045,18,281,299,281
3659,6/6/2011,2,0,6,8,0,1,1,1,0.64,0.6061,0.73,0.0896,28,410,438,410
3660,6/6/2011,2,0,6,9,0,1,1,1,0.7,0.6515,0.58,0.1642,26,162,188,162
3661,6/6/2011,2,0,6,10,0,1,1,1,0.72,0.6667,0.51,0.2239,31,64,95,64
3662,6/6/2011,2,0,6,11,0,1,1,1,0.74,0.6667,0.42,0.1343,39,72,111,72
3663,6/6/2011,2,0,6,12,0,1,1,1,0.76,0.6667,0.37,0.1642,25,128,153,128
3664,6/6/2011,2,0,6,13,0,1,1,1,0.78,0.6818,0.35,0,28,152,180,152
3665,6/6/2011,2,0,6,14,0,1,1,1,0.78,0.6818,0.31,0.1343,46,99,145,99
3666,6/6/2011,2,0,6,15,0,1,1,1,0.8,0.697,0.29,0.194,38,127,165,127
3667,6/6/2011,2,0,6,16,0,1,1,1,0.76,0.6667,0.33,0.1343,34,233,267,233
3668,6/6/2011,2,0,6,17,0,1,1,1,0.78,0.6818,0.33,0.2836,63,516,579,516
3669,6/6/2011,2,0,6,18,0,1,1,1,0.76,0.6667,0.31,0.1343,56,500,556,500
3670,6/6/2011,2,0,6,19,0,1,1,1,0.72,0.6667,0.54,0.194,64,343,407,343
3671,6/6/2011,2,0,6,20,0,1,1,1,0.68,0.6364,0.61,0.1343,59,277,336,277
3672,6/6/2011,2,0,6,21,0,1,1,1,0.66,0.6212,0.57,0.0896,29,160,189,160
3673,6/6/2011,2,0,6,22,0,1,1,1,0.66,0.6212,0.61,0.0896,36,137,173,137
3674,6/6/2011,2,0,6,23,0,1,1,1,0.64,0.6061,0.69,0.0896,5,55,60,55
3675,6/7/2011,2,0,6,0,0,2,1,1,0.64,0.6061,0.65,0.0896,5,15,20,15
3676,6/7/2011,2,0,6,1,0,2,1,1,0.62,0.6061,0.69,0.1343,2,2,4,2
3677,6/7/2011,2,0,6,2,0,2,1,1,0.6,0.5909,0.73,0.0896,3,2,5,2
3678,6/7/2011,2,0,6,3,0,2,1,1,0.6,0.5909,0.73,0.0896,1,1,2,1
3679,6/7/2011,2,0,6,4,0,2,1,1,0.58,0.5455,0.83,0.1343,2,3,5,3
3680,6/7/2011,2,0,6,5,0,2,1,1,0.58,0.5455,0.88,0.1642,2,30,32,30
3681,6/7/2011,2,0,6,6,0,2,1,1,0.6,0.5758,0.78,0.1343,10,116,126,116
3682,6/7/2011,2,0,6,7,0,2,1,2,0.64,0.6061,0.69,0.194,23,311,334,311
3683,6/7/2011,2,0,6,8,0,2,1,2,0.68,0.6364,0.61,0.1343,45,432,477,432
3684,6/7/2011,2,0,6,9,0,2,1,2,0.72,0.6667,0.58,0.2239,27,190,217,190
3685,6/7/2011,2,0,6,10,0,2,1,2,0.76,0.6818,0.48,0.194,37,86,123,86
3686,6/7/2011,2,0,6,11,0,2,1,2,0.76,0.697,0.52,0.2537,38,113,151,113
3687,6/7/2011,2,0,6,12,0,2,1,2,0.8,0.7273,0.46,0.2836,42,141,183,141
3688,6/7/2011,2,0,6,13,0,2,1,2,0.8,0.7273,0.43,0.2537,55,141,196,141
3689,6/7/2011,2,0,6,14,0,2,1,2,0.8,0.7273,0.43,0.2836,34,112,146,112
3690,6/7/2011,2,0,6,15,0,2,1,2,0.82,0.7424,0.41,0.3284,56,127,183,127
3691,6/7/2011,2,0,6,16,0,2,1,1,0.8,0.7121,0.38,0.2239,55,253,308,253
3692,6/7/2011,2,0,6,17,0,2,1,1,0.8,0.7273,0.43,0.2537,64,475,539,475
3693,6/7/2011,2,0,6,18,0,2,1,1,0.78,0.697,0.46,0.2836,72,479,551,479
3694,6/7/2011,2,0,6,19,0,2,1,1,0.76,0.6818,0.48,0.2537,69,355,424,355
3695,6/7/2011,2,0,6,20,0,2,1,1,0.74,0.6818,0.56,0.1343,45,301,346,301
3696,6/7/2011,2,0,6,21,0,2,1,1,0.72,0.6818,0.7,0.1343,31,187,218,187
3697,6/7/2011,2,0,6,22,0,2,1,1,0.7,0.6515,0.65,0.1343,27,126,153,126
3698,6/7/2011,2,0,6,23,0,2,1,1,0.68,0.6364,0.79,0.1045,18,72,90,72
3699,6/8/2011,2,0,6,0,0,3,1,1,0.66,0.5909,0.89,0.1343,12,29,41,29
3700,6/8/2011,2,0,6,1,0,3,1,1,0.66,0.6061,0.78,0,3,20,23,20
3701,6/8/2011,2,0,6,2,0,3,1,1,0.64,0.5758,0.89,0.0896,0,7,7,7
3702,6/8/2011,2,0,6,3,0,3,1,1,0.64,0.5758,0.89,0.0896,2,1,3,1
3703,6/8/2011,2,0,6,4,0,3,1,1,0.62,0.5758,0.83,0,0,6,6,6
3704,6/8/2011,2,0,6,5,0,3,1,1,0.62,0.5606,0.88,0,0,21,21,21
3705,6/8/2011,2,0,6,6,0,3,1,1,0.64,0.5758,0.89,0.1343,13,103,116,103
3706,6/8/2011,2,0,6,7,0,3,1,1,0.66,0.6212,0.74,0.1045,24,329,353,329
3707,6/8/2011,2,0,6,8,0,3,1,1,0.76,0.7121,0.58,0.1642,46,435,481,435
3708,6/8/2011,2,0,6,9,0,3,1,1,0.76,0.7121,0.58,0.1642,34,168,202,168
3709,6/8/2011,2,0,6,10,0,3,1,1,0.82,0.7424,0.43,0.2239,27,63,90,63
3710,6/8/2011,2,0,6,11,0,3,1,1,0.84,0.7576,0.41,0.194,28,106,134,106
3711,6/8/2011,2,0,6,12,0,3,1,1,0.88,0.8182,0.42,0.1343,15,134,149,134
3712,6/8/2011,2,0,6,13,0,3,1,1,0.9,0.8485,0.42,0,20,116,136,116
3713,6/8/2011,2,0,6,14,0,3,1,1,0.92,0.8788,0.4,0.2537,44,111,155,111
3714,6/8/2011,2,0,6,15,0,3,1,1,0.92,0.8788,0.4,0.1642,28,100,128,100
3715,6/8/2011,2,0,6,16,0,3,1,1,0.92,0.8788,0.4,0.2239,34,199,233,199
3716,6/8/2011,2,0,6,17,0,3,1,1,0.92,0.8485,0.35,0.2239,80,426,506,426
3717,6/8/2011,2,0,6,18,0,3,1,1,0.9,0.8182,0.37,0.2239,61,398,459,398
3718,6/8/2011,2,0,6,19,0,3,1,1,0.82,0.803,0.59,0.1343,61,323,384,323
3719,6/8/2011,2,0,6,20,0,3,1,1,0.8,0.7879,0.63,0.1343,55,225,280,225
3720,6/8/2011,2,0,6,21,0,3,1,1,0.8,0.803,0.66,0.1343,34,168,202,168
3721,6/8/2011,2,0,6,22,0,3,1,1,0.76,0.7424,0.75,0.1642,37,139,176,139
3722,6/8/2011,2,0,6,23,0,3,1,1,0.76,0.7424,0.75,0.194,18,98,116,98
3723,6/9/2011,2,0,6,0,0,4,1,2,0.74,0.7121,0.79,0.1343,7,40,47,40
3724,6/9/2011,2,0,6,1,0,4,1,1,0.74,0.7121,0.79,0.1045,3,13,16,13
3725,6/9/2011,2,0,6,2,0,4,1,2,0.72,0.7121,0.84,0.1642,0,6,6,6
3726,6/9/2011,2,0,6,3,0,4,1,2,0.72,0.7121,0.84,0.1045,0,2,2,2
3727,6/9/2011,2,0,6,4,0,4,1,2,0.72,0.697,0.79,0.0896,2,4,6,4
3728,6/9/2011,2,0,6,5,0,4,1,2,0.7,0.6667,0.84,0,1,19,20,19
3729,6/9/2011,2,0,6,6,0,4,1,2,0.72,0.7121,0.84,0.0896,13,105,118,105
3730,6/9/2011,2,0,6,7,0,4,1,2,0.72,0.697,0.79,0.1343,31,283,314,283
3731,6/9/2011,2,0,6,8,0,4,1,2,0.76,0.7273,0.7,0.1045,32,400,432,400
3732,6/9/2011,2,0,6,9,0,4,1,1,0.84,0.7879,0.49,0,20,148,168,148
3733,6/9/2011,2,0,6,10,0,4,1,1,0.86,0.8182,0.5,0.2836,20,74,94,74
3734,6/9/2011,2,0,6,11,0,4,1,1,0.9,0.8485,0.42,0.2239,36,82,118,82
3735,6/9/2011,2,0,6,12,0,4,1,1,0.92,0.8485,0.35,0.194,40,100,140,100
3736,6/9/2011,2,0,6,13,0,4,1,1,0.9,0.8182,0.37,0.0896,18,118,136,118
3737,6/9/2011,2,0,6,14,0,4,1,1,0.92,0.8788,0.4,0.194,25,93,118,93
3738,6/9/2011,2,0,6,15,0,4,1,1,0.94,0.8333,0.31,0.1642,18,86,104,86
3739,6/9/2011,2,0,6,16,0,4,1,1,0.92,0.8333,0.33,0.1343,30,170,200,170
3740,6/9/2011,2,0,6,17,0,4,1,1,0.9,0.8182,0.37,0.2537,54,355,409,355
3741,6/9/2011,2,0,6,18,0,4,1,1,0.88,0.803,0.39,0.2836,52,414,466,414
3742,6/9/2011,2,0,6,19,0,4,1,2,0.84,0.7424,0.39,0.3284,55,271,326,271
3743,6/9/2011,2,0,6,20,0,4,1,2,0.8,0.7273,0.43,0.194,40,214,254,214
3744,6/9/2011,2,0,6,21,0,4,1,3,0.76,0.697,0.52,0,29,142,171,142
3745,6/9/2011,2,0,6,22,0,4,1,2,0.74,0.6818,0.58,0.1642,22,131,153,131
3746,6/9/2011,2,0,6,23,0,4,1,2,0.74,0.697,0.57,0.1642,15,82,97,82
3747,6/10/2011,2,0,6,0,0,5,1,3,0.7,0.6515,0.65,0.2239,8,61,69,61
3748,6/10/2011,2,0,6,1,0,5,1,3,0.7,0.6515,0.65,0.2239,5,18,23,18
3749,6/10/2011,2,0,6,2,0,5,1,1,0.68,0.6364,0.69,0.1642,6,7,13,7
3750,6/10/2011,2,0,6,3,0,5,1,1,0.68,0.6364,0.69,0.1642,3,3,6,3
3751,6/10/2011,2,0,6,4,0,5,1,1,0.66,0.6061,0.78,0.1642,0,4,4,4
3752,6/10/2011,2,0,6,5,0,5,1,1,0.66,0.6061,0.78,0.1642,0,28,28,28
3753,6/10/2011,2,0,6,6,0,5,1,1,0.66,0.6061,0.78,0.0896,10,94,104,94
3754,6/10/2011,2,0,6,7,0,5,1,1,0.72,0.6818,0.66,0.1045,25,242,267,242
3755,6/10/2011,2,0,6,8,0,5,1,1,0.74,0.6818,0.58,0.1343,29,423,452,423
3756,6/10/2011,2,0,6,9,0,5,1,1,0.76,0.697,0.55,0,37,176,213,176
3757,6/10/2011,2,0,6,10,0,5,1,1,0.78,0.7121,0.52,0,23,88,111,88
3758,6/10/2011,2,0,6,11,0,5,1,1,0.82,0.7576,0.46,0,46,107,153,107
3759,6/10/2011,2,0,6,12,0,5,1,1,0.84,0.7576,0.44,0.1343,40,167,207,167
3760,6/10/2011,2,0,6,13,0,5,1,1,0.84,0.7576,0.44,0.1045,40,149,189,149
3761,6/10/2011,2,0,6,14,0,5,1,1,0.86,0.7727,0.39,0,44,121,165,121
3762,6/10/2011,2,0,6,15,0,5,1,1,0.84,0.7576,0.44,0.1045,49,163,212,163
3763,6/10/2011,2,0,6,16,0,5,1,1,0.82,0.7879,0.56,0.2985,46,239,285,239
3764,6/10/2011,2,0,6,17,0,5,1,1,0.82,0.7727,0.52,0.2239,63,454,517,454
3765,6/10/2011,2,0,6,18,0,5,1,1,0.8,0.7727,0.59,0.2239,96,367,463,367
3766,6/10/2011,2,0,6,19,0,5,1,1,0.78,0.7424,0.59,0.194,61,245,306,245
3767,6/10/2011,2,0,6,20,0,5,1,1,0.76,0.7121,0.62,0.1045,53,197,250,197
3768,6/10/2011,2,0,6,21,0,5,1,1,0.76,0.7273,0.66,0.1343,55,163,218,163
3769,6/10/2011,2,0,6,22,0,5,1,1,0.72,0.697,0.74,0.2537,40,145,185,145
3770,6/10/2011,2,0,6,23,0,5,1,1,0.72,0.697,0.74,0.1642,36,110,146,110
3771,6/11/2011,2,0,6,0,0,6,0,1,0.7,0.6667,0.79,0.1343,28,89,117,89
3772,6/11/2011,2,0,6,1,0,6,0,1,0.7,0.6667,0.79,0.0896,10,67,77,67
3773,6/11/2011,2,0,6,2,0,6,0,1,0.7,0.6667,0.79,0.1045,10,50,60,50
3774,6/11/2011,2,0,6,3,0,6,0,1,0.68,0.6364,0.83,0.0896,10,18,28,18
3775,6/11/2011,2,0,6,4,0,6,0,1,0.68,0.6364,0.79,0.0896,4,9,13,9
3776,6/11/2011,2,0,6,5,0,6,0,1,0.68,0.6364,0.74,0.1343,4,12,16,12
3777,6/11/2011,2,0,6,6,0,6,0,1,0.7,0.6515,0.61,0.1343,9,31,40,31
3778,6/11/2011,2,0,6,7,0,6,0,1,0.72,0.6667,0.58,0.194,18,50,68,50
3779,6/11/2011,2,0,6,8,0,6,0,1,0.74,0.6818,0.58,0.194,32,111,143,111
3780,6/11/2011,2,0,6,9,0,6,0,1,0.74,0.6818,0.62,0.1343,59,171,230,171
3781,6/11/2011,2,0,6,10,0,6,0,1,0.74,0.6818,0.58,0.1642,91,173,264,173
3782,6/11/2011,2,0,6,11,0,6,0,1,0.76,0.7121,0.62,0.1343,110,215,325,215
3783,6/11/2011,2,0,6,12,0,6,0,1,0.8,0.7576,0.55,0.2239,112,235,347,235
3784,6/11/2011,2,0,6,13,0,6,0,1,0.8,0.7576,0.55,0.194,150,237,387,237
3785,6/11/2011,2,0,6,14,0,6,0,1,0.82,0.7727,0.49,0.1045,148,232,380,232
3786,6/11/2011,2,0,6,15,0,6,0,1,0.82,0.7727,0.49,0.1045,142,232,374,232
3787,6/11/2011,2,0,6,16,0,6,0,2,0.8,0.7273,0.46,0.194,169,225,394,225
3788,6/11/2011,2,0,6,17,0,6,0,2,0.74,0.6818,0.58,0.1642,147,190,337,190
3789,6/11/2011,2,0,6,18,0,6,0,2,0.72,0.6818,0.62,0.1343,131,155,286,155
3790,6/11/2011,2,0,6,19,0,6,0,1,0.7,0.6515,0.65,0.194,97,167,264,167
3791,6/11/2011,2,0,6,20,0,6,0,1,0.68,0.6364,0.74,0.2537,95,180,275,180
3792,6/11/2011,2,0,6,21,0,6,0,1,0.66,0.6212,0.74,0.2239,76,144,220,144
3793,6/11/2011,2,0,6,22,0,6,0,1,0.66,0.6061,0.78,0.2239,53,137,190,137
3794,6/11/2011,2,0,6,23,0,6,0,1,0.66,0.6212,0.74,0.1045,24,107,131,107
3795,6/12/2011,2,0,6,0,0,0,0,1,0.66,0.6061,0.78,0.2239,19,100,119,100
3796,6/12/2011,2,0,6,1,0,0,0,1,0.64,0.5758,0.83,0.1045,19,74,93,74
3797,6/12/2011,2,0,6,2,0,0,0,1,0.64,0.5758,0.89,0.2537,9,57,66,57
3798,6/12/2011,2,0,6,3,0,0,0,1,0.64,0.5758,0.89,0.2836,8,20,28,20
3799,6/12/2011,2,0,6,4,0,0,0,1,0.62,0.5606,0.88,0.1642,8,6,14,6
3800,6/12/2011,2,0,6,5,0,0,0,1,0.62,0.5606,0.88,0.2239,5,5,10,5
3801,6/12/2011,2,0,6,6,0,0,0,1,0.62,0.5606,0.88,0.1045,5,9,14,9
3802,6/12/2011,2,0,6,7,0,0,0,1,0.64,0.5909,0.78,0.1045,7,27,34,27
3803,6/12/2011,2,0,6,8,0,0,0,1,0.7,0.6667,0.74,0,28,64,92,64
3804,6/12/2011,2,0,6,9,0,0,0,1,0.72,0.6818,0.66,0,75,107,182,107
3805,6/12/2011,2,0,6,10,0,0,0,1,0.76,0.7121,0.58,0.0896,120,191,311,191
3806,6/12/2011,2,0,6,11,0,0,0,1,0.78,0.7273,0.55,0.1045,131,236,367,236
3807,6/12/2011,2,0,6,12,0,0,0,1,0.82,0.7576,0.46,0,176,244,420,244
3808,6/12/2011,2,0,6,13,0,0,0,1,0.78,0.7424,0.59,0.2836,109,264,373,264
3809,6/12/2011,2,0,6,14,0,0,0,1,0.82,0.7879,0.56,0.2537,96,219,315,219
3810,6/12/2011,2,0,6,15,0,0,0,1,0.8,0.7727,0.59,0.2985,142,218,360,218
3811,6/12/2011,2,0,6,16,0,0,0,3,0.68,0.6364,0.83,0.2836,115,235,350,235
3812,6/12/2011,2,0,6,17,0,0,0,3,0.68,0.6364,0.83,0.2836,94,158,252,158
3813,6/12/2011,2,0,6,18,0,0,0,1,0.7,0.6667,0.74,0.1642,69,187,256,187
3814,6/12/2011,2,0,6,19,0,0,0,1,0.7,0.6667,0.74,0.1045,67,156,223,156
3815,6/12/2011,2,0,6,20,0,0,0,1,0.66,0.6061,0.83,0.1642,62,144,206,144
3816,6/12/2011,2,0,6,21,0,0,0,1,0.66,0.6061,0.83,0.1045,39,101,140,101
3817,6/12/2011,2,0,6,22,0,0,0,1,0.64,0.5758,0.83,0.1343,31,97,128,97
3818,6/12/2011,2,0,6,23,0,0,0,1,0.64,0.5909,0.78,0.194,33,74,107,74
3819,6/13/2011,2,0,6,0,0,1,1,1,0.64,0.5909,0.78,0.1343,8,20,28,20
3820,6/13/2011,2,0,6,1,0,1,1,1,0.64,0.6061,0.73,0.2239,6,10,16,10
3821,6/13/2011,2,0,6,2,0,1,1,1,0.62,0.5909,0.73,0.2836,2,8,10,8
3822,6/13/2011,2,0,6,3,0,1,1,1,0.6,0.6061,0.6,0.4925,1,6,7,6
3823,6/13/2011,2,0,6,4,0,1,1,1,0.56,0.5303,0.64,0.2985,1,3,4,3
3824,6/13/2011,2,0,6,5,0,1,1,1,0.54,0.5152,0.64,0.3881,2,27,29,27
3825,6/13/2011,2,0,6,6,0,1,1,1,0.54,0.5152,0.64,0.4179,7,98,105,98
3826,6/13/2011,2,0,6,7,0,1,1,1,0.56,0.5303,0.56,0.3582,26,302,328,302
3827,6/13/2011,2,0,6,8,0,1,1,1,0.58,0.5455,0.49,0.4478,44,432,476,432
3828,6/13/2011,2,0,6,9,0,1,1,1,0.62,0.6212,0.46,0.3582,35,189,224,189
3829,6/13/2011,2,0,6,10,0,1,1,1,0.64,0.6212,0.41,0.3284,38,80,118,80
3830,6/13/2011,2,0,6,11,0,1,1,1,0.66,0.6212,0.41,0.2985,53,106,159,106
3831,6/13/2011,2,0,6,12,0,1,1,1,0.66,0.6212,0.41,0.2836,35,161,196,161
3832,6/13/2011,2,0,6,13,0,1,1,1,0.7,0.6364,0.37,0,53,174,227,174
3833,6/13/2011,2,0,6,14,0,1,1,1,0.7,0.6364,0.34,0.2537,55,145,200,145
3834,6/13/2011,2,0,6,15,0,1,1,1,0.7,0.6364,0.37,0.4478,58,127,185,127
3835,6/13/2011,2,0,6,16,0,1,1,1,0.7,0.6364,0.37,0.4179,64,262,326,262
3836,6/13/2011,2,0,6,17,0,1,1,1,0.7,0.6364,0.39,0.3284,72,529,601,529
3837,6/13/2011,2,0,6,18,0,1,1,1,0.7,0.6364,0.37,0.3582,76,510,586,510
3838,6/13/2011,2,0,6,19,0,1,1,1,0.66,0.6212,0.39,0.2836,75,348,423,348
3839,6/13/2011,2,0,6,20,0,1,1,1,0.64,0.6212,0.44,0.2537,78,253,331,253
3840,6/13/2011,2,0,6,21,0,1,1,1,0.64,0.6212,0.41,0.2537,40,178,218,178
3841,6/13/2011,2,0,6,22,0,1,1,1,0.62,0.6212,0.46,0.2239,20,114,134,114
3842,6/13/2011,2,0,6,23,0,1,1,1,0.62,0.6212,0.46,0.194,14,75,89,75
3843,6/14/2011,2,0,6,0,0,2,1,1,0.6,0.6212,0.49,0.194,13,18,31,18
3844,6/14/2011,2,0,6,1,0,2,1,1,0.6,0.6212,0.49,0.2537,3,10,13,10
3845,6/14/2011,2,0,6,2,0,2,1,1,0.6,0.6212,0.49,0.2836,2,8,10,8
3846,6/14/2011,2,0,6,3,0,2,1,1,0.58,0.5455,0.53,0.3284,1,1,2,1
3847,6/14/2011,2,0,6,4,0,2,1,1,0.54,0.5152,0.6,0.2537,0,3,3,3
3848,6/14/2011,2,0,6,5,0,2,1,1,0.54,0.5152,0.56,0.3284,3,23,26,23
3849,6/14/2011,2,0,6,6,0,2,1,1,0.54,0.5152,0.56,0.2985,6,107,113,107
3850,6/14/2011,2,0,6,7,0,2,1,1,0.56,0.5303,0.52,0.4179,19,346,365,346
3851,6/14/2011,2,0,6,8,0,2,1,1,0.58,0.5455,0.49,0.3881,45,441,486,441
3852,6/14/2011,2,0,6,9,0,2,1,1,0.62,0.6212,0.46,0.194,19,174,193,174
3853,6/14/2011,2,0,6,10,0,2,1,1,0.62,0.6212,0.46,0.2239,33,97,130,97
3854,6/14/2011,2,0,6,11,0,2,1,1,0.64,0.6212,0.41,0.2836,40,103,143,103
3855,6/14/2011,2,0,6,12,0,2,1,1,0.64,0.6212,0.41,0.3582,30,139,169,139
3856,6/14/2011,2,0,6,13,0,2,1,1,0.64,0.6212,0.44,0.2239,33,176,209,176
3857,6/14/2011,2,0,6,14,0,2,1,2,0.64,0.6212,0.47,0.194,41,118,159,118
3858,6/14/2011,2,0,6,15,0,2,1,1,0.64,0.6212,0.47,0.1642,42,136,178,136
3859,6/14/2011,2,0,6,16,0,2,1,1,0.68,0.6364,0.41,0.194,51,279,330,279
3860,6/14/2011,2,0,6,17,0,2,1,3,0.64,0.6212,0.5,0.2836,85,484,569,484
3861,6/14/2011,2,0,6,18,0,2,1,1,0.62,0.6212,0.51,0.3284,65,473,538,473
3862,6/14/2011,2,0,6,19,0,2,1,1,0.64,0.6212,0.5,0.3582,51,335,386,335
3863,6/14/2011,2,0,6,20,0,2,1,1,0.6,0.6212,0.56,0.1642,60,237,297,237
3864,6/14/2011,2,0,6,21,0,2,1,1,0.6,0.6212,0.56,0.2985,37,206,243,206
3865,6/14/2011,2,0,6,22,0,2,1,1,0.58,0.5455,0.6,0.2239,29,159,188,159
3866,6/14/2011,2,0,6,23,0,2,1,1,0.56,0.5303,0.68,0.2239,19,91,110,91
3867,6/15/2011,2,0,6,0,0,3,1,1,0.56,0.5303,0.64,0.3582,8,44,52,44
3868,6/15/2011,2,0,6,1,0,3,1,1,0.54,0.5152,0.64,0.2836,0,14,14,14
3869,6/15/2011,2,0,6,2,0,3,1,1,0.52,0.5,0.63,0.2239,0,9,9,9
3870,6/15/2011,2,0,6,3,0,3,1,1,0.5,0.4848,0.68,0.2537,0,1,1,1
3871,6/15/2011,2,0,6,4,0,3,1,1,0.5,0.4848,0.63,0.2836,0,4,4,4
3872,6/15/2011,2,0,6,5,0,3,1,1,0.48,0.4697,0.67,0.2836,1,20,21,20
3873,6/15/2011,2,0,6,6,0,3,1,1,0.5,0.4848,0.63,0.2537,11,110,121,110
3874,6/15/2011,2,0,6,7,0,3,1,1,0.54,0.5152,0.6,0.1343,22,348,370,348
3875,6/15/2011,2,0,6,8,0,3,1,1,0.58,0.5455,0.53,0.1343,53,445,498,445
3876,6/15/2011,2,0,6,9,0,3,1,1,0.6,0.6212,0.49,0,22,185,207,185
3877,6/15/2011,2,0,6,10,0,3,1,1,0.64,0.6212,0.47,0.1642,27,108,135,108
3878,6/15/2011,2,0,6,11,0,3,1,1,0.68,0.6364,0.36,0,49,115,164,115
3879,6/15/2011,2,0,6,12,0,3,1,1,0.7,0.6364,0.34,0.2239,33,178,211,178
3880,6/15/2011,2,0,6,13,0,3,1,1,0.74,0.6515,0.28,0.2836,43,146,189,146
3881,6/15/2011,2,0,6,14,0,3,1,1,0.74,0.6515,0.28,0,50,128,178,128
3882,6/15/2011,2,0,6,15,0,3,1,1,0.76,0.6667,0.27,0,33,131,164,131
3883,6/15/2011,2,0,6,16,0,3,1,1,0.76,0.6667,0.27,0.1343,47,265,312,265
3884,6/15/2011,2,0,6,17,0,3,1,1,0.74,0.6515,0.28,0.1045,83,555,638,555
3885,6/15/2011,2,0,6,18,0,3,1,1,0.72,0.6515,0.32,0.1343,80,527,607,527
3886,6/15/2011,2,0,6,19,0,3,1,1,0.7,0.6364,0.37,0.2836,54,362,416,362
3887,6/15/2011,2,0,6,20,0,3,1,1,0.66,0.6212,0.44,0.1642,57,273,330,273
3888,6/15/2011,2,0,6,21,0,3,1,1,0.64,0.6212,0.47,0.2239,48,209,257,209
3889,6/15/2011,2,0,6,22,0,3,1,1,0.62,0.6212,0.5,0.1045,31,144,175,144
3890,6/15/2011,2,0,6,23,0,3,1,1,0.62,0.6212,0.53,0,17,90,107,90
3891,6/16/2011,2,0,6,0,0,4,1,1,0.6,0.6212,0.56,0.1045,9,38,47,38
3892,6/16/2011,2,0,6,1,0,4,1,1,0.58,0.5455,0.6,0,4,13,17,13
3893,6/16/2011,2,0,6,2,0,4,1,1,0.6,0.6212,0.56,0.0896,1,4,5,4
3894,6/16/2011,2,0,6,3,0,4,1,2,0.56,0.5303,0.73,0.0896,0,4,4,4
3895,6/16/2011,2,0,6,4,0,4,1,2,0.56,0.5303,0.68,0.1045,0,6,6,6
3896,6/16/2011,2,0,6,5,0,4,1,1,0.6,0.6061,0.64,0.194,7,18,25,18
3897,6/16/2011,2,0,6,6,0,4,1,3,0.58,0.5455,0.73,0.1642,8,104,112,104
3898,6/16/2011,2,0,6,7,0,4,1,3,0.56,0.5303,0.78,0.1642,16,172,188,172
3899,6/16/2011,2,0,6,8,0,4,1,2,0.6,0.5909,0.69,0.1343,24,364,388,364
3900,6/16/2011,2,0,6,9,0,4,1,2,0.62,0.6061,0.65,0.194,29,232,261,232
3901,6/16/2011,2,0,6,10,0,4,1,2,0.66,0.6212,0.61,0.2537,18,103,121,103
3902,6/16/2011,2,0,6,11,0,4,1,2,0.68,0.6364,0.61,0.2985,33,117,150,117
3903,6/16/2011,2,0,6,12,0,4,1,1,0.72,0.6667,0.54,0.3881,41,165,206,165
3904,6/16/2011,2,0,6,13,0,4,1,2,0.72,0.6667,0.54,0.2537,37,114,151,114
3905,6/16/2011,2,0,6,14,0,4,1,2,0.72,0.6667,0.54,0.3284,39,114,153,114
3906,6/16/2011,2,0,6,15,0,4,1,2,0.7,0.6515,0.61,0.2985,32,127,159,127
3907,6/16/2011,2,0,6,16,0,4,1,3,0.66,0.6212,0.69,0.194,36,258,294,258
3908,6/16/2011,2,0,6,17,0,4,1,2,0.64,0.5909,0.78,0.1045,42,230,272,230
3909,6/16/2011,2,0,6,18,0,4,1,1,0.64,0.5758,0.83,0.2239,26,299,325,299
3910,6/16/2011,2,0,6,19,0,4,1,1,0.62,0.5758,0.83,0.2836,58,269,327,269
3911,6/16/2011,2,0,6,20,0,4,1,1,0.62,0.5758,0.83,0.3284,25,176,201,176
3912,6/16/2011,2,0,6,21,0,4,1,3,0.62,0.5758,0.83,0.2537,34,154,188,154
3913,6/16/2011,2,0,6,22,0,4,1,3,0.62,0.5758,0.83,0.2537,24,127,151,127
3914,6/16/2011,2,0,6,23,0,4,1,3,0.6,0.5606,0.83,0.2537,2,14,16,14
3915,6/17/2011,2,0,6,0,0,5,1,1,0.56,0.5303,0.88,0.0896,3,21,24,21
3916,6/17/2011,2,0,6,1,0,5,1,1,0.56,0.5303,0.94,0.1343,4,19,23,19
3917,6/17/2011,2,0,6,2,0,5,1,1,0.56,0.5303,0.94,0.1045,2,11,13,11
3918,6/17/2011,2,0,6,3,0,5,1,1,0.56,0.5303,0.94,0.1045,1,5,6,5
3919,6/17/2011,2,0,6,4,0,5,1,1,0.54,0.5152,0.94,0.1343,1,5,6,5
3920,6/17/2011,2,0,6,5,0,5,1,1,0.54,0.5152,1,0,1,12,13,12
3921,6/17/2011,2,0,6,6,0,5,1,1,0.56,0.5303,0.94,0,8,89,97,89
3922,6/17/2011,2,0,6,7,0,5,1,1,0.6,0.5606,0.83,0,25,225,250,225
3923,6/17/2011,2,0,6,8,0,5,1,2,0.6,0.5606,0.83,0,28,426,454,426
3924,6/17/2011,2,0,6,9,0,5,1,1,0.7,0.6515,0.58,0.194,28,196,224,196
3925,6/17/2011,2,0,6,10,0,5,1,1,0.7,0.6515,0.58,0.194,44,126,170,126
3926,6/17/2011,2,0,6,11,0,5,1,1,0.68,0.6364,0.69,0.2537,43,138,181,138
3927,6/17/2011,2,0,6,12,0,5,1,1,0.7,0.6515,0.65,0.2537,49,194,243,194
3928,6/17/2011,2,0,6,13,0,5,1,1,0.74,0.6818,0.62,0.2836,48,156,204,156
3929,6/17/2011,2,0,6,14,0,5,1,1,0.76,0.697,0.52,0.194,73,142,215,142
3930,6/17/2011,2,0,6,15,0,5,1,1,0.78,0.697,0.43,0.2239,62,181,243,181
3931,6/17/2011,2,0,6,16,0,5,1,1,0.76,0.6818,0.45,0.1642,69,286,355,286
3932,6/17/2011,2,0,6,17,0,5,1,3,0.76,0.6818,0.4,0.194,85,467,552,467
3933,6/17/2011,2,0,6,18,0,5,1,3,0.76,0.6818,0.4,0.194,62,388,450,388
3934,6/17/2011,2,0,6,19,0,5,1,3,0.64,0.5758,0.83,0.2537,53,275,328,275
3935,6/17/2011,2,0,6,20,0,5,1,1,0.64,0.5909,0.78,0.1045,40,192,232,192
3936,6/17/2011,2,0,6,21,0,5,1,1,0.64,0.5909,0.78,0.0896,49,159,208,159
3937,6/17/2011,2,0,6,22,0,5,1,1,0.62,0.5606,0.88,0.1343,48,127,175,127
3938,6/17/2011,2,0,6,23,0,5,1,1,0.62,0.5758,0.83,0.1343,37,141,178,141
3939,6/18/2011,2,0,6,0,0,6,0,1,0.62,0.5606,0.88,0.1343,21,83,104,83
3940,6/18/2011,2,0,6,1,0,6,0,1,0.62,0.5758,0.83,0.1045,15,80,95,80
3941,6/18/2011,2,0,6,2,0,6,0,1,0.6,0.5455,0.88,0,16,37,53,37
3942,6/18/2011,2,0,6,3,0,6,0,1,0.6,0.5455,0.88,0.0896,4,16,20,16
3943,6/18/2011,2,0,6,4,0,6,0,1,0.6,0.5455,0.88,0.0896,1,4,5,4
3944,6/18/2011,2,0,6,5,0,6,0,1,0.62,0.5758,0.83,0,1,6,7,6
3945,6/18/2011,2,0,6,6,0,6,0,1,0.62,0.5758,0.83,0.1045,9,18,27,18
3946,6/18/2011,2,0,6,7,0,6,0,1,0.64,0.5909,0.78,0.1343,12,45,57,45
3947,6/18/2011,2,0,6,8,0,6,0,1,0.66,0.6061,0.78,0.0896,28,103,131,103
3948,6/18/2011,2,0,6,9,0,6,0,1,0.7,0.6515,0.61,0.2239,62,156,218,156
3949,6/18/2011,2,0,6,10,0,6,0,1,0.72,0.6818,0.62,0.194,68,176,244,176
3950,6/18/2011,2,0,6,11,0,6,0,1,0.72,0.6818,0.62,0.1343,134,270,404,270
3951,6/18/2011,2,0,6,12,0,6,0,1,0.74,0.697,0.66,0.0896,162,258,420,258
3952,6/18/2011,2,0,6,13,0,6,0,1,0.76,0.697,0.55,0,135,192,327,192
3953,6/18/2011,2,0,6,14,0,6,0,2,0.8,0.7273,0.46,0.2836,138,196,334,196
3954,6/18/2011,2,0,6,15,0,6,0,2,0.82,0.7576,0.46,0.1343,153,214,367,214
3955,6/18/2011,2,0,6,16,0,6,0,2,0.76,0.697,0.52,0.2239,193,275,468,275
3956,6/18/2011,2,0,6,17,0,6,0,2,0.76,0.6818,0.48,0.1642,210,239,449,239
3957,6/18/2011,2,0,6,18,0,6,0,2,0.74,0.6818,0.55,0.194,118,263,381,263
3958,6/18/2011,2,0,6,19,0,6,0,2,0.74,0.6667,0.51,0.1045,99,227,326,227
3959,6/18/2011,2,0,6,20,0,6,0,2,0.72,0.6667,0.58,0.1343,61,127,188,127
3960,6/18/2011,2,0,6,21,0,6,0,2,0.72,0.6818,0.66,0.1045,58,125,183,125
3961,6/18/2011,2,0,6,22,0,6,0,2,0.72,0.6818,0.62,0.1343,56,105,161,105
3962,6/18/2011,2,0,6,23,0,6,0,2,0.72,0.6818,0.62,0,53,97,150,97
3963,6/19/2011,2,0,6,0,0,0,0,1,0.7,0.6515,0.65,0,18,71,89,71
3964,6/19/2011,2,0,6,1,0,0,0,2,0.7,0.6515,0.65,0.0896,17,59,76,59
3965,6/19/2011,2,0,6,2,0,0,0,1,0.68,0.6364,0.74,0.0896,13,59,72,59
3966,6/19/2011,2,0,6,3,0,0,0,2,0.66,0.6061,0.78,0.1343,14,16,30,16
3967,6/19/2011,2,0,6,4,0,0,0,2,0.66,0.6212,0.74,0.1343,7,10,17,10
3968,6/19/2011,2,0,6,5,0,0,0,2,0.66,0.6061,0.78,0,7,12,19,12
3969,6/19/2011,2,0,6,6,0,0,0,2,0.66,0.6061,0.78,0.1642,11,22,33,22
3970,6/19/2011,2,0,6,7,0,0,0,2,0.66,0.6061,0.78,0.1642,35,36,71,36
3971,6/19/2011,2,0,6,8,0,0,0,3,0.68,0.6364,0.74,0.1045,25,59,84,59
3972,6/19/2011,2,0,6,9,0,0,0,2,0.68,0.6364,0.74,0.1045,58,111,169,111
3973,6/19/2011,2,0,6,10,0,0,0,2,0.7,0.6515,0.61,0.1045,86,158,244,158
3974,6/19/2011,2,0,6,11,0,0,0,2,0.72,0.6667,0.58,0.0896,141,236,377,236
3975,6/19/2011,2,0,6,12,0,0,0,2,0.74,0.6818,0.55,0.0896,141,255,396,255
3976,6/19/2011,2,0,6,13,0,0,0,2,0.74,0.6667,0.51,0,149,214,363,214
3977,6/19/2011,2,0,6,14,0,0,0,3,0.74,0.6818,0.58,0.1045,124,193,317,193
3978,6/19/2011,2,0,6,15,0,0,0,2,0.74,0.6818,0.55,0.1045,146,216,362,216
3979,6/19/2011,2,0,6,16,0,0,0,2,0.76,0.6818,0.48,0,121,257,378,257
3980,6/19/2011,2,0,6,17,0,0,0,1,0.74,0.6667,0.51,0,159,238,397,238
3981,6/19/2011,2,0,6,18,0,0,0,2,0.74,0.6818,0.58,0.0896,78,218,296,218
3982,6/19/2011,2,0,6,19,0,0,0,1,0.72,0.6818,0.62,0.1343,94,217,311,217
3983,6/19/2011,2,0,6,20,0,0,0,1,0.7,0.6515,0.7,0.194,86,146,232,146
3984,6/19/2011,2,0,6,21,0,0,0,1,0.68,0.6364,0.79,0.1343,57,110,167,110
3985,6/19/2011,2,0,6,22,0,0,0,1,0.66,0.6061,0.78,0.2239,38,114,152,114
3986,6/19/2011,2,0,6,23,0,0,0,1,0.66,0.6061,0.78,0.194,14,78,92,78
3987,6/20/2011,2,0,6,0,0,1,1,1,0.66,0.6061,0.83,0.1642,7,19,26,19
3988,6/20/2011,2,0,6,1,0,1,1,1,0.64,0.5758,0.89,0.0896,9,3,12,3
3989,6/20/2011,2,0,6,2,0,1,1,1,0.64,0.5758,0.89,0.0896,2,0,2,0
3990,6/20/2011,2,0,6,3,0,1,1,3,0.64,0.5758,0.89,0,1,0,1,0
3991,6/20/2011,2,0,6,4,0,1,1,3,0.62,0.5606,0.88,0.1642,1,2,3,2
3992,6/20/2011,2,0,6,5,0,1,1,3,0.62,0.5758,0.83,0.1343,0,3,3,3
3993,6/20/2011,2,0,6,6,0,1,1,3,0.6,0.5758,0.78,0.1343,1,25,26,25
3994,6/20/2011,2,0,6,7,0,1,1,3,0.56,0.5303,0.88,0.194,0,46,46,46
3995,6/20/2011,2,0,6,8,0,1,1,3,0.56,0.5303,0.83,0.194,12,209,221,209
3996,6/20/2011,2,0,6,9,0,1,1,2,0.6,0.5758,0.78,0.2537,19,200,219,200
3997,6/20/2011,2,0,6,10,0,1,1,2,0.6,0.5758,0.78,0.2537,33,58,91,58
3998,6/20/2011,2,0,6,11,0,1,1,2,0.6,0.5758,0.78,0.1045,27,67,94,67
3999,6/20/2011,2,0,6,12,0,1,1,2,0.62,0.6061,0.69,0.1045,33,129,162,129
4000,6/20/2011,2,0,6,13,0,1,1,1,0.64,0.6061,0.65,0.1045,50,129,179,129
4001,6/20/2011,2,0,6,14,0,1,1,1,0.66,0.6212,0.61,0.1045,45,130,175,130
4002,6/20/2011,2,0,6,15,0,1,1,1,0.66,0.6212,0.61,0.1343,66,139,205,139
4003,6/20/2011,2,0,6,16,0,1,1,1,0.7,0.6515,0.58,0.1642,61,238,299,238
4004,6/20/2011,2,0,6,17,0,1,1,1,0.7,0.6515,0.54,0,81,484,565,484
4005,6/20/2011,2,0,6,18,0,1,1,1,0.7,0.6515,0.61,0.2537,64,474,538,474
4006,6/20/2011,2,0,6,19,0,1,1,1,0.66,0.6212,0.65,0.2239,62,369,431,369
4007,6/20/2011,2,0,6,20,0,1,1,1,0.66,0.6212,0.69,0.2239,52,264,316,264
4008,6/20/2011,2,0,6,21,0,1,1,1,0.64,0.6061,0.73,0.1642,39,167,206,167
4009,6/20/2011,2,0,6,22,0,1,1,2,0.64,0.6061,0.73,0.2239,24,106,130,106
4010,6/20/2011,2,0,6,23,0,1,1,1,0.62,0.5909,0.78,0.2537,10,50,60,50
4011,6/21/2011,3,0,6,0,0,2,1,1,0.62,0.5909,0.78,0.1642,10,23,33,23
4012,6/21/2011,3,0,6,1,0,2,1,3,0.62,0.5909,0.78,0.1642,2,12,14,12
4013,6/21/2011,3,0,6,2,0,2,1,3,0.62,0.5758,0.83,0.1642,1,5,6,5
4014,6/21/2011,3,0,6,3,0,2,1,3,0.62,0.5758,0.83,0.1642,0,2,2,2
4015,6/21/2011,3,0,6,4,0,2,1,2,0.6,0.5455,0.88,0.1045,2,7,9,7
4016,6/21/2011,3,0,6,5,0,2,1,2,0.6,0.5455,0.88,0.1343,3,22,25,22
4017,6/21/2011,3,0,6,6,0,2,1,2,0.6,0.5455,0.88,0.1343,8,107,115,107
4018,6/21/2011,3,0,6,7,0,2,1,2,0.6,0.5152,0.94,0,21,288,309,288
4019,6/21/2011,3,0,6,8,0,2,1,2,0.62,0.5606,0.88,0.1045,33,368,401,368
4020,6/21/2011,3,0,6,9,0,2,1,2,0.62,0.5606,0.88,0.2537,32,243,275,243
4021,6/21/2011,3,0,6,10,0,2,1,2,0.64,0.5758,0.83,0.194,41,120,161,120
4022,6/21/2011,3,0,6,11,0,2,1,1,0.66,0.6061,0.83,0.1642,52,119,171,119
4023,6/21/2011,3,0,6,12,0,2,1,1,0.7,0.6667,0.74,0.1642,40,149,189,149
4024,6/21/2011,3,0,6,13,0,2,1,1,0.74,0.697,0.66,0.1642,49,158,207,158
4025,6/21/2011,3,0,6,14,0,2,1,1,0.76,0.7121,0.62,0.2239,44,108,152,108
4026,6/21/2011,3,0,6,15,0,2,1,1,0.78,0.7424,0.59,0.2537,42,128,170,128
4027,6/21/2011,3,0,6,16,0,2,1,1,0.8,0.7727,0.59,0.2239,62,273,335,273
4028,6/21/2011,3,0,6,17,0,2,1,1,0.78,0.7576,0.66,0.2239,65,507,572,507
4029,6/21/2011,3,0,6,18,0,2,1,2,0.76,0.7273,0.7,0.2537,67,469,536,469
4030,6/21/2011,3,0,6,19,0,2,1,2,0.74,0.7121,0.74,0.2239,67,358,425,358
4031,6/21/2011,3,0,6,20,0,2,1,3,0.74,0.697,0.7,0.2239,72,254,326,254
4032,6/21/2011,3,0,6,21,0,2,1,1,0.72,0.697,0.74,0.194,38,191,229,191
4033,6/21/2011,3,0,6,22,0,2,1,1,0.7,0.6667,0.79,0.1045,12,97,109,97
4034,6/21/2011,3,0,6,23,0,2,1,1,0.7,0.6667,0.74,0.1045,11,53,64,53
4035,6/22/2011,3,0,6,0,0,3,1,1,0.66,0.6061,0.78,0.194,15,18,33,18
4036,6/22/2011,3,0,6,1,0,3,1,1,0.66,0.6061,0.78,0.1343,2,19,21,19
4037,6/22/2011,3,0,6,2,0,3,1,1,0.66,0.6061,0.78,0,2,5,7,5
4038,6/22/2011,3,0,6,3,0,3,1,1,0.66,0.6061,0.78,0.1343,0,7,7,7
4039,6/22/2011,3,0,6,4,0,3,1,1,0.64,0.5758,0.83,0,3,8,11,8
4040,6/22/2011,3,0,6,5,0,3,1,1,0.64,0.5758,0.89,0,2,21,23,21
4041,6/22/2011,3,0,6,6,0,3,1,1,0.66,0.6061,0.83,0,12,110,122,110
4042,6/22/2011,3,0,6,7,0,3,1,1,0.7,0.6667,0.79,0,23,288,311,288
4043,6/22/2011,3,0,6,8,0,3,1,1,0.72,0.697,0.74,0.1045,27,396,423,396
4044,6/22/2011,3,0,6,9,0,3,1,1,0.72,0.697,0.79,0.1642,14,205,219,205
4045,6/22/2011,3,0,6,10,0,3,1,1,0.74,0.697,0.7,0.2537,31,104,135,104
4046,6/22/2011,3,0,6,11,0,3,1,1,0.74,0.697,0.7,0.1642,37,108,145,108
4047,6/22/2011,3,0,6,12,0,3,1,2,0.8,0.7727,0.59,0.2239,44,144,188,144
4048,6/22/2011,3,0,6,13,0,3,1,2,0.82,0.7879,0.56,0.2537,34,113,147,113
4049,6/22/2011,3,0,6,14,0,3,1,2,0.82,0.7727,0.52,0.2836,32,113,145,113
4050,6/22/2011,3,0,6,15,0,3,1,2,0.82,0.7879,0.56,0.2836,32,114,146,114
4051,6/22/2011,3,0,6,16,0,3,1,2,0.82,0.803,0.59,0.3284,34,224,258,224
4052,6/22/2011,3,0,6,17,0,3,1,2,0.8,0.7576,0.55,0.3881,67,462,529,462
4053,6/22/2011,3,0,6,18,0,3,1,2,0.8,0.7727,0.59,0.2537,66,447,513,447
4054,6/22/2011,3,0,6,19,0,3,1,2,0.8,0.7424,0.52,0.2537,62,280,342,280
4055,6/22/2011,3,0,6,20,0,3,1,1,0.74,0.7121,0.74,0.1343,52,230,282,230
4056,6/22/2011,3,0,6,21,0,3,1,1,0.74,0.7121,0.79,0.1642,31,216,247,216
4057,6/22/2011,3,0,6,22,0,3,1,2,0.72,0.697,0.79,0.194,25,123,148,123
4058,6/22/2011,3,0,6,23,0,3,1,2,0.72,0.697,0.79,0.2239,14,91,105,91
4059,6/23/2011,3,0,6,0,0,4,1,1,0.72,0.697,0.79,0.2239,5,44,49,44
4060,6/23/2011,3,0,6,1,0,4,1,1,0.72,0.697,0.74,0.2239,5,26,31,26
4061,6/23/2011,3,0,6,2,0,4,1,1,0.72,0.697,0.74,0.2239,0,4,4,4
4062,6/23/2011,3,0,6,3,0,4,1,2,0.72,0.697,0.74,0.1642,1,4,5,4
4063,6/23/2011,3,0,6,4,0,4,1,2,0.7,0.6667,0.79,0.1343,0,7,7,7
4064,6/23/2011,3,0,6,5,0,4,1,1,0.72,0.697,0.74,0.1642,2,22,24,22
4065,6/23/2011,3,0,6,6,0,4,1,1,0.72,0.697,0.74,0.1642,8,92,100,92
4066,6/23/2011,3,0,6,7,0,4,1,2,0.72,0.697,0.74,0.1343,26,301,327,301
4067,6/23/2011,3,0,6,8,0,4,1,2,0.74,0.697,0.7,0.194,20,412,432,412
4068,6/23/2011,3,0,6,9,0,4,1,2,0.74,0.697,0.7,0.1343,33,194,227,194
4069,6/23/2011,3,0,6,10,0,4,1,2,0.76,0.7273,0.66,0.1343,39,88,127,88
4070,6/23/2011,3,0,6,11,0,4,1,3,0.76,0.7273,0.66,0.2537,28,108,136,108
4071,6/23/2011,3,0,6,12,0,4,1,2,0.76,0.7273,0.66,0.2836,30,130,160,130
4072,6/23/2011,3,0,6,13,0,4,1,2,0.76,0.7121,0.62,0.2836,37,149,186,149
4073,6/23/2011,3,0,6,14,0,4,1,2,0.76,0.7273,0.66,0.2985,46,103,149,103
4074,6/23/2011,3,0,6,15,0,4,1,2,0.76,0.697,0.52,0.3582,62,127,189,127
4075,6/23/2011,3,0,6,16,0,4,1,2,0.74,0.6818,0.62,0.2985,58,217,275,217
4076,6/23/2011,3,0,6,17,0,4,1,2,0.72,0.6818,0.7,0.3582,74,495,569,495
4077,6/23/2011,3,0,6,18,0,4,1,1,0.72,0.6818,0.7,0.4179,57,483,540,483
4078,6/23/2011,3,0,6,19,0,4,1,1,0.72,0.6818,0.7,0.3582,56,344,400,344
4079,6/23/2011,3,0,6,20,0,4,1,1,0.7,0.6667,0.74,0.2239,75,277,352,277
4080,6/23/2011,3,0,6,21,0,4,1,1,0.7,0.6667,0.74,0.194,46,188,234,188
4081,6/23/2011,3,0,6,22,0,4,1,2,0.7,0.6667,0.74,0.2239,23,139,162,139
4082,6/23/2011,3,0,6,23,0,4,1,1,0.7,0.6667,0.74,0.2836,15,90,105,90
4083,6/24/2011,3,0,6,0,0,5,1,1,0.68,0.6364,0.79,0.194,10,53,63,53
4084,6/24/2011,3,0,6,1,0,5,1,1,0.66,0.6061,0.83,0.3284,8,20,28,20
4085,6/24/2011,3,0,6,2,0,5,1,1,0.66,0.6061,0.83,0.3284,4,10,14,10
4086,6/24/2011,3,0,6,3,0,5,1,1,0.66,0.6061,0.83,0.1642,1,4,5,4
4087,6/24/2011,3,0,6,4,0,5,1,1,0.66,0.6061,0.83,0.0896,1,8,9,8
4088,6/24/2011,3,0,6,5,0,5,1,1,0.64,0.5758,0.89,0.0896,2,18,20,18
4089,6/24/2011,3,0,6,6,0,5,1,1,0.66,0.6061,0.83,0.1343,4,87,91,87
4090,6/24/2011,3,0,6,7,0,5,1,2,0.66,0.6061,0.83,0.2239,21,247,268,247
4091,6/24/2011,3,0,6,8,0,5,1,1,0.7,0.6667,0.74,0.2239,27,439,466,439
4092,6/24/2011,3,0,6,9,0,5,1,1,0.74,0.6818,0.62,0.1343,28,203,231,203
4093,6/24/2011,3,0,6,10,0,5,1,1,0.8,0.7273,0.43,0.2836,43,102,145,102
4094,6/24/2011,3,0,6,11,0,5,1,1,0.8,0.7121,0.38,0.3284,56,147,203,147
4095,6/24/2011,3,0,6,12,0,5,1,1,0.8,0.7121,0.41,0.2836,51,150,201,150
4096,6/24/2011,3,0,6,13,0,5,1,1,0.8,0.7121,0.36,0.2239,43,178,221,178
4097,6/24/2011,3,0,6,14,0,5,1,1,0.78,0.697,0.43,0.2836,67,162,229,162
4098,6/24/2011,3,0,6,15,0,5,1,1,0.82,0.7273,0.34,0.3881,69,147,216,147
4099,6/24/2011,3,0,6,16,0,5,1,1,0.8,0.697,0.33,0.4179,80,247,327,247
4100,6/24/2011,3,0,6,17,0,5,1,1,0.76,0.6667,0.37,0.2537,85,472,557,472
4101,6/24/2011,3,0,6,18,0,5,1,1,0.76,0.6667,0.37,0.2985,87,365,452,365
4102,6/24/2011,3,0,6,19,0,5,1,1,0.74,0.6515,0.4,0.2239,92,293,385,293
4103,6/24/2011,3,0,6,20,0,5,1,1,0.72,0.6515,0.45,0.1642,66,222,288,222
4104,6/24/2011,3,0,6,21,0,5,1,1,0.7,0.6515,0.48,0.1343,50,183,233,183
4105,6/24/2011,3,0,6,22,0,5,1,1,0.7,0.6515,0.48,0,41,126,167,126
4106,6/24/2011,3,0,6,23,0,5,1,1,0.68,0.6364,0.51,0.1343,33,139,172,139
4107,6/25/2011,3,0,6,0,0,6,0,1,0.68,0.6364,0.47,0.1642,19,97,116,97
4108,6/25/2011,3,0,6,1,0,6,0,1,0.66,0.6212,0.5,0.1642,20,75,95,75
4109,6/25/2011,3,0,6,2,0,6,0,2,0.66,0.6212,0.5,0.194,8,51,59,51
4110,6/25/2011,3,0,6,3,0,6,0,1,0.64,0.6212,0.57,0.194,18,21,39,21
4111,6/25/2011,3,0,6,4,0,6,0,1,0.64,0.6212,0.57,0.194,7,4,11,4
4112,6/25/2011,3,0,6,5,0,6,0,1,0.62,0.6061,0.61,0.1343,6,8,14,8
4113,6/25/2011,3,0,6,6,0,6,0,1,0.64,0.6212,0.57,0.2239,12,17,29,17
4114,6/25/2011,3,0,6,7,0,6,0,1,0.64,0.6212,0.57,0.2836,7,35,42,35
4115,6/25/2011,3,0,6,8,0,6,0,1,0.7,0.6515,0.48,0.2537,27,85,112,85
4116,6/25/2011,3,0,6,9,0,6,0,1,0.72,0.6515,0.45,0.2537,47,139,186,139
4117,6/25/2011,3,0,6,10,0,6,0,1,0.72,0.6515,0.45,0.194,99,203,302,203
4118,6/25/2011,3,0,6,11,0,6,0,1,0.74,0.6667,0.42,0,122,209,331,209
4119,6/25/2011,3,0,6,12,0,6,0,1,0.74,0.6515,0.4,0.2836,140,252,392,252
4120,6/25/2011,3,0,6,13,0,6,0,1,0.74,0.6515,0.4,0.2836,140,231,371,231
4121,6/25/2011,3,0,6,14,0,6,0,1,0.74,0.6667,0.45,0.2985,151,232,383,232
4122,6/25/2011,3,0,6,15,0,6,0,1,0.74,0.6667,0.45,0,157,235,392,235
4123,6/25/2011,3,0,6,16,0,6,0,1,0.76,0.6818,0.43,0.2985,175,235,410,235
4124,6/25/2011,3,0,6,17,0,6,0,1,0.74,0.6667,0.42,0.2239,152,247,399,247
4125,6/25/2011,3,0,6,18,0,6,0,1,0.72,0.6515,0.45,0.2537,108,199,307,199
4126,6/25/2011,3,0,6,19,0,6,0,1,0.72,0.6667,0.48,0.2836,121,254,375,254
4127,6/25/2011,3,0,6,20,0,6,0,1,0.7,0.6515,0.48,0.194,74,195,269,195
4128,6/25/2011,3,0,6,21,0,6,0,1,0.68,0.6364,0.51,0.1642,62,140,202,140
4129,6/25/2011,3,0,6,22,0,6,0,1,0.68,0.6364,0.47,0.194,61,126,187,126
4130,6/25/2011,3,0,6,23,0,6,0,2,0.66,0.6212,0.5,0.2985,49,130,179,130
4131,6/26/2011,3,0,6,0,0,0,0,1,0.64,0.6212,0.53,0,30,85,115,85
4132,6/26/2011,3,0,6,1,0,0,0,1,0.64,0.6212,0.53,0.1045,17,73,90,73
4133,6/26/2011,3,0,6,2,0,0,0,1,0.62,0.6212,0.57,0.1045,17,70,87,70
4134,6/26/2011,3,0,6,3,0,0,0,1,0.6,0.6061,0.64,0.1045,12,22,34,22
4135,6/26/2011,3,0,6,4,0,0,0,1,0.6,0.6061,0.64,0.0896,3,8,11,8
4136,6/26/2011,3,0,6,5,0,0,0,1,0.6,0.6061,0.64,0,3,9,12,9
4137,6/26/2011,3,0,6,6,0,0,0,1,0.6,0.6061,0.64,0,7,13,20,13
4138,6/26/2011,3,0,6,7,0,0,0,1,0.62,0.6061,0.61,0,24,27,51,27
4139,6/26/2011,3,0,6,8,0,0,0,1,0.64,0.6212,0.61,0.194,29,78,107,78
4140,6/26/2011,3,0,6,9,0,0,0,1,0.66,0.6212,0.54,0.0896,75,131,206,131
4141,6/26/2011,3,0,6,10,0,0,0,1,0.72,0.6667,0.48,0.1045,136,196,332,196
4142,6/26/2011,3,0,6,11,0,0,0,1,0.72,0.6515,0.45,0.1343,127,219,346,219
4143,6/26/2011,3,0,6,12,0,0,0,1,0.74,0.6515,0.4,0.1642,175,268,443,268
4144,6/26/2011,3,0,6,13,0,0,0,1,0.74,0.6515,0.4,0,197,245,442,245
4145,6/26/2011,3,0,6,14,0,0,0,1,0.74,0.6515,0.4,0.1343,197,246,443,246
4146,6/26/2011,3,0,6,15,0,0,0,1,0.74,0.6515,0.4,0,174,229,403,229
4147,6/26/2011,3,0,6,16,0,0,0,1,0.74,0.6667,0.42,0.194,177,278,455,278
4148,6/26/2011,3,0,6,17,0,0,0,2,0.72,0.6515,0.42,0.1642,178,243,421,243
4149,6/26/2011,3,0,6,18,0,0,0,2,0.72,0.6515,0.45,0.2537,117,265,382,265
4150,6/26/2011,3,0,6,19,0,0,0,2,0.72,0.6667,0.48,0.1343,89,228,317,228
4151,6/26/2011,3,0,6,20,0,0,0,2,0.7,0.6515,0.48,0.1045,55,158,213,158
4152,6/26/2011,3,0,6,21,0,0,0,2,0.7,0.6515,0.54,0.1045,48,135,183,135
4153,6/26/2011,3,0,6,22,0,0,0,1,0.7,0.6515,0.51,0,19,95,114,95
4154,6/26/2011,3,0,6,23,0,0,0,1,0.7,0.6515,0.54,0.0896,14,64,78,64
4155,6/27/2011,3,0,6,0,0,1,1,3,0.64,0.6061,0.73,0.2836,7,25,32,25
4156,6/27/2011,3,0,6,1,0,1,1,2,0.62,0.5909,0.78,0.1343,4,11,15,11
4157,6/27/2011,3,0,6,2,0,1,1,3,0.62,0.5909,0.78,0.1343,3,3,6,3
4158,6/27/2011,3,0,6,3,0,1,1,3,0.62,0.5909,0.78,0.1343,0,2,2,2
4159,6/27/2011,3,0,6,4,0,1,1,2,0.6,0.5606,0.83,0.1642,1,8,9,8
4160,6/27/2011,3,0,6,5,0,1,1,2,0.62,0.5758,0.83,0.1642,1,21,22,21
4161,6/27/2011,3,0,6,6,0,1,1,2,0.62,0.5909,0.78,0.1642,4,90,94,90
4162,6/27/2011,3,0,6,7,0,1,1,2,0.64,0.6061,0.73,0.2239,14,247,261,247
4163,6/27/2011,3,0,6,8,0,1,1,1,0.66,0.6212,0.74,0.194,29,418,447,418
4164,6/27/2011,3,0,6,9,0,1,1,2,0.72,0.6667,0.54,0,37,150,187,150
4165,6/27/2011,3,0,6,10,0,1,1,2,0.72,0.6667,0.54,0.1343,55,95,150,95
4166,6/27/2011,3,0,6,11,0,1,1,2,0.7,0.6515,0.58,0,55,95,150,95
4167,6/27/2011,3,0,6,12,0,1,1,2,0.72,0.6667,0.54,0,40,130,170,130
4168,6/27/2011,3,0,6,13,0,1,1,2,0.72,0.6667,0.58,0.2239,37,127,164,127
4169,6/27/2011,3,0,6,14,0,1,1,2,0.72,0.6667,0.58,0.0896,58,100,158,100
4170,6/27/2011,3,0,6,15,0,1,1,2,0.74,0.6818,0.55,0,76,126,202,126
4171,6/27/2011,3,0,6,16,0,1,1,1,0.74,0.6818,0.55,0.1045,53,222,275,222
4172,6/27/2011,3,0,6,17,0,1,1,1,0.74,0.6818,0.55,0.1343,90,514,604,514
4173,6/27/2011,3,0,6,18,0,1,1,1,0.74,0.6667,0.51,0,79,512,591,512
4174,6/27/2011,3,0,6,19,0,1,1,1,0.72,0.6818,0.62,0.194,56,340,396,340
4175,6/27/2011,3,0,6,20,0,1,1,1,0.7,0.6515,0.65,0.1045,54,251,305,251
4176,6/27/2011,3,0,6,21,0,1,1,1,0.7,0.6515,0.65,0,52,190,242,190
4177,6/27/2011,3,0,6,22,0,1,1,1,0.68,0.6364,0.69,0,33,112,145,112
4178,6/27/2011,3,0,6,23,0,1,1,1,0.68,0.6364,0.69,0,16,65,81,65
4179,6/28/2011,3,0,6,0,0,2,1,2,0.66,0.6061,0.78,0.1343,5,25,30,25
4180,6/28/2011,3,0,6,1,0,2,1,1,0.66,0.6212,0.74,0,5,8,13,8
4181,6/28/2011,3,0,6,2,0,2,1,2,0.66,0.6212,0.74,0,2,9,11,9
4182,6/28/2011,3,0,6,3,0,2,1,2,0.66,0.6212,0.74,0,0,2,2,2
4183,6/28/2011,3,0,6,4,0,2,1,1,0.66,0.6212,0.74,0,1,7,8,7
4184,6/28/2011,3,0,6,5,0,2,1,1,0.66,0.6061,0.78,0,1,20,21,20
4185,6/28/2011,3,0,6,6,0,2,1,1,0.66,0.6061,0.83,0.1642,7,117,124,117
4186,6/28/2011,3,0,6,7,0,2,1,1,0.68,0.6364,0.83,0.194,27,320,347,320
4187,6/28/2011,3,0,6,8,0,2,1,1,0.7,0.6667,0.79,0.1642,39,417,456,417
4188,6/28/2011,3,0,6,9,0,2,1,1,0.74,0.697,0.7,0,38,208,246,208
4189,6/28/2011,3,0,6,10,0,2,1,1,0.8,0.7424,0.49,0.1642,45,112,157,112
4190,6/28/2011,3,0,6,11,0,2,1,1,0.82,0.7576,0.46,0,49,118,167,118
4191,6/28/2011,3,0,6,12,0,2,1,1,0.84,0.7727,0.47,0.2239,41,161,202,161
4192,6/28/2011,3,0,6,13,0,2,1,1,0.84,0.7576,0.44,0,33,156,189,156
4193,6/28/2011,3,0,6,14,0,2,1,1,0.86,0.7879,0.44,0.2239,43,117,160,117
4194,6/28/2011,3,0,6,15,0,2,1,1,0.86,0.7879,0.41,0,39,127,166,127
4195,6/28/2011,3,0,6,16,0,2,1,1,0.86,0.803,0.47,0.2836,41,220,261,220
4196,6/28/2011,3,0,6,17,0,2,1,3,0.82,0.7879,0.56,0.2836,70,509,579,509
4197,6/28/2011,3,0,6,18,0,2,1,3,0.8,0.7576,0.55,0.2985,68,436,504,436
4198,6/28/2011,3,0,6,19,0,2,1,2,0.74,0.6818,0.58,0.4627,44,255,299,255
4199,6/28/2011,3,0,6,20,0,2,1,1,0.74,0.6818,0.62,0,50,246,296,246
4200,6/28/2011,3,0,6,21,0,2,1,1,0.74,0.697,0.66,0.2836,31,164,195,164
4201,6/28/2011,3,0,6,22,0,2,1,1,0.7,0.6515,0.7,0.2985,30,104,134,104
4202,6/28/2011,3,0,6,23,0,2,1,1,0.7,0.6515,0.7,0.2836,23,58,81,58
4203,6/29/2011,3,0,6,0,0,3,1,2,0.68,0.6364,0.79,0.2836,11,25,36,25
4204,6/29/2011,3,0,6,1,0,3,1,1,0.68,0.6364,0.79,0.2985,10,18,28,18
4205,6/29/2011,3,0,6,2,0,3,1,1,0.66,0.6061,0.83,0.2239,7,9,16,9
4206,6/29/2011,3,0,6,3,0,3,1,2,0.66,0.6061,0.83,0.1045,2,3,5,3
4207,6/29/2011,3,0,6,4,0,3,1,1,0.66,0.6061,0.83,0.1045,0,5,5,5
4208,6/29/2011,3,0,6,5,0,3,1,1,0.64,0.5758,0.83,0.194,3,19,22,19
4209,6/29/2011,3,0,6,6,0,3,1,1,0.66,0.6212,0.69,0.2985,12,104,116,104
4210,6/29/2011,3,0,6,7,0,3,1,1,0.7,0.6515,0.54,0.2239,18,318,336,318
4211,6/29/2011,3,0,6,8,0,3,1,1,0.7,0.6515,0.48,0.2836,41,499,540,499
4212,6/29/2011,3,0,6,9,0,3,1,1,0.72,0.6515,0.45,0.3881,32,189,221,189
4213,6/29/2011,3,0,6,10,0,3,1,1,0.74,0.6667,0.42,0.2836,31,95,126,95
4214,6/29/2011,3,0,6,11,0,3,1,1,0.76,0.6667,0.35,0.2239,53,117,170,117
4215,6/29/2011,3,0,6,12,0,3,1,1,0.76,0.6667,0.35,0.2537,55,188,243,188
4216,6/29/2011,3,0,6,13,0,3,1,1,0.8,0.697,0.31,0.3284,45,186,231,186
4217,6/29/2011,3,0,6,14,0,3,1,1,0.8,0.697,0.31,0.194,50,138,188,138
4218,6/29/2011,3,0,6,15,0,3,1,1,0.82,0.7121,0.3,0.1642,43,146,189,146
4219,6/29/2011,3,0,6,16,0,3,1,1,0.82,0.7121,0.3,0.4179,60,268,328,268
4220,6/29/2011,3,0,6,17,0,3,1,1,0.82,0.7121,0.26,0.4179,78,492,570,492
4221,6/29/2011,3,0,6,18,0,3,1,1,0.8,0.697,0.29,0.2985,78,510,588,510
4222,6/29/2011,3,0,6,19,0,3,1,1,0.76,0.6667,0.35,0.3881,60,341,401,341
4223,6/29/2011,3,0,6,20,0,3,1,1,0.74,0.6515,0.37,0.2985,69,264,333,264
4224,6/29/2011,3,0,6,21,0,3,1,1,0.72,0.6515,0.39,0.2239,26,195,221,195
4225,6/29/2011,3,0,6,22,0,3,1,1,0.7,0.6364,0.42,0.194,32,151,183,151
4226,6/29/2011,3,0,6,23,0,3,1,1,0.68,0.6364,0.47,0.194,32,97,129,97
4227,6/30/2011,3,0,6,0,0,4,1,1,0.66,0.6212,0.5,0.1642,15,39,54,39
4228,6/30/2011,3,0,6,1,0,4,1,1,0.64,0.6212,0.53,0.1343,13,19,32,19
4229,6/30/2011,3,0,6,2,0,4,1,1,0.62,0.6212,0.57,0.1343,2,6,8,6
4230,6/30/2011,3,0,6,3,0,4,1,1,0.6,0.6061,0.6,0.1642,2,7,9,7
4231,6/30/2011,3,0,6,4,0,4,1,1,0.58,0.5455,0.64,0.1343,2,4,6,4
4232,6/30/2011,3,0,6,5,0,4,1,1,0.58,0.5455,0.64,0.2537,1,24,25,24
4233,6/30/2011,3,0,6,6,0,4,1,1,0.6,0.6061,0.64,0.2537,4,119,123,119
4234,6/30/2011,3,0,6,7,0,4,1,1,0.62,0.6061,0.61,0.2239,29,291,320,291
4235,6/30/2011,3,0,6,8,0,4,1,1,0.68,0.6364,0.47,0.2239,44,511,555,511
4236,6/30/2011,3,0,6,9,0,4,1,1,0.7,0.6364,0.42,0.2239,33,227,260,227
4237,6/30/2011,3,0,6,10,0,4,1,1,0.72,0.6515,0.42,0.194,35,97,132,97
4238,6/30/2011,3,0,6,11,0,4,1,1,0.74,0.6515,0.37,0.1343,47,122,169,122
4239,6/30/2011,3,0,6,12,0,4,1,1,0.76,0.6667,0.35,0.1642,50,183,233,183
4240,6/30/2011,3,0,6,13,0,4,1,1,0.76,0.6667,0.33,0.194,70,162,232,162
4241,6/30/2011,3,0,6,14,0,4,1,1,0.78,0.6818,0.31,0.194,46,117,163,117
4242,6/30/2011,3,0,6,15,0,4,1,1,0.78,0.6667,0.25,0.2537,64,176,240,176
4243,6/30/2011,3,0,6,16,0,4,1,1,0.8,0.697,0.26,0.1343,63,260,323,260
4244,6/30/2011,3,0,6,17,0,4,1,1,0.78,0.6818,0.27,0.3582,98,496,594,496
4245,6/30/2011,3,0,6,18,0,4,1,1,0.76,0.6667,0.29,0.2537,114,472,586,472
4246,6/30/2011,3,0,6,19,0,4,1,1,0.74,0.6515,0.33,0.194,89,366,455,366
4247,6/30/2011,3,0,6,20,0,4,1,1,0.74,0.6515,0.33,0.194,55,285,340,285
4248,6/30/2011,3,0,6,21,0,4,1,1,0.72,0.6515,0.37,0.1045,81,242,323,242
4249,6/30/2011,3,0,6,22,0,4,1,1,0.7,0.6364,0.42,0.1642,43,164,207,164
4250,6/30/2011,3,0,6,23,0,4,1,1,0.66,0.6212,0.5,0,27,99,126,99
4251,7/1/2011,3,0,7,0,0,5,1,1,0.66,0.6212,0.5,0,20,48,68,48
4252,7/1/2011,3,0,7,1,0,5,1,1,0.66,0.6212,0.5,0,15,16,31,16
4253,7/1/2011,3,0,7,2,0,5,1,1,0.62,0.6061,0.69,0,6,7,13,7
4254,7/1/2011,3,0,7,3,0,5,1,1,0.64,0.6212,0.53,0,5,6,11,6
4255,7/1/2011,3,0,7,4,0,5,1,1,0.62,0.6212,0.57,0,1,5,6,5
4256,7/1/2011,3,0,7,5,0,5,1,1,0.6,0.6061,0.64,0.1343,3,27,30,27
4257,7/1/2011,3,0,7,6,0,5,1,1,0.62,0.6061,0.61,0.1343,11,97,108,97
4258,7/1/2011,3,0,7,7,0,5,1,1,0.66,0.6212,0.54,0.1045,25,218,243,218
4259,7/1/2011,3,0,7,8,0,5,1,1,0.7,0.6364,0.42,0.1642,39,453,492,453
4260,7/1/2011,3,0,7,9,0,5,1,1,0.74,0.6515,0.35,0.1642,58,202,260,202
4261,7/1/2011,3,0,7,10,0,5,1,1,0.76,0.6667,0.33,0.1642,61,109,170,109
4262,7/1/2011,3,0,7,11,0,5,1,1,0.8,0.697,0.26,0,68,146,214,146
4263,7/1/2011,3,0,7,12,0,5,1,1,0.8,0.697,0.26,0,83,180,263,180
4264,7/1/2011,3,0,7,13,0,5,1,1,0.8,0.6818,0.24,0,83,209,292,209
4265,7/1/2011,3,0,7,14,0,5,1,1,0.82,0.697,0.23,0.194,78,225,303,225
4266,7/1/2011,3,0,7,15,0,5,1,1,0.82,0.697,0.21,0.2537,82,299,381,299
4267,7/1/2011,3,0,7,16,0,5,1,1,0.82,0.697,0.17,0,85,342,427,342
4268,7/1/2011,3,0,7,17,0,5,1,1,0.82,0.697,0.21,0.194,99,362,461,362
4269,7/1/2011,3,0,7,18,0,5,1,1,0.8,0.6818,0.24,0.2537,98,324,422,324
4270,7/1/2011,3,0,7,19,0,5,1,1,0.78,0.6667,0.25,0.194,80,238,318,238
4271,7/1/2011,3,0,7,20,0,5,1,1,0.72,0.6515,0.42,0.2239,84,185,269,185
4272,7/1/2011,3,0,7,21,0,5,1,1,0.7,0.6364,0.45,0.194,69,149,218,149
4273,7/1/2011,3,0,7,22,0,5,1,1,0.7,0.6364,0.42,0,49,173,222,173
4274,7/1/2011,3,0,7,23,0,5,1,1,0.68,0.6364,0.47,0.0896,44,96,140,96
4275,7/2/2011,3,0,7,0,0,6,0,1,0.68,0.6364,0.47,0.0896,31,84,115,84
4276,7/2/2011,3,0,7,1,0,6,0,1,0.66,0.6212,0.54,0,20,58,78,58
4277,7/2/2011,3,0,7,2,0,6,0,1,0.64,0.6212,0.53,0,9,43,52,43
4278,7/2/2011,3,0,7,3,0,6,0,1,0.64,0.6212,0.53,0,5,21,26,21
4279,7/2/2011,3,0,7,4,0,6,0,1,0.62,0.6061,0.61,0,3,8,11,8
4280,7/2/2011,3,0,7,5,0,6,0,1,0.58,0.5455,0.73,0.1045,1,13,14,13
4281,7/2/2011,3,0,7,6,0,6,0,1,0.62,0.6061,0.69,0.1045,11,21,32,21
4282,7/2/2011,3,0,7,7,0,6,0,1,0.64,0.6061,0.65,0,10,35,45,35
4283,7/2/2011,3,0,7,8,0,6,0,1,0.68,0.6364,0.57,0,38,94,132,94
4284,7/2/2011,3,0,7,9,0,6,0,1,0.74,0.6667,0.51,0.0896,55,124,179,124
4285,7/2/2011,3,0,7,10,0,6,0,1,0.8,0.7121,0.36,0,103,168,271,168
4286,7/2/2011,3,0,7,11,0,6,0,1,0.8,0.7121,0.36,0.0896,144,213,357,213
4287,7/2/2011,3,0,7,12,0,6,0,1,0.82,0.7121,0.3,0.1343,142,232,374,232
4288,7/2/2011,3,0,7,13,0,6,0,1,0.82,0.7121,0.3,0.1045,178,226,404,226
4289,7/2/2011,3,0,7,14,0,6,0,1,0.84,0.7121,0.2,0,177,215,392,215
4290,7/2/2011,3,0,7,15,0,6,0,1,0.86,0.7273,0.19,0.1642,168,163,331,163
4291,7/2/2011,3,0,7,16,0,6,0,1,0.88,0.7424,0.22,0.2239,206,192,398,192
4292,7/2/2011,3,0,7,17,0,6,0,1,0.84,0.7273,0.3,0.2239,179,170,349,170
4293,7/2/2011,3,0,7,18,0,6,0,1,0.82,0.7121,0.3,0.2836,193,190,383,190
4294,7/2/2011,3,0,7,19,0,6,0,1,0.8,0.697,0.33,0.2239,156,149,305,149
4295,7/2/2011,3,0,7,20,0,6,0,1,0.76,0.6818,0.45,0.2836,136,148,284,148
4296,7/2/2011,3,0,7,21,0,6,0,1,0.74,0.6667,0.48,0.194,95,137,232,137
4297,7/2/2011,3,0,7,22,0,6,0,1,0.72,0.6667,0.51,0.1642,78,123,201,123
4298,7/2/2011,3,0,7,23,0,6,0,1,0.72,0.6667,0.54,0.2836,66,88,154,88
4299,7/3/2011,3,0,7,0,0,0,0,1,0.7,0.6515,0.58,0.2239,47,97,144,97
4300,7/3/2011,3,0,7,1,0,0,0,2,0.7,0.6515,0.61,0.1642,23,55,78,55
4301,7/3/2011,3,0,7,2,0,0,0,1,0.7,0.6515,0.58,0.194,19,50,69,50
4302,7/3/2011,3,0,7,3,0,0,0,3,0.68,0.6364,0.65,0.0896,8,25,33,25
4303,7/3/2011,3,0,7,4,0,0,0,3,0.68,0.6364,0.65,0.0896,3,2,5,2
4304,7/3/2011,3,0,7,5,0,0,0,3,0.62,0.5758,0.83,0.194,0,1,1,1
4305,7/3/2011,3,0,7,6,0,0,0,2,0.62,0.5455,0.94,0.0896,0,3,3,3
4306,7/3/2011,3,0,7,7,0,0,0,2,0.64,0.5758,0.89,0.194,3,22,25,22
4307,7/3/2011,3,0,7,8,0,0,0,1,0.68,0.6364,0.79,0.2239,39,53,92,53
4308,7/3/2011,3,0,7,9,0,0,0,1,0.7,0.6667,0.74,0.2537,82,99,181,99
4309,7/3/2011,3,0,7,10,0,0,0,1,0.74,0.697,0.66,0.1642,131,133,264,133
4310,7/3/2011,3,0,7,11,0,0,0,1,0.76,0.7121,0.62,0.1045,215,175,390,175
4311,7/3/2011,3,0,7,12,0,0,0,1,0.8,0.7576,0.55,0.1045,198,206,404,206
4312,7/3/2011,3,0,7,13,0,0,0,1,0.8,0.7727,0.59,0.2239,248,173,421,173
4313,7/3/2011,3,0,7,14,0,0,0,1,0.82,0.7879,0.56,0.2537,225,150,375,150
4314,7/3/2011,3,0,7,15,0,0,0,1,0.84,0.803,0.53,0.2985,194,182,376,182
4315,7/3/2011,3,0,7,16,0,0,0,1,0.84,0.803,0.53,0.2985,195,219,414,219
4316,7/3/2011,3,0,7,17,0,0,0,3,0.8,0.7424,0.49,0.8507,181,177,358,177
4317,7/3/2011,3,0,7,18,0,0,0,3,0.8,0.7424,0.49,0.8507,74,107,181,107
4318,7/3/2011,3,0,7,19,0,0,0,2,0.66,0.6061,0.83,0.194,100,83,183,83
4319,7/3/2011,3,0,7,20,0,0,0,3,0.66,0.6061,0.83,0,83,93,176,93
4320,7/3/2011,3,0,7,21,0,0,0,2,0.66,0.6061,0.83,0.1642,75,92,167,92
4321,7/3/2011,3,0,7,22,0,0,0,2,0.66,0.6061,0.78,0.1045,69,93,162,93
4322,7/3/2011,3,0,7,23,0,0,0,1,0.64,0.5758,0.83,0.1642,70,77,147,77
4323,7/4/2011,3,0,7,0,1,1,0,1,0.64,0.5758,0.83,0.1343,63,77,140,77
4324,7/4/2011,3,0,7,1,1,1,0,1,0.64,0.5758,0.83,0.0896,43,76,119,76
4325,7/4/2011,3,0,7,2,1,1,0,1,0.64,0.5758,0.83,0,33,30,63,30
4326,7/4/2011,3,0,7,3,1,1,0,1,0.64,0.5909,0.78,0,13,13,26,13
4327,7/4/2011,3,0,7,4,1,1,0,2,0.66,0.6061,0.78,0.0896,8,4,12,4
4328,7/4/2011,3,0,7,5,1,1,0,2,0.64,0.5758,0.83,0.1343,1,3,4,3
4329,7/4/2011,3,0,7,6,1,1,0,1,0.64,0.5758,0.89,0.1642,5,11,16,11
4330,7/4/2011,3,0,7,7,1,1,0,1,0.66,0.6061,0.83,0.1343,17,19,36,19
4331,7/4/2011,3,0,7,8,1,1,0,1,0.7,0.6667,0.74,0.1045,42,44,86,44
4332,7/4/2011,3,0,7,9,1,1,0,2,0.72,0.6818,0.66,0.0896,142,96,238,96
4333,7/4/2011,3,0,7,10,1,1,0,2,0.76,0.697,0.55,0.0896,166,114,280,114
4334,7/4/2011,3,0,7,11,1,1,0,2,0.76,0.697,0.55,0.0896,177,172,349,172
4335,7/4/2011,3,0,7,12,1,1,0,2,0.78,0.7121,0.52,0,237,210,447,210
4336,7/4/2011,3,0,7,13,1,1,0,2,0.78,0.7121,0.49,0,242,181,423,181
4337,7/4/2011,3,0,7,14,1,1,0,1,0.8,0.7273,0.46,0,235,173,408,173
4338,7/4/2011,3,0,7,15,1,1,0,1,0.82,0.7424,0.43,0.0896,224,184,408,184
4339,7/4/2011,3,0,7,16,1,1,0,1,0.82,0.7424,0.41,0,236,216,452,216
4340,7/4/2011,3,0,7,17,1,1,0,1,0.8,0.7273,0.46,0,240,196,436,196
4341,7/4/2011,3,0,7,18,1,1,0,1,0.8,0.7273,0.46,0.1343,222,196,418,196
4342,7/4/2011,3,0,7,19,1,1,0,2,0.78,0.7121,0.49,0.1642,170,205,375,205
4343,7/4/2011,3,0,7,20,1,1,0,2,0.76,0.697,0.55,0.1045,195,191,386,191
4344,7/4/2011,3,0,7,21,1,1,0,2,0.74,0.6818,0.62,0.1045,195,262,457,262
4345,7/4/2011,3,0,7,22,1,1,0,2,0.74,0.6818,0.62,0.1343,115,211,326,211
4346,7/4/2011,3,0,7,23,1,1,0,2,0.72,0.6818,0.7,0.1045,44,94,138,94
4347,7/5/2011,3,0,7,0,0,2,1,2,0.7,0.6515,0.65,0.1642,19,36,55,36
4348,7/5/2011,3,0,7,1,0,2,1,1,0.7,0.6515,0.65,0.1045,15,24,39,24
4349,7/5/2011,3,0,7,2,0,2,1,1,0.66,0.6212,0.74,0.0896,8,5,13,5
4350,7/5/2011,3,0,7,3,0,2,1,1,0.66,0.6212,0.74,0.2239,1,7,8,7
4351,7/5/2011,3,0,7,4,0,2,1,1,0.66,0.6212,0.69,0.1642,1,4,5,4
4352,7/5/2011,3,0,7,5,0,2,1,1,0.66,0.6212,0.69,0,1,19,20,19
4353,7/5/2011,3,0,7,6,0,2,1,1,0.66,0.6212,0.74,0.0896,3,91,94,91
4354,7/5/2011,3,0,7,7,0,2,1,1,0.7,0.6515,0.65,0.0896,22,248,270,248
4355,7/5/2011,3,0,7,8,0,2,1,1,0.72,0.6818,0.62,0.1343,41,391,432,391
4356,7/5/2011,3,0,7,9,0,2,1,1,0.74,0.6818,0.58,0.1343,50,177,227,177
4357,7/5/2011,3,0,7,10,0,2,1,1,0.76,0.697,0.52,0.1045,55,84,139,84
4358,7/5/2011,3,0,7,11,0,2,1,1,0.78,0.697,0.46,0.1045,75,97,172,97
4359,7/5/2011,3,0,7,12,0,2,1,1,0.8,0.7273,0.43,0.1045,71,130,201,130
4360,7/5/2011,3,0,7,13,0,2,1,1,0.82,0.7424,0.43,0.1045,67,136,203,136
4361,7/5/2011,3,0,7,14,0,2,1,1,0.8,0.7424,0.49,0.1642,66,112,178,112
4362,7/5/2011,3,0,7,15,0,2,1,1,0.82,0.7424,0.43,0,51,111,162,111
4363,7/5/2011,3,0,7,16,0,2,1,1,0.82,0.7576,0.46,0.1045,79,202,281,202
4364,7/5/2011,3,0,7,17,0,2,1,1,0.82,0.7576,0.46,0.1045,79,466,545,466
4365,7/5/2011,3,0,7,18,0,2,1,1,0.8,0.7576,0.55,0.1642,70,426,496,426
4366,7/5/2011,3,0,7,19,0,2,1,1,0.8,0.7727,0.59,0.1343,71,297,368,297
4367,7/5/2011,3,0,7,20,0,2,1,1,0.76,0.7273,0.66,0.1045,59,225,284,225
4368,7/5/2011,3,0,7,21,0,2,1,1,0.78,0.7424,0.62,0.2537,77,168,245,168
4369,7/5/2011,3,0,7,22,0,2,1,1,0.76,0.7273,0.66,0.2239,31,124,155,124
4370,7/5/2011,3,0,7,23,0,2,1,1,0.74,0.697,0.66,0.1642,19,54,73,54
4371,7/6/2011,3,0,7,0,0,3,1,1,0.72,0.697,0.74,0.194,11,26,37,26
4372,7/6/2011,3,0,7,1,0,3,1,1,0.7,0.6667,0.74,0.1343,4,11,15,11
4373,7/6/2011,3,0,7,2,0,3,1,1,0.7,0.6667,0.79,0.0896,1,4,5,4
4374,7/6/2011,3,0,7,3,0,3,1,1,0.7,0.6667,0.79,0,0,6,6,6
4375,7/6/2011,3,0,7,4,0,3,1,2,0.68,0.6364,0.83,0.0896,0,6,6,6
4376,7/6/2011,3,0,7,5,0,3,1,1,0.68,0.6364,0.83,0.0896,5,30,35,30
4377,7/6/2011,3,0,7,6,0,3,1,1,0.7,0.6667,0.79,0.0896,9,112,121,112
4378,7/6/2011,3,0,7,7,0,3,1,2,0.72,0.697,0.79,0,24,288,312,288
4379,7/6/2011,3,0,7,8,0,3,1,2,0.72,0.697,0.74,0.1045,31,397,428,397
4380,7/6/2011,3,0,7,9,0,3,1,3,0.7,0.6667,0.79,0.194,31,158,189,158
4381,7/6/2011,3,0,7,10,0,3,1,3,0.7,0.6667,0.79,0.0896,13,30,43,30
4382,7/6/2011,3,0,7,11,0,3,1,2,0.72,0.697,0.74,0,24,103,127,103
4383,7/6/2011,3,0,7,12,0,3,1,2,0.74,0.697,0.66,0.0896,38,114,152,114
4384,7/6/2011,3,0,7,13,0,3,1,2,0.74,0.697,0.7,0.1045,33,107,140,107
4385,7/6/2011,3,0,7,14,0,3,1,1,0.76,0.7273,0.66,0.2836,50,113,163,113
4386,7/6/2011,3,0,7,15,0,3,1,1,0.76,0.7273,0.7,0.2836,55,130,185,130
4387,7/6/2011,3,0,7,16,0,3,1,1,0.76,0.7273,0.7,0.2537,57,218,275,218
4388,7/6/2011,3,0,7,17,0,3,1,1,0.78,0.7424,0.59,0.2239,79,517,596,517
4389,7/6/2011,3,0,7,18,0,3,1,1,0.76,0.7121,0.62,0.194,77,486,563,486
4390,7/6/2011,3,0,7,19,0,3,1,1,0.74,0.697,0.7,0.2239,71,323,394,323
4391,7/6/2011,3,0,7,20,0,3,1,1,0.72,0.697,0.74,0.2537,55,257,312,257
4392,7/6/2011,3,0,7,21,0,3,1,1,0.7,0.6667,0.79,0.194,66,175,241,175
4393,7/6/2011,3,0,7,22,0,3,1,1,0.7,0.6667,0.79,0.194,30,156,186,156
4394,7/6/2011,3,0,7,23,0,3,1,1,0.68,0.6364,0.83,0.2239,20,78,98,78
4395,7/7/2011,3,0,7,0,0,4,1,1,0.66,0.5909,0.89,0.1343,6,29,35,29
4396,7/7/2011,3,0,7,1,0,4,1,1,0.66,0.5909,0.89,0.194,2,14,16,14
4397,7/7/2011,3,0,7,2,0,4,1,1,0.66,0.5909,0.89,0.194,1,7,8,7
4398,7/7/2011,3,0,7,3,0,4,1,1,0.64,0.5606,0.94,0.1045,2,2,4,2
4399,7/7/2011,3,0,7,4,0,4,1,1,0.64,0.5758,0.89,0.1045,0,4,4,4
4400,7/7/2011,3,0,7,5,0,4,1,1,0.64,0.5758,0.89,0.1045,2,30,32,30
4401,7/7/2011,3,0,7,6,0,4,1,2,0.64,0.5758,0.89,0.1343,11,107,118,107
4402,7/7/2011,3,0,7,7,0,4,1,2,0.66,0.5909,0.89,0.1045,13,279,292,279
4403,7/7/2011,3,0,7,8,0,4,1,2,0.7,0.6667,0.79,0.194,28,415,443,415
4404,7/7/2011,3,0,7,9,0,4,1,1,0.74,0.697,0.7,0.1642,25,154,179,154
4405,7/7/2011,3,0,7,10,0,4,1,1,0.78,0.7424,0.62,0,29,72,101,72
4406,7/7/2011,3,0,7,11,0,4,1,1,0.82,0.7727,0.52,0.1343,30,112,142,112
4407,7/7/2011,3,0,7,12,0,4,1,1,0.84,0.7727,0.41,0,32,139,171,139
4408,7/7/2011,3,0,7,13,0,4,1,1,0.86,0.7879,0.41,0,48,107,155,107
4409,7/7/2011,3,0,7,14,0,4,1,1,0.86,0.7879,0.41,0.2537,39,121,160,121
4410,7/7/2011,3,0,7,15,0,4,1,1,0.86,0.7879,0.41,0.2537,47,119,166,119
4411,7/7/2011,3,0,7,16,0,4,1,1,0.86,0.7727,0.39,0.2239,47,218,265,218
4412,7/7/2011,3,0,7,17,0,4,1,1,0.86,0.7576,0.36,0.2537,80,489,569,489
4413,7/7/2011,3,0,7,18,0,4,1,1,0.84,0.7576,0.44,0.2985,70,492,562,492
4414,7/7/2011,3,0,7,19,0,4,1,1,0.82,0.7727,0.52,0.2836,79,286,365,286
4415,7/7/2011,3,0,7,20,0,4,1,1,0.76,0.7121,0.58,0.3582,61,224,285,224
4416,7/7/2011,3,0,7,21,0,4,1,1,0.74,0.6818,0.62,0.1642,39,170,209,170
4417,7/7/2011,3,0,7,22,0,4,1,1,0.74,0.6818,0.62,0.1642,32,150,182,150
4418,7/7/2011,3,0,7,23,0,4,1,1,0.72,0.6818,0.66,0,31,98,129,98
4419,7/8/2011,3,0,7,0,0,5,1,1,0.74,0.697,0.66,0.1045,6,41,47,41
4420,7/8/2011,3,0,7,1,0,5,1,1,0.72,0.697,0.79,0,9,25,34,25
4421,7/8/2011,3,0,7,2,0,5,1,2,0.7,0.6667,0.74,0.1642,10,12,22,12
4422,7/8/2011,3,0,7,3,0,5,1,1,0.68,0.6364,0.79,0.1045,2,4,6,4
4423,7/8/2011,3,0,7,4,0,5,1,1,0.7,0.6667,0.79,0.2537,7,4,11,4
4424,7/8/2011,3,0,7,5,0,5,1,1,0.68,0.6364,0.79,0.2537,3,24,27,24
4425,7/8/2011,3,0,7,6,0,5,1,1,0.7,0.6667,0.74,0.1045,11,91,102,91
4426,7/8/2011,3,0,7,7,0,5,1,2,0.7,0.6667,0.79,0.194,30,302,332,302
4427,7/8/2011,3,0,7,8,0,5,1,2,0.72,0.697,0.74,0.2537,36,421,457,421
4428,7/8/2011,3,0,7,9,0,5,1,2,0.76,0.7273,0.7,0.2985,30,211,241,211
4429,7/8/2011,3,0,7,10,0,5,1,2,0.74,0.697,0.7,0.3582,30,108,138,108
4430,7/8/2011,3,0,7,11,0,5,1,2,0.74,0.7121,0.74,0.2537,61,104,165,104
4431,7/8/2011,3,0,7,12,0,5,1,2,0.76,0.7273,0.7,0.2836,49,164,213,164
4432,7/8/2011,3,0,7,13,0,5,1,2,0.78,0.7576,0.66,0.2836,54,175,229,175
4433,7/8/2011,3,0,7,14,0,5,1,2,0.8,0.7879,0.63,0.3582,53,163,216,163
4434,7/8/2011,3,0,7,15,0,5,1,2,0.8,0.7879,0.63,0.3582,39,102,141,102
4435,7/8/2011,3,0,7,16,0,5,1,3,0.68,0.6364,0.83,0.4478,27,105,132,105
4436,7/8/2011,3,0,7,17,0,5,1,3,0.66,0.5909,0.89,0.4478,6,161,167,161
4437,7/8/2011,3,0,7,18,0,5,1,1,0.66,0.6061,0.83,0.0896,35,281,316,281
4438,7/8/2011,3,0,7,19,0,5,1,1,0.66,0.6061,0.83,0.0896,45,225,270,225
4439,7/8/2011,3,0,7,20,0,5,1,1,0.66,0.6061,0.83,0.1642,30,220,250,220
4440,7/8/2011,3,0,7,21,0,5,1,2,0.66,0.6061,0.83,0.2537,46,158,204,158
4441,7/8/2011,3,0,7,22,0,5,1,2,0.66,0.6061,0.78,0.194,33,136,169,136
4442,7/8/2011,3,0,7,23,0,5,1,2,0.66,0.6061,0.78,0.0896,40,111,151,111
4443,7/9/2011,3,0,7,0,0,6,0,2,0.66,0.6061,0.83,0.1343,31,90,121,90
4444,7/9/2011,3,0,7,1,0,6,0,2,0.64,0.5758,0.89,0.1045,5,48,53,48
4445,7/9/2011,3,0,7,2,0,6,0,1,0.64,0.5758,0.89,0.1642,12,43,55,43
4446,7/9/2011,3,0,7,3,0,6,0,1,0.64,0.5758,0.89,0.1343,7,23,30,23
4447,7/9/2011,3,0,7,4,0,6,0,1,0.64,0.5758,0.83,0.2239,2,4,6,4
4448,7/9/2011,3,0,7,5,0,6,0,2,0.62,0.5606,0.88,0.1642,4,11,15,11
4449,7/9/2011,3,0,7,6,0,6,0,2,0.64,0.5758,0.83,0.194,11,27,38,27
4450,7/9/2011,3,0,7,7,0,6,0,1,0.66,0.6061,0.78,0.194,21,50,71,50
4451,7/9/2011,3,0,7,8,0,6,0,1,0.7,0.6515,0.7,0.2537,68,114,182,114
4452,7/9/2011,3,0,7,9,0,6,0,1,0.74,0.6818,0.58,0.2836,77,170,247,170
4453,7/9/2011,3,0,7,10,0,6,0,1,0.76,0.697,0.52,0.1642,87,177,264,177
4454,7/9/2011,3,0,7,11,0,6,0,1,0.78,0.697,0.46,0.2985,101,189,290,189
4455,7/9/2011,3,0,7,12,0,6,0,1,0.8,0.7273,0.46,0.2537,145,221,366,221
4456,7/9/2011,3,0,7,13,0,6,0,1,0.82,0.7424,0.41,0.2239,167,249,416,249
4457,7/9/2011,3,0,7,14,0,6,0,1,0.84,0.7424,0.36,0.1343,158,215,373,215
4458,7/9/2011,3,0,7,15,0,6,0,1,0.84,0.7273,0.34,0.0896,182,220,402,220
4459,7/9/2011,3,0,7,16,0,6,0,1,0.82,0.7273,0.38,0,171,245,416,245
4460,7/9/2011,3,0,7,17,0,6,0,1,0.84,0.7273,0.32,0,160,241,401,241
4461,7/9/2011,3,0,7,18,0,6,0,1,0.82,0.7273,0.36,0.1045,132,246,378,246
4462,7/9/2011,3,0,7,19,0,6,0,1,0.76,0.697,0.55,0.1642,128,178,306,178
4463,7/9/2011,3,0,7,20,0,6,0,1,0.76,0.7121,0.58,0.2239,129,185,314,185
4464,7/9/2011,3,0,7,21,0,6,0,1,0.74,0.6818,0.58,0.1642,83,155,238,155
4465,7/9/2011,3,0,7,22,0,6,0,1,0.72,0.6818,0.62,0.1642,60,154,214,154
4466,7/9/2011,3,0,7,23,0,6,0,1,0.72,0.6667,0.58,0.194,47,93,140,93
4467,7/10/2011,3,0,7,0,0,0,0,1,0.7,0.6515,0.61,0.1642,42,112,154,112
4468,7/10/2011,3,0,7,1,0,0,0,1,0.7,0.6515,0.61,0.1343,19,94,113,94
4469,7/10/2011,3,0,7,2,0,0,0,1,0.68,0.6364,0.69,0.0896,28,68,96,68
4470,7/10/2011,3,0,7,3,0,0,0,1,0.66,0.6212,0.74,0.0896,6,19,25,19
4471,7/10/2011,3,0,7,4,0,0,0,1,0.66,0.6212,0.69,0.0896,0,5,5,5
4472,7/10/2011,3,0,7,5,0,0,0,1,0.66,0.6212,0.74,0,7,10,17,10
4473,7/10/2011,3,0,7,6,0,0,0,1,0.64,0.5909,0.78,0.0896,8,17,25,17
4474,7/10/2011,3,0,7,7,0,0,0,1,0.7,0.6515,0.7,0.0896,27,38,65,38
4475,7/10/2011,3,0,7,8,0,0,0,1,0.72,0.6818,0.66,0,27,65,92,65
4476,7/10/2011,3,0,7,9,0,0,0,1,0.74,0.697,0.66,0.0896,62,107,169,107
4477,7/10/2011,3,0,7,10,0,0,0,1,0.76,0.697,0.55,0.1343,95,173,268,173
4478,7/10/2011,3,0,7,11,0,0,0,1,0.78,0.7273,0.55,0.194,110,177,287,177
4479,7/10/2011,3,0,7,12,0,0,0,1,0.82,0.7576,0.46,0.2836,133,244,377,244
4480,7/10/2011,3,0,7,13,0,0,0,1,0.8,0.7273,0.46,0.2985,139,228,367,228
4481,7/10/2011,3,0,7,14,0,0,0,1,0.82,0.7424,0.41,0.3284,122,227,349,227
4482,7/10/2011,3,0,7,15,0,0,0,1,0.84,0.7424,0.39,0.2836,142,219,361,219
4483,7/10/2011,3,0,7,16,0,0,0,1,0.84,0.7576,0.41,0.2836,128,244,372,244
4484,7/10/2011,3,0,7,17,0,0,0,1,0.84,0.7424,0.36,0.2239,146,217,363,217
4485,7/10/2011,3,0,7,18,0,0,0,1,0.82,0.7424,0.43,0.2836,141,222,363,222
4486,7/10/2011,3,0,7,19,0,0,0,1,0.8,0.7424,0.49,0.3284,120,183,303,183
4487,7/10/2011,3,0,7,20,0,0,0,1,0.76,0.697,0.55,0.194,101,167,268,167
4488,7/10/2011,3,0,7,21,0,0,0,1,0.74,0.6818,0.62,0.2537,65,162,227,162
4489,7/10/2011,3,0,7,22,0,0,0,1,0.74,0.697,0.66,0.2239,56,87,143,87
4490,7/10/2011,3,0,7,23,0,0,0,1,0.72,0.6818,0.66,0.2537,19,53,72,53
4491,7/11/2011,3,0,7,0,0,1,1,1,0.7,0.6515,0.65,0.194,10,25,35,25
4492,7/11/2011,3,0,7,1,0,1,1,1,0.7,0.6515,0.61,0.2836,5,5,10,5
4493,7/11/2011,3,0,7,2,0,1,1,1,0.7,0.6515,0.61,0.2239,8,4,12,4
4494,7/11/2011,3,0,7,3,0,1,1,1,0.68,0.6364,0.65,0.1642,2,8,10,8
4495,7/11/2011,3,0,7,4,0,1,1,1,0.66,0.6212,0.74,0.2239,0,4,4,4
4496,7/11/2011,3,0,7,5,0,1,1,1,0.66,0.6212,0.74,0.1343,5,21,26,21
4497,7/11/2011,3,0,7,6,0,1,1,1,0.68,0.6364,0.74,0.194,19,102,121,102
4498,7/11/2011,3,0,7,7,0,1,1,1,0.7,0.6667,0.74,0.2537,28,289,317,289
4499,7/11/2011,3,0,7,8,0,1,1,1,0.74,0.697,0.66,0.2836,35,385,420,385
4500,7/11/2011,3,0,7,9,0,1,1,1,0.78,0.7424,0.59,0.2985,41,167,208,167
4501,7/11/2011,3,0,7,10,0,1,1,1,0.8,0.7576,0.55,0.3582,44,73,117,73
4502,7/11/2011,3,0,7,11,0,1,1,1,0.82,0.7879,0.56,0.2985,39,89,128,89
4503,7/11/2011,3,0,7,12,0,1,1,1,0.84,0.803,0.53,0.2836,40,108,148,108
4504,7/11/2011,3,0,7,13,0,1,1,1,0.86,0.8182,0.5,0.2537,22,119,141,119
4505,7/11/2011,3,0,7,14,0,1,1,1,0.86,0.8333,0.53,0.2836,40,94,134,94
4506,7/11/2011,3,0,7,15,0,1,1,1,0.86,0.8485,0.56,0.4179,38,108,146,108
4507,7/11/2011,3,0,7,16,0,1,1,1,0.86,0.8485,0.56,0.3881,57,182,239,182
4508,7/11/2011,3,0,7,17,0,1,1,1,0.86,0.8485,0.56,0.4179,59,455,514,455
4509,7/11/2011,3,0,7,18,0,1,1,1,0.86,0.8333,0.53,0.3881,57,415,472,415
4510,7/11/2011,3,0,7,19,0,1,1,1,0.84,0.8333,0.59,0.3284,80,293,373,293
4511,7/11/2011,3,0,7,20,0,1,1,1,0.72,0.697,0.74,0.4179,42,194,236,194
4512,7/11/2011,3,0,7,21,0,1,1,1,0.7,0.6667,0.79,0.4179,21,109,130,109
4513,7/11/2011,3,0,7,22,0,1,1,1,0.72,0.697,0.74,0.1343,20,70,90,70
4514,7/11/2011,3,0,7,23,0,1,1,1,0.7,0.6667,0.79,0.1343,11,44,55,44
4515,7/12/2011,3,0,7,0,0,2,1,1,0.7,0.6667,0.79,0.1343,3,19,22,19
4516,7/12/2011,3,0,7,1,0,2,1,1,0.7,0.6667,0.79,0.0896,6,8,14,8
4517,7/12/2011,3,0,7,2,0,2,1,1,0.7,0.6667,0.79,0.1045,2,7,9,7
4518,7/12/2011,3,0,7,3,0,2,1,2,0.7,0.6667,0.79,0,2,6,8,6
4519,7/12/2011,3,0,7,4,0,2,1,1,0.7,0.6667,0.79,0.1642,0,6,6,6
4520,7/12/2011,3,0,7,5,0,2,1,1,0.7,0.6667,0.79,0.0896,4,21,25,21
4521,7/12/2011,3,0,7,6,0,2,1,1,0.74,0.6818,0.58,0.2239,13,102,115,102
4522,7/12/2011,3,0,7,7,0,2,1,1,0.76,0.697,0.55,0.194,29,301,330,301
4523,7/12/2011,3,0,7,8,0,2,1,1,0.76,0.7121,0.58,0.2239,35,382,417,382
4524,7/12/2011,3,0,7,9,0,2,1,1,0.78,0.7273,0.55,0.4925,27,149,176,149
4525,7/12/2011,3,0,7,10,0,2,1,1,0.82,0.7727,0.52,0.1642,38,85,123,85
4526,7/12/2011,3,0,7,11,0,2,1,1,0.82,0.7727,0.52,0.1642,39,86,125,86
4527,7/12/2011,3,0,7,12,0,2,1,1,0.86,0.7879,0.44,0.2985,38,125,163,125
4528,7/12/2011,3,0,7,13,0,2,1,1,0.86,0.803,0.47,0.2239,32,104,136,104
4529,7/12/2011,3,0,7,14,0,2,1,1,0.9,0.8485,0.42,0.2985,33,91,124,91
4530,7/12/2011,3,0,7,15,0,2,1,1,0.9,0.8485,0.42,0.3582,37,111,148,111
4531,7/12/2011,3,0,7,16,0,2,1,1,0.86,0.7879,0.44,0.2836,25,177,202,177
4532,7/12/2011,3,0,7,17,0,2,1,1,0.88,0.8182,0.44,0.2836,48,380,428,380
4533,7/12/2011,3,0,7,18,0,2,1,1,0.86,0.803,0.47,0.2985,39,472,511,472
4534,7/12/2011,3,0,7,19,0,2,1,1,0.84,0.7576,0.44,0.2836,42,295,337,295
4535,7/12/2011,3,0,7,20,0,2,1,1,0.82,0.7424,0.43,0.194,57,251,308,251
4536,7/12/2011,3,0,7,21,0,2,1,1,0.82,0.7424,0.43,0.1045,49,209,258,209
4537,7/12/2011,3,0,7,22,0,2,1,1,0.8,0.7273,0.46,0.1343,44,150,194,150
4538,7/12/2011,3,0,7,23,0,2,1,1,0.78,0.7121,0.52,0,20,59,79,59
4539,7/13/2011,3,0,7,0,0,3,1,1,0.76,0.7121,0.62,0,9,37,46,37
4540,7/13/2011,3,0,7,1,0,3,1,1,0.76,0.697,0.55,0,1,11,12,11
4541,7/13/2011,3,0,7,2,0,3,1,1,0.76,0.697,0.55,0,2,3,5,3
4542,7/13/2011,3,0,7,3,0,3,1,1,0.74,0.6818,0.58,0.194,0,4,4,4
4543,7/13/2011,3,0,7,4,0,3,1,1,0.74,0.6818,0.58,0.2537,0,5,5,5
4544,7/13/2011,3,0,7,5,0,3,1,1,0.74,0.6818,0.58,0.194,4,22,26,22
4545,7/13/2011,3,0,7,6,0,3,1,1,0.74,0.6818,0.58,0.1642,18,103,121,103
4546,7/13/2011,3,0,7,7,0,3,1,1,0.76,0.697,0.55,0.2537,32,281,313,281
4547,7/13/2011,3,0,7,8,0,3,1,1,0.8,0.7424,0.49,0.2537,31,418,449,418
4548,7/13/2011,3,0,7,9,0,3,1,1,0.82,0.7424,0.41,0.194,23,163,186,163
4549,7/13/2011,3,0,7,10,0,3,1,1,0.82,0.7576,0.46,0.194,33,80,113,80
4550,7/13/2011,3,0,7,11,0,3,1,1,0.84,0.7424,0.39,0.1642,55,110,165,110
4551,7/13/2011,3,0,7,12,0,3,1,1,0.84,0.7576,0.41,0.2836,40,134,174,134
4552,7/13/2011,3,0,7,13,0,3,1,3,0.82,0.7576,0.46,0.1343,39,119,158,119
4553,7/13/2011,3,0,7,14,0,3,1,3,0.82,0.7576,0.46,0.1343,27,89,116,89
4554,7/13/2011,3,0,7,15,0,3,1,3,0.64,0.5606,0.94,0.1343,13,33,46,33
4555,7/13/2011,3,0,7,16,0,3,1,2,0.66,0.5909,0.89,0,23,118,141,118
4556,7/13/2011,3,0,7,17,0,3,1,1,0.7,0.6667,0.79,0,70,418,488,418
4557,7/13/2011,3,0,7,18,0,3,1,1,0.72,0.697,0.79,0.1343,51,412,463,412
4558,7/13/2011,3,0,7,19,0,3,1,1,0.7,0.6667,0.79,0.1045,79,340,419,340
4559,7/13/2011,3,0,7,20,0,3,1,1,0.7,0.6667,0.84,0.1642,61,281,342,281
4560,7/13/2011,3,0,7,21,0,3,1,1,0.7,0.6667,0.79,0.1045,56,194,250,194
4561,7/13/2011,3,0,7,22,0,3,1,1,0.68,0.6364,0.83,0.194,48,136,184,136
4562,7/13/2011,3,0,7,23,0,3,1,1,0.66,0.6061,0.83,0.2537,33,83,116,83
4563,7/14/2011,3,0,7,0,0,4,1,1,0.66,0.6212,0.69,0.2985,14,32,46,32
4564,7/14/2011,3,0,7,1,0,4,1,1,0.66,0.6212,0.61,0.2537,4,21,25,21
4565,7/14/2011,3,0,7,2,0,4,1,1,0.64,0.6212,0.57,0.2985,3,7,10,7
4566,7/14/2011,3,0,7,3,0,4,1,1,0.62,0.6212,0.57,0.2985,1,5,6,5
4567,7/14/2011,3,0,7,4,0,4,1,1,0.62,0.6212,0.53,0.2537,0,6,6,6
4568,7/14/2011,3,0,7,5,0,4,1,1,0.6,0.6212,0.56,0.2239,6,22,28,22
4569,7/14/2011,3,0,7,6,0,4,1,1,0.6,0.6061,0.6,0.2239,14,116,130,116
4570,7/14/2011,3,0,7,7,0,4,1,1,0.62,0.6212,0.53,0.2537,23,311,334,311
4571,7/14/2011,3,0,7,8,0,4,1,1,0.64,0.6212,0.5,0.3582,53,433,486,433
4572,7/14/2011,3,0,7,9,0,4,1,1,0.68,0.6364,0.47,0.2836,29,195,224,195
4573,7/14/2011,3,0,7,10,0,4,1,1,0.7,0.6364,0.42,0.2537,32,95,127,95
4574,7/14/2011,3,0,7,11,0,4,1,1,0.72,0.6515,0.37,0.2239,38,110,148,110
4575,7/14/2011,3,0,7,12,0,4,1,1,0.74,0.6515,0.35,0.2537,51,172,223,172
4576,7/14/2011,3,0,7,13,0,4,1,1,0.76,0.6667,0.33,0.3284,39,138,177,138
4577,7/14/2011,3,0,7,14,0,4,1,1,0.74,0.6515,0.35,0.2836,49,129,178,129
4578,7/14/2011,3,0,7,15,0,4,1,1,0.76,0.6667,0.33,0.2985,42,138,180,138
4579,7/14/2011,3,0,7,16,0,4,1,1,0.76,0.6667,0.33,0.1343,43,231,274,231
4580,7/14/2011,3,0,7,17,0,4,1,1,0.74,0.6515,0.37,0.1343,78,517,595,517
4581,7/14/2011,3,0,7,18,0,4,1,1,0.72,0.6515,0.42,0.194,94,484,578,484
4582,7/14/2011,3,0,7,19,0,4,1,1,0.72,0.6515,0.39,0.2239,67,333,400,333
4583,7/14/2011,3,0,7,20,0,4,1,1,0.7,0.6364,0.42,0.2239,81,267,348,267
4584,7/14/2011,3,0,7,21,0,4,1,1,0.66,0.6212,0.5,0.1343,58,203,261,203
4585,7/14/2011,3,0,7,22,0,4,1,1,0.64,0.6212,0.57,0.0896,42,134,176,134
4586,7/14/2011,3,0,7,23,0,4,1,1,0.64,0.6061,0.65,0.2537,27,97,124,97
4587,7/15/2011,3,0,7,0,0,5,1,1,0.62,0.5909,0.73,0.2239,23,57,80,57
4588,7/15/2011,3,0,7,1,0,5,1,1,0.62,0.5909,0.73,0.194,7,13,20,13
4589,7/15/2011,3,0,7,2,0,5,1,1,0.6,0.5758,0.78,0.1642,16,22,38,22
4590,7/15/2011,3,0,7,3,0,5,1,1,0.6,0.5909,0.73,0.194,1,6,7,6
4591,7/15/2011,3,0,7,4,0,5,1,1,0.6,0.5909,0.73,0.1642,2,8,10,8
4592,7/15/2011,3,0,7,5,0,5,1,1,0.6,0.5909,0.73,0.1343,7,16,23,16
4593,7/15/2011,3,0,7,6,0,5,1,2,0.6,0.5909,0.73,0.1045,12,108,120,108
4594,7/15/2011,3,0,7,7,0,5,1,1,0.64,0.6061,0.65,0.1045,17,257,274,257
4595,7/15/2011,3,0,7,8,0,5,1,1,0.64,0.6061,0.65,0.2537,50,514,564,514
4596,7/15/2011,3,0,7,9,0,5,1,1,0.68,0.6364,0.54,0.194,31,176,207,176
4597,7/15/2011,3,0,7,10,0,5,1,2,0.66,0.6212,0.61,0.1642,59,107,166,107
4598,7/15/2011,3,0,7,11,0,5,1,1,0.7,0.6515,0.54,0.1343,73,137,210,137
4599,7/15/2011,3,0,7,12,0,5,1,1,0.7,0.6515,0.48,0.194,61,177,238,177
4600,7/15/2011,3,0,7,13,0,5,1,1,0.7,0.6515,0.54,0.194,85,162,247,162
4601,7/15/2011,3,0,7,14,0,5,1,1,0.7,0.6515,0.51,0.194,105,160,265,160
4602,7/15/2011,3,0,7,15,0,5,1,1,0.72,0.6515,0.45,0.1642,74,163,237,163
4603,7/15/2011,3,0,7,16,0,5,1,1,0.72,0.6667,0.51,0.194,96,265,361,265
4604,7/15/2011,3,0,7,17,0,5,1,1,0.74,0.6667,0.42,0.2537,104,483,587,483
4605,7/15/2011,3,0,7,18,0,5,1,1,0.72,0.6515,0.45,0.2239,102,394,496,394
4606,7/15/2011,3,0,7,19,0,5,1,1,0.7,0.6364,0.45,0.2239,114,280,394,280
4607,7/15/2011,3,0,7,20,0,5,1,1,0.7,0.6515,0.51,0.2239,92,251,343,251
4608,7/15/2011,3,0,7,21,0,5,1,1,0.66,0.6212,0.54,0.1045,75,186,261,186
4609,7/15/2011,3,0,7,22,0,5,1,1,0.66,0.6212,0.57,0.2239,71,152,223,152
4610,7/15/2011,3,0,7,23,0,5,1,1,0.64,0.6212,0.61,0.1642,41,126,167,126
4611,7/16/2011,3,0,7,0,0,6,0,1,0.62,0.6061,0.65,0.194,42,68,110,68
4612,7/16/2011,3,0,7,1,0,6,0,1,0.6,0.5909,0.69,0.1045,24,51,75,51
4613,7/16/2011,3,0,7,2,0,6,0,1,0.6,0.5909,0.73,0.1343,10,48,58,48
4614,7/16/2011,3,0,7,3,0,6,0,1,0.6,0.5758,0.78,0.1343,6,20,26,20
4615,7/16/2011,3,0,7,4,0,6,0,1,0.6,0.5909,0.73,0.0896,9,7,16,7
4616,7/16/2011,3,0,7,5,0,6,0,1,0.58,0.5455,0.78,0.0896,4,6,10,6
4617,7/16/2011,3,0,7,6,0,6,0,1,0.6,0.5758,0.78,0.1642,16,21,37,21
4618,7/16/2011,3,0,7,7,0,6,0,1,0.62,0.5909,0.73,0.1343,14,38,52,38
4619,7/16/2011,3,0,7,8,0,6,0,1,0.66,0.6212,0.65,0.1642,37,90,127,90
4620,7/16/2011,3,0,7,9,0,6,0,1,0.7,0.6515,0.54,0.2239,72,150,222,150
4621,7/16/2011,3,0,7,10,0,6,0,1,0.72,0.6667,0.54,0.194,114,208,322,208
4622,7/16/2011,3,0,7,11,0,6,0,1,0.74,0.6667,0.48,0.2239,171,225,396,225
4623,7/16/2011,3,0,7,12,0,6,0,1,0.76,0.6818,0.43,0.2836,187,276,463,276
4624,7/16/2011,3,0,7,13,0,6,0,1,0.76,0.6818,0.45,0.2985,221,276,497,276
4625,7/16/2011,3,0,7,14,0,6,0,1,0.74,0.6667,0.45,0.2985,201,232,433,232
4626,7/16/2011,3,0,7,15,0,6,0,1,0.76,0.6818,0.45,0.3284,205,223,428,223
4627,7/16/2011,3,0,7,16,0,6,0,1,0.76,0.6818,0.45,0.2836,183,242,425,242
4628,7/16/2011,3,0,7,17,0,6,0,1,0.76,0.6818,0.45,0.2239,234,241,475,241
4629,7/16/2011,3,0,7,18,0,6,0,1,0.76,0.6818,0.45,0.2836,185,243,428,243
4630,7/16/2011,3,0,7,19,0,6,0,1,0.74,0.6818,0.48,0.194,164,242,406,242
4631,7/16/2011,3,0,7,20,0,6,0,1,0.72,0.6667,0.51,0.2239,108,188,296,188
4632,7/16/2011,3,0,7,21,0,6,0,1,0.7,0.6515,0.58,0.2239,85,167,252,167
4633,7/16/2011,3,0,7,22,0,6,0,1,0.7,0.6515,0.65,0.2836,65,136,201,136
4634,7/16/2011,3,0,7,23,0,6,0,1,0.68,0.6364,0.61,0.2239,61,107,168,107
4635,7/17/2011,3,0,7,0,0,0,0,1,0.66,0.6212,0.65,0.2239,34,91,125,91
4636,7/17/2011,3,0,7,1,0,0,0,1,0.64,0.6061,0.69,0.194,16,86,102,86
4637,7/17/2011,3,0,7,2,0,0,0,1,0.64,0.6061,0.69,0.2239,28,66,94,66
4638,7/17/2011,3,0,7,3,0,0,0,1,0.64,0.6061,0.69,0.2239,21,26,47,26
4639,7/17/2011,3,0,7,4,0,0,0,1,0.62,0.5909,0.73,0.1642,4,6,10,6
4640,7/17/2011,3,0,7,5,0,0,0,1,0.64,0.6061,0.69,0.2239,4,8,12,8
4641,7/17/2011,3,0,7,6,0,0,0,1,0.62,0.5909,0.73,0.1642,10,11,21,11
4642,7/17/2011,3,0,7,7,0,0,0,1,0.64,0.6061,0.73,0.1642,20,30,50,30
4643,7/17/2011,3,0,7,8,0,0,0,1,0.68,0.6364,0.65,0.2239,45,73,118,73
4644,7/17/2011,3,0,7,9,0,0,0,1,0.72,0.6667,0.58,0.2239,74,110,184,110
4645,7/17/2011,3,0,7,10,0,0,0,1,0.74,0.6818,0.6,0.2239,127,177,304,177
4646,7/17/2011,3,0,7,11,0,0,0,1,0.76,0.697,0.55,0.2836,147,244,391,244
4647,7/17/2011,3,0,7,12,0,0,0,1,0.76,0.697,0.55,0.2836,177,243,420,243
4648,7/17/2011,3,0,7,13,0,0,0,1,0.8,0.7424,0.49,0.2985,200,272,472,272
4649,7/17/2011,3,0,7,14,0,0,0,1,0.8,0.7424,0.49,0.3582,168,262,430,262
4650,7/17/2011,3,0,7,15,0,0,0,1,0.82,0.7424,0.43,0.2985,129,195,324,195
4651,7/17/2011,3,0,7,16,0,0,0,1,0.8,0.7273,0.46,0.2985,129,188,317,188
4652,7/17/2011,3,0,7,17,0,0,0,1,0.8,0.7424,0.49,0.3881,133,236,369,236
4653,7/17/2011,3,0,7,18,0,0,0,1,0.8,0.7273,0.46,0.2985,147,243,390,243
4654,7/17/2011,3,0,7,19,0,0,0,1,0.76,0.697,0.55,0.2836,145,234,379,234
4655,7/17/2011,3,0,7,20,0,0,0,1,0.76,0.7121,0.58,0.2537,85,177,262,177
4656,7/17/2011,3,0,7,21,0,0,0,1,0.74,0.6818,0.62,0.2239,59,148,207,148
4657,7/17/2011,3,0,7,22,0,0,0,1,0.72,0.6818,0.66,0.2239,65,116,181,116
4658,7/17/2011,3,0,7,23,0,0,0,1,0.7,0.6667,0.74,0.1343,39,54,93,54
4659,7/18/2011,3,0,7,0,0,1,1,1,0.7,0.6667,0.74,0.1343,21,30,51,30
4660,7/18/2011,3,0,7,1,0,1,1,1,0.7,0.6667,0.74,0.2239,17,8,25,8
4661,7/18/2011,3,0,7,2,0,1,1,1,0.66,0.6061,0.83,0.2239,2,8,10,8
4662,7/18/2011,3,0,7,3,0,1,1,1,0.66,0.6061,0.78,0.194,3,4,7,4
4663,7/18/2011,3,0,7,4,0,1,1,1,0.64,0.5909,0.78,0.1642,1,3,4,3
4664,7/18/2011,3,0,7,5,0,1,1,1,0.64,0.5909,0.78,0.1045,2,15,17,15
4665,7/18/2011,3,0,7,6,0,1,1,1,0.64,0.5758,0.83,0.1045,10,95,105,95
4666,7/18/2011,3,0,7,7,0,1,1,1,0.68,0.6364,0.74,0.2239,22,255,277,255
4667,7/18/2011,3,0,7,8,0,1,1,1,0.7,0.6515,0.7,0.194,18,329,347,329
4668,7/18/2011,3,0,7,9,0,1,1,1,0.74,0.697,0.67,0.2239,33,170,203,170
4669,7/18/2011,3,0,7,10,0,1,1,1,0.76,0.7121,0.62,0.194,52,78,130,78
4670,7/18/2011,3,0,7,11,0,1,1,1,0.8,0.7576,0.55,0.0896,42,99,141,99
4671,7/18/2011,3,0,7,12,0,1,1,1,0.8,0.7727,0.59,0.194,39,126,165,126
4672,7/18/2011,3,0,7,13,0,1,1,1,0.82,0.7879,0.56,0.2537,27,125,152,125
4673,7/18/2011,3,0,7,14,0,1,1,1,0.82,0.7879,0.56,0.3284,32,106,138,106
4674,7/18/2011,3,0,7,15,0,1,1,1,0.84,0.803,0.53,0.3284,53,111,164,111
4675,7/18/2011,3,0,7,16,0,1,1,1,0.84,0.803,0.53,0.2836,45,220,265,220
4676,7/18/2011,3,0,7,17,0,1,1,1,0.84,0.7879,0.49,0.3284,72,473,545,473
4677,7/18/2011,3,0,7,18,0,1,1,1,0.82,0.7727,0.49,0.3582,80,478,558,478
4678,7/18/2011,3,0,7,19,0,1,1,1,0.8,0.7576,0.55,0.2239,63,335,398,335
4679,7/18/2011,3,0,7,20,0,1,1,1,0.78,0.7424,0.59,0.2239,91,232,323,232
4680,7/18/2011,3,0,7,21,0,1,1,1,0.74,0.697,0.66,0.194,48,154,202,154
4681,7/18/2011,3,0,7,22,0,1,1,1,0.76,0.7273,0.66,0.2239,36,104,140,104
4682,7/18/2011,3,0,7,23,0,1,1,1,0.74,0.697,0.66,0.1642,32,59,91,59
4683,7/19/2011,3,0,7,0,0,2,1,1,0.74,0.697,0.66,0.1045,25,26,51,26
4684,7/19/2011,3,0,7,1,0,2,1,2,0.74,0.697,0.66,0.1343,7,6,13,6
4685,7/19/2011,3,0,7,2,0,2,1,1,0.72,0.6818,0.7,0.1642,9,4,13,4
4686,7/19/2011,3,0,7,3,0,2,1,1,0.72,0.6818,0.7,0.1642,2,1,3,1
4687,7/19/2011,3,0,7,4,0,2,1,1,0.72,0.6818,0.7,0.1343,1,4,5,4
4688,7/19/2011,3,0,7,5,0,2,1,2,0.7,0.6667,0.74,0.1045,0,19,19,19
4689,7/19/2011,3,0,7,6,0,2,1,2,0.72,0.697,0.74,0.1045,8,126,134,126
4690,7/19/2011,3,0,7,7,0,2,1,2,0.74,0.697,0.7,0.1642,28,287,315,287
4691,7/19/2011,3,0,7,8,0,2,1,2,0.76,0.7273,0.7,0.1642,31,381,412,381
4692,7/19/2011,3,0,7,9,0,2,1,2,0.8,0.7879,0.63,0.1343,22,177,199,177
4693,7/19/2011,3,0,7,10,0,2,1,2,0.82,0.7879,0.56,0.1642,29,112,141,112
4694,7/19/2011,3,0,7,11,0,2,1,1,0.82,0.803,0.59,0,29,98,127,98
4695,7/19/2011,3,0,7,12,0,2,1,1,0.84,0.8182,0.56,0.0896,26,127,153,127
4696,7/19/2011,3,0,7,13,0,2,1,1,0.86,0.8333,0.53,0.1045,33,139,172,139
4697,7/19/2011,3,0,7,14,0,2,1,1,0.86,0.8182,0.5,0.194,41,111,152,111
4698,7/19/2011,3,0,7,15,0,2,1,1,0.88,0.8182,0.44,0.194,48,110,158,110
4699,7/19/2011,3,0,7,16,0,2,1,1,0.9,0.8485,0.42,0.2985,61,216,277,216
4700,7/19/2011,3,0,7,17,0,2,1,1,0.8,0.803,0.66,0,68,445,513,445
4701,7/19/2011,3,0,7,18,0,2,1,1,0.8,0.803,0.66,0.1343,80,450,530,450
4702,7/19/2011,3,0,7,19,0,2,1,1,0.76,0.7424,0.75,0.194,54,334,388,334
4703,7/19/2011,3,0,7,20,0,2,1,1,0.74,0.7273,0.74,0.0896,48,229,277,229
4704,7/19/2011,3,0,7,21,0,2,1,1,0.74,0.7121,0.74,0.1343,47,194,241,194
4705,7/19/2011,3,0,7,22,0,2,1,1,0.74,0.7121,0.74,0,36,120,156,120
4706,7/19/2011,3,0,7,23,0,2,1,3,0.72,0.697,0.79,0.1642,19,73,92,73
4707,7/20/2011,3,0,7,0,0,3,1,1,0.7,0.6667,0.84,0.1045,11,29,40,29
4708,7/20/2011,3,0,7,1,0,3,1,1,0.7,0.6667,0.84,0,4,7,11,7
4709,7/20/2011,3,0,7,2,0,3,1,1,0.7,0.6667,0.84,0,2,7,9,7
4710,7/20/2011,3,0,7,3,0,3,1,1,0.7,0.6667,0.84,0.1045,2,4,6,4
4711,7/20/2011,3,0,7,4,0,3,1,1,0.68,0.6364,0.83,0,0,4,4,4
4712,7/20/2011,3,0,7,5,0,3,1,1,0.68,0.6364,0.83,0.1045,4,19,23,19
4713,7/20/2011,3,0,7,6,0,3,1,2,0.68,0.6364,0.89,0.1045,5,111,116,111
4714,7/20/2011,3,0,7,7,0,3,1,2,0.7,0.6667,0.84,0.1045,27,276,303,276
4715,7/20/2011,3,0,7,8,0,3,1,1,0.74,0.7121,0.74,0,34,404,438,404
4716,7/20/2011,3,0,7,9,0,3,1,1,0.74,0.697,0.7,0.0896,28,181,209,181
4717,7/20/2011,3,0,7,10,0,3,1,1,0.76,0.7273,0.7,0,34,76,110,76
4718,7/20/2011,3,0,7,11,0,3,1,1,0.8,0.7879,0.63,0.0896,26,116,142,116
4719,7/20/2011,3,0,7,12,0,3,1,1,0.82,0.803,0.59,0,28,121,149,121
4720,7/20/2011,3,0,7,13,0,3,1,1,0.84,0.8182,0.56,0.194,23,97,120,97
4721,7/20/2011,3,0,7,14,0,3,1,1,0.86,0.8333,0.53,0.2239,44,83,127,83
4722,7/20/2011,3,0,7,15,0,3,1,1,0.86,0.8182,0.5,0.1642,36,102,138,102
4723,7/20/2011,3,0,7,16,0,3,1,1,0.84,0.8182,0.56,0,30,204,234,204
4724,7/20/2011,3,0,7,17,0,3,1,1,0.84,0.8333,0.59,0.194,50,405,455,405
4725,7/20/2011,3,0,7,18,0,3,1,1,0.84,0.8333,0.59,0.2239,68,429,497,429
4726,7/20/2011,3,0,7,19,0,3,1,1,0.82,0.8485,0.67,0.1642,59,323,382,323
4727,7/20/2011,3,0,7,20,0,3,1,1,0.8,0.8333,0.75,0.2239,45,264,309,264
4728,7/20/2011,3,0,7,21,0,3,1,1,0.8,0.803,0.66,0.1642,33,209,242,209
4729,7/20/2011,3,0,7,22,0,3,1,1,0.78,0.7727,0.7,0.2239,25,144,169,144
4730,7/20/2011,3,0,7,23,0,3,1,1,0.76,0.7424,0.75,0.2537,26,73,99,73
4731,7/21/2011,3,0,7,0,0,4,1,2,0.76,0.7424,0.75,0.194,13,29,42,29
4732,7/21/2011,3,0,7,1,0,4,1,2,0.74,0.7273,0.84,0.2239,5,16,21,16
4733,7/21/2011,3,0,7,2,0,4,1,2,0.74,0.7273,0.84,0.2239,2,4,6,4
4734,7/21/2011,3,0,7,3,0,4,1,2,0.74,0.7121,0.79,0.1343,1,5,6,5
4735,7/21/2011,3,0,7,4,0,4,1,2,0.72,0.7121,0.84,0.1045,0,4,4,4
4736,7/21/2011,3,0,7,5,0,4,1,2,0.72,0.7121,0.84,0.1045,2,16,18,16
4737,7/21/2011,3,0,7,6,0,4,1,2,0.72,0.7121,0.84,0.1045,6,111,117,111
4738,7/21/2011,3,0,7,7,0,4,1,2,0.74,0.7273,0.84,0.1343,23,251,274,251
4739,7/21/2011,3,0,7,8,0,4,1,2,0.76,0.7576,0.79,0.1642,23,358,381,358
4740,7/21/2011,3,0,7,9,0,4,1,2,0.8,0.8182,0.75,0.2537,34,166,200,166
4741,7/21/2011,3,0,7,10,0,4,1,2,0.82,0.8636,0.71,0.2239,31,47,78,47
4742,7/21/2011,3,0,7,11,0,4,1,2,0.86,0.8939,0.63,0.2985,27,79,106,79
4743,7/21/2011,3,0,7,12,0,4,1,1,0.88,0.8939,0.56,0.3284,29,106,135,106
4744,7/21/2011,3,0,7,13,0,4,1,1,0.88,0.8939,0.56,0.2985,21,81,102,81
4745,7/21/2011,3,0,7,14,0,4,1,1,0.9,0.8939,0.5,0.3582,50,97,147,97
4746,7/21/2011,3,0,7,15,0,4,1,1,0.9,0.9242,0.53,0.2537,40,93,133,93
4747,7/21/2011,3,0,7,16,0,4,1,1,0.92,0.9242,0.48,0.2836,43,167,210,167
4748,7/21/2011,3,0,7,17,0,4,1,1,0.92,0.9091,0.45,0.2985,40,374,414,374
4749,7/21/2011,3,0,7,18,0,4,1,1,0.9,0.8939,0.5,0.2836,39,343,382,343
4750,7/21/2011,3,0,7,19,0,4,1,1,0.86,0.9242,0.67,0.2836,51,233,284,233
4751,7/21/2011,3,0,7,20,0,4,1,1,0.84,0.8939,0.71,0.2239,38,199,237,199
4752,7/21/2011,3,0,7,21,0,4,1,1,0.82,0.8939,0.75,0.2239,38,187,225,187
4753,7/21/2011,3,0,7,22,0,4,1,1,0.82,0.8636,0.71,0.1642,36,113,149,113
4754,7/21/2011,3,0,7,23,0,4,1,1,0.8,0.8182,0.71,0.1642,40,73,113,73
4755,7/22/2011,3,0,7,0,0,5,1,1,0.82,0.8333,0.63,0.1343,9,51,60,51
4756,7/22/2011,3,0,7,1,0,5,1,1,0.8,0.7879,0.63,0,7,17,24,17
4757,7/22/2011,3,0,7,2,0,5,1,1,0.78,0.803,0.79,0.1343,0,14,14,14
4758,7/22/2011,3,0,7,3,0,5,1,1,0.78,0.7879,0.75,0.1045,1,6,7,6
4759,7/22/2011,3,0,7,4,0,5,1,1,0.76,0.7424,0.75,0.1045,8,5,13,5
4760,7/22/2011,3,0,7,5,0,5,1,1,0.74,0.7121,0.79,0.1045,2,17,19,17
4761,7/22/2011,3,0,7,6,0,5,1,1,0.76,0.7424,0.75,0.0896,13,83,96,83
4762,7/22/2011,3,0,7,7,0,5,1,2,0.8,0.803,0.66,0.1045,20,232,252,232
4763,7/22/2011,3,0,7,8,0,5,1,2,0.84,0.8485,0.63,0.1642,30,292,322,292
4764,7/22/2011,3,0,7,9,0,5,1,1,0.86,0.8939,0.63,0.0896,31,177,208,177
4765,7/22/2011,3,0,7,10,0,5,1,1,0.9,0.9242,0.53,0.0896,32,83,115,83
4766,7/22/2011,3,0,7,11,0,5,1,1,0.9,0.8939,0.5,0.1045,23,86,109,86
4767,7/22/2011,3,0,7,12,0,5,1,1,0.94,0.9545,0.48,0.1642,20,95,115,95
4768,7/22/2011,3,0,7,13,0,5,1,1,0.94,0.9848,0.51,0.1642,25,98,123,98
4769,7/22/2011,3,0,7,14,0,5,1,1,0.96,1,0.48,0.2985,24,77,101,77
4770,7/22/2011,3,0,7,15,0,5,1,1,0.94,0.9848,0.51,0.2985,32,101,133,101
4771,7/22/2011,3,0,7,16,0,5,1,3,0.9,0.8333,0.39,0.2985,29,153,182,153
4772,7/22/2011,3,0,7,17,0,5,1,1,0.88,0.8485,0.47,0.1045,35,271,306,271
4773,7/22/2011,3,0,7,18,0,5,1,1,0.9,0.8182,0.37,0.1642,34,250,284,250
4774,7/22/2011,3,0,7,19,0,5,1,2,0.86,0.7879,0.41,0.1045,40,210,250,210
4775,7/22/2011,3,0,7,20,0,5,1,1,0.84,0.8182,0.56,0,46,166,212,166
4776,7/22/2011,3,0,7,21,0,5,1,1,0.82,0.803,0.59,0.0896,38,152,190,152
4777,7/22/2011,3,0,7,22,0,5,1,2,0.84,0.7879,0.49,0.0896,44,105,149,105
4778,7/22/2011,3,0,7,23,0,5,1,1,0.8,0.7879,0.63,0.194,19,84,103,84
4779,7/23/2011,3,0,7,0,0,6,0,1,0.82,0.7879,0.56,0,16,85,101,85
4780,7/23/2011,3,0,7,1,0,6,0,1,0.82,0.7727,0.52,0.1045,13,57,70,57
4781,7/23/2011,3,0,7,2,0,6,0,1,0.82,0.7727,0.52,0,13,48,61,48
4782,7/23/2011,3,0,7,3,0,6,0,1,0.78,0.7576,0.66,0.0896,6,16,22,16
4783,7/23/2011,3,0,7,4,0,6,0,1,0.76,0.7273,0.66,0.1045,5,4,9,4
4784,7/23/2011,3,0,7,5,0,6,0,1,0.76,0.7121,0.62,0.1343,1,6,7,6
4785,7/23/2011,3,0,7,6,0,6,0,1,0.8,0.7424,0.52,0.1343,6,19,25,19
4786,7/23/2011,3,0,7,7,0,6,0,1,0.8,0.7424,0.52,0.1045,7,38,45,38
4787,7/23/2011,3,0,7,8,0,6,0,1,0.84,0.7879,0.49,0.2537,24,85,109,85
4788,7/23/2011,3,0,7,9,0,6,0,1,0.84,0.7879,0.49,0.1642,30,102,132,102
4789,7/23/2011,3,0,7,10,0,6,0,1,0.86,0.7879,0.41,0.2239,61,137,198,137
4790,7/23/2011,3,0,7,11,0,6,0,1,0.9,0.8182,0.37,0.194,62,154,216,154
4791,7/23/2011,3,0,7,12,0,6,0,1,0.92,0.8636,0.37,0.1045,71,164,235,164
4792,7/23/2011,3,0,7,13,0,6,0,1,0.94,0.8788,0.38,0.1642,78,167,245,167
4793,7/23/2011,3,0,7,14,0,6,0,1,0.92,0.8939,0.42,0,84,152,236,152
4794,7/23/2011,3,0,7,15,0,6,0,1,0.94,0.8788,0.38,0,78,137,215,137
4795,7/23/2011,3,0,7,16,0,6,0,1,0.94,0.8788,0.38,0.1343,70,151,221,151
4796,7/23/2011,3,0,7,17,0,6,0,1,0.94,0.8788,0.38,0.1343,70,127,197,127
4797,7/23/2011,3,0,7,18,0,6,0,1,0.92,0.8788,0.4,0.2239,62,134,196,134
4798,7/23/2011,3,0,7,19,0,6,0,2,0.82,0.803,0.59,0.1343,80,137,217,137
4799,7/23/2011,3,0,7,20,0,6,0,1,0.82,0.803,0.59,0.2239,47,98,145,98
4800,7/23/2011,3,0,7,21,0,6,0,1,0.82,0.803,0.59,0.2239,39,115,154,115
4801,7/23/2011,3,0,7,22,0,6,0,1,0.8,0.7727,0.59,0.194,37,88,125,88
4802,7/23/2011,3,0,7,23,0,6,0,1,0.8,0.7727,0.59,0.1045,27,77,104,77
4803,7/24/2011,3,0,7,0,0,0,0,1,0.8,0.7727,0.59,0.1045,42,77,119,77
4804,7/24/2011,3,0,7,1,0,0,0,1,0.78,0.7576,0.66,0.1045,33,63,96,63
4805,7/24/2011,3,0,7,2,0,0,0,1,0.8,0.7879,0.63,0.0896,12,48,60,48
4806,7/24/2011,3,0,7,3,0,0,0,1,0.8,0.7879,0.63,0.0896,17,20,37,20
4807,7/24/2011,3,0,7,4,0,0,0,1,0.78,0.7576,0.66,0.1045,1,5,6,5
4808,7/24/2011,3,0,7,5,0,0,0,1,0.78,0.7576,0.66,0.0896,5,3,8,3
4809,7/24/2011,3,0,7,6,0,0,0,2,0.8,0.7879,0.63,0.0896,9,13,22,13
4810,7/24/2011,3,0,7,7,0,0,0,1,0.8,0.7727,0.59,0.1343,6,29,35,29
4811,7/24/2011,3,0,7,8,0,0,0,1,0.82,0.7879,0.56,0.2836,22,82,104,82
4812,7/24/2011,3,0,7,9,0,0,0,1,0.82,0.7879,0.56,0.3881,42,112,154,112
4813,7/24/2011,3,0,7,10,0,0,0,1,0.86,0.8182,0.5,0.3284,61,165,226,165
4814,7/24/2011,3,0,7,11,0,0,0,1,0.84,0.803,0.53,0.2537,74,169,243,169
4815,7/24/2011,3,0,7,12,0,0,0,1,0.9,0.8636,0.45,0.1642,85,161,246,161
4816,7/24/2011,3,0,7,13,0,0,0,1,0.86,0.803,0.47,0.2239,90,162,252,162
4817,7/24/2011,3,0,7,14,0,0,0,1,0.86,0.8182,0.5,0.2836,79,204,283,204
4818,7/24/2011,3,0,7,15,0,0,0,1,0.9,0.8485,0.42,0.2537,68,170,238,170
4819,7/24/2011,3,0,7,16,0,0,0,1,0.9,0.8485,0.42,0.2537,62,187,249,187
4820,7/24/2011,3,0,7,17,0,0,0,1,0.9,0.8333,0.39,0.1045,75,174,249,174
4821,7/24/2011,3,0,7,18,0,0,0,1,0.88,0.8182,0.42,0.1642,67,176,243,176
4822,7/24/2011,3,0,7,19,0,0,0,1,0.86,0.803,0.47,0.1642,70,170,240,170
4823,7/24/2011,3,0,7,20,0,0,0,1,0.84,0.7879,0.49,0.1642,52,143,195,143
4824,7/24/2011,3,0,7,21,0,0,0,1,0.8,0.7879,0.63,0.1343,42,111,153,111
4825,7/24/2011,3,0,7,22,0,0,0,1,0.78,0.7576,0.66,0,23,75,98,75
4826,7/24/2011,3,0,7,23,0,0,0,2,0.76,0.7273,0.7,0.0896,13,37,50,37
4827,7/25/2011,3,0,7,0,0,1,1,2,0.76,0.7273,0.7,0,17,17,34,17
4828,7/25/2011,3,0,7,1,0,1,1,2,0.76,0.7424,0.75,0.0896,4,8,12,8
4829,7/25/2011,3,0,7,2,0,1,1,2,0.74,0.7121,0.79,0.0896,3,3,6,3
4830,7/25/2011,3,0,7,3,0,1,1,1,0.74,0.7121,0.79,0,2,2,4,2
4831,7/25/2011,3,0,7,4,0,1,1,1,0.72,0.7121,0.84,0.0896,0,6,6,6
4832,7/25/2011,3,0,7,5,0,1,1,1,0.72,0.7121,0.84,0.0896,2,22,24,22
4833,7/25/2011,3,0,7,6,0,1,1,2,0.72,0.7121,0.84,0.0896,7,100,107,100
4834,7/25/2011,3,0,7,7,0,1,1,2,0.74,0.7121,0.79,0,20,257,277,257
4835,7/25/2011,3,0,7,8,0,1,1,2,0.76,0.7424,0.75,0,34,353,387,353
4836,7/25/2011,3,0,7,9,0,1,1,1,0.8,0.803,0.66,0,11,124,135,124
4837,7/25/2011,3,0,7,10,0,1,1,1,0.82,0.803,0.59,0,30,54,84,54
4838,7/25/2011,3,0,7,11,0,1,1,2,0.84,0.8333,0.59,0.194,24,83,107,83
4839,7/25/2011,3,0,7,12,0,1,1,2,0.84,0.8333,0.59,0.194,17,50,67,50
4840,7/25/2011,3,0,7,13,0,1,1,2,0.74,0.7121,0.74,0.1343,14,64,78,64
4841,7/25/2011,3,0,7,14,0,1,1,2,0.72,0.697,0.79,0.194,28,62,90,62
4842,7/25/2011,3,0,7,15,0,1,1,1,0.7,0.6667,0.84,0.3881,16,96,112,96
4843,7/25/2011,3,0,7,16,0,1,1,1,0.7,0.6667,0.84,0.2239,37,161,198,161
4844,7/25/2011,3,0,7,17,0,1,1,1,0.72,0.697,0.74,0,48,437,485,437
4845,7/25/2011,3,0,7,18,0,1,1,1,0.74,0.7121,0.74,0.0896,60,473,533,473
4846,7/25/2011,3,0,7,19,0,1,1,1,0.74,0.697,0.7,0.0896,62,324,386,324
4847,7/25/2011,3,0,7,20,0,1,1,1,0.72,0.697,0.74,0.1343,55,247,302,247
4848,7/25/2011,3,0,7,21,0,1,1,1,0.7,0.6667,0.84,0,41,153,194,153
4849,7/25/2011,3,0,7,22,0,1,1,1,0.7,0.6667,0.84,0,13,112,125,112
4850,7/25/2011,3,0,7,23,0,1,1,1,0.7,0.6667,0.84,0.0896,23,64,87,64
4851,7/26/2011,3,0,7,0,0,2,1,1,0.7,0.6667,0.79,0.1045,8,20,28,20
4852,7/26/2011,3,0,7,1,0,2,1,1,0.7,0.6667,0.79,0.1045,6,6,12,6
4853,7/26/2011,3,0,7,2,0,2,1,1,0.68,0.6364,0.89,0.1045,1,6,7,6
4854,7/26/2011,3,0,7,3,0,2,1,1,0.68,0.6364,0.89,0.1343,2,2,4,2
4855,7/26/2011,3,0,7,4,0,2,1,1,0.68,0.6364,0.88,0.1642,0,6,6,6
4856,7/26/2011,3,0,7,5,0,2,1,1,0.66,0.5909,0.89,0.0896,3,24,27,24
4857,7/26/2011,3,0,7,6,0,2,1,1,0.68,0.6364,0.83,0.2239,2,108,110,108
4858,7/26/2011,3,0,7,7,0,2,1,1,0.72,0.6818,0.66,0.2836,30,288,318,288
4859,7/26/2011,3,0,7,8,0,2,1,1,0.74,0.6818,0.55,0.194,32,392,424,392
4860,7/26/2011,3,0,7,9,0,2,1,1,0.76,0.6818,0.4,0.2239,25,162,187,162
4861,7/26/2011,3,0,7,10,0,2,1,1,0.8,0.697,0.31,0.2239,42,96,138,96
4862,7/26/2011,3,0,7,11,0,2,1,1,0.82,0.7121,0.3,0,49,102,151,102
4863,7/26/2011,3,0,7,12,0,2,1,1,0.84,0.7273,0.28,0,25,122,147,122
4864,7/26/2011,3,0,7,13,0,2,1,1,0.84,0.7273,0.32,0.2985,43,139,182,139
4865,7/26/2011,3,0,7,14,0,2,1,1,0.86,0.7424,0.3,0.2836,46,101,147,101
4866,7/26/2011,3,0,7,15,0,2,1,1,0.88,0.7576,0.28,0.3284,49,114,163,114
4867,7/26/2011,3,0,7,16,0,2,1,1,0.86,0.7576,0.36,0.2836,41,213,254,213
4868,7/26/2011,3,0,7,17,0,2,1,1,0.86,0.7576,0.36,0.3582,72,465,537,465
4869,7/26/2011,3,0,7,18,0,2,1,1,0.84,0.7424,0.39,0.3881,68,478,546,478
4870,7/26/2011,3,0,7,19,0,2,1,1,0.82,0.7424,0.43,0.2985,69,329,398,329
4871,7/26/2011,3,0,7,20,0,2,1,1,0.8,0.7273,0.46,0.2537,47,243,290,243
4872,7/26/2011,3,0,7,21,0,2,1,1,0.78,0.7121,0.49,0.2239,45,222,267,222
4873,7/26/2011,3,0,7,22,0,2,1,1,0.76,0.697,0.55,0.1343,27,131,158,131
4874,7/26/2011,3,0,7,23,0,2,1,1,0.76,0.7121,0.58,0.1045,18,71,89,71
4875,7/27/2011,3,0,7,0,0,3,1,2,0.78,0.7121,0.52,0.1642,19,26,45,26
4876,7/27/2011,3,0,7,1,0,3,1,1,0.78,0.7121,0.49,0.194,1,9,10,9
4877,7/27/2011,3,0,7,2,0,3,1,1,0.76,0.697,0.52,0.2985,1,5,6,5
4878,7/27/2011,3,0,7,3,0,3,1,1,0.72,0.6667,0.58,0.1642,0,4,4,4
4879,7/27/2011,3,0,7,4,0,3,1,1,0.72,0.6667,0.51,0.194,1,3,4,3
4880,7/27/2011,3,0,7,5,0,3,1,1,0.7,0.6515,0.54,0.2836,0,18,18,18
4881,7/27/2011,3,0,7,6,0,3,1,1,0.7,0.6515,0.54,0.2239,4,119,123,119
4882,7/27/2011,3,0,7,7,0,3,1,1,0.72,0.6667,0.48,0.2537,34,313,347,313
4883,7/27/2011,3,0,7,8,0,3,1,1,0.74,0.6667,0.42,0.2537,28,405,433,405
4884,7/27/2011,3,0,7,9,0,3,1,1,0.76,0.6667,0.35,0.2537,27,189,216,189
4885,7/27/2011,3,0,7,10,0,3,1,1,0.78,0.6818,0.33,0,32,82,114,82
4886,7/27/2011,3,0,7,11,0,3,1,1,0.8,0.697,0.31,0,42,94,136,94
4887,7/27/2011,3,0,7,12,0,3,1,1,0.82,0.7121,0.3,0.2836,37,132,169,132
4888,7/27/2011,3,0,7,13,0,3,1,1,0.84,0.7273,0.3,0.3582,29,151,180,151
4889,7/27/2011,3,0,7,14,0,3,1,1,0.84,0.7273,0.28,0.2239,20,107,127,107
4890,7/27/2011,3,0,7,15,0,3,1,1,0.86,0.7424,0.26,0.2537,37,103,140,103
4891,7/27/2011,3,0,7,16,0,3,1,1,0.86,0.7273,0.25,0.1642,40,228,268,228
4892,7/27/2011,3,0,7,17,0,3,1,1,0.84,0.7121,0.26,0.2239,81,491,572,491
4893,7/27/2011,3,0,7,18,0,3,1,1,0.82,0.7121,0.28,0.1045,78,463,541,463
4894,7/27/2011,3,0,7,19,0,3,1,1,0.8,0.697,0.29,0.0896,87,288,375,288
4895,7/27/2011,3,0,7,20,0,3,1,1,0.76,0.6818,0.45,0.2239,55,239,294,239
4896,7/27/2011,3,0,7,21,0,3,1,1,0.74,0.6667,0.48,0.1045,49,196,245,196
4897,7/27/2011,3,0,7,22,0,3,1,1,0.72,0.6667,0.48,0,37,143,180,143
4898,7/27/2011,3,0,7,23,0,3,1,1,0.74,0.6667,0.45,0.0896,16,93,109,93
4899,7/28/2011,3,0,7,0,0,4,1,1,0.7,0.6515,0.51,0.1343,14,31,45,31
4900,7/28/2011,3,0,7,1,0,4,1,1,0.72,0.6667,0.51,0,3,26,29,26
4901,7/28/2011,3,0,7,2,0,4,1,1,0.72,0.6667,0.54,0.1045,2,5,7,5
4902,7/28/2011,3,0,7,3,0,4,1,1,0.72,0.6667,0.54,0,0,5,5,5
4903,7/28/2011,3,0,7,4,0,4,1,1,0.7,0.6515,0.61,0.1045,0,6,6,6
4904,7/28/2011,3,0,7,5,0,4,1,1,0.7,0.6515,0.65,0.1045,1,26,27,26
4905,7/28/2011,3,0,7,6,0,4,1,1,0.7,0.6515,0.7,0.0896,6,110,116,110
4906,7/28/2011,3,0,7,7,0,4,1,1,0.72,0.6818,0.7,0.1642,27,278,305,278
4907,7/28/2011,3,0,7,8,0,4,1,1,0.74,0.697,0.66,0.1642,47,409,456,409
4908,7/28/2011,3,0,7,9,0,4,1,1,0.78,0.7424,0.59,0.194,21,189,210,189
4909,7/28/2011,3,0,7,10,0,4,1,1,0.8,0.7576,0.55,0.2836,30,86,116,86
4910,7/28/2011,3,0,7,11,0,4,1,1,0.84,0.8182,0.56,0.2836,41,113,154,113
4911,7/28/2011,3,0,7,12,0,4,1,1,0.84,0.803,0.53,0.2537,35,151,186,151
4912,7/28/2011,3,0,7,13,0,4,1,1,0.86,0.803,0.47,0.2537,26,126,152,126
4913,7/28/2011,3,0,7,14,0,4,1,2,0.84,0.7879,0.49,0.2537,27,111,138,111
4914,7/28/2011,3,0,7,15,0,4,1,1,0.86,0.8182,0.5,0.194,22,124,146,124
4915,7/28/2011,3,0,7,16,0,4,1,1,0.86,0.803,0.47,0.1642,42,214,256,214
4916,7/28/2011,3,0,7,17,0,4,1,1,0.84,0.803,0.53,0.194,45,423,468,423
4917,7/28/2011,3,0,7,18,0,4,1,1,0.84,0.8182,0.56,0.2239,55,428,483,428
4918,7/28/2011,3,0,7,19,0,4,1,1,0.82,0.803,0.59,0.194,37,285,322,285
4919,7/28/2011,3,0,7,20,0,4,1,1,0.8,0.7879,0.63,0.194,41,229,270,229
4920,7/28/2011,3,0,7,21,0,4,1,1,0.78,0.7576,0.66,0.2836,31,165,196,165
4921,7/28/2011,3,0,7,22,0,4,1,1,0.76,0.7273,0.7,0.2537,25,149,174,149
4922,7/28/2011,3,0,7,23,0,4,1,1,0.76,0.7424,0.75,0.194,28,95,123,95
4923,7/29/2011,3,0,7,0,0,5,1,1,0.74,0.7121,0.79,0.1642,12,45,57,45
4924,7/29/2011,3,0,7,1,0,5,1,1,0.74,0.7121,0.79,0.1343,12,22,34,22
4925,7/29/2011,3,0,7,2,0,5,1,1,0.74,0.7121,0.79,0,3,10,13,10
4926,7/29/2011,3,0,7,3,0,5,1,1,0.74,0.7121,0.79,0,2,9,11,9
4927,7/29/2011,3,0,7,4,0,5,1,1,0.72,0.7121,0.84,0.1343,2,4,6,4
4928,7/29/2011,3,0,7,5,0,5,1,1,0.72,0.7121,0.84,0,4,23,27,23
4929,7/29/2011,3,0,7,6,0,5,1,2,0.72,0.7121,0.84,0,7,83,90,83
4930,7/29/2011,3,0,7,7,0,5,1,2,0.74,0.7121,0.79,0.0896,26,228,254,228
4931,7/29/2011,3,0,7,8,0,5,1,2,0.76,0.7727,0.77,0,30,354,384,354
4932,7/29/2011,3,0,7,9,0,5,1,1,0.86,0.803,0.47,0.2537,28,151,179,151
4933,7/29/2011,3,0,7,10,0,5,1,1,0.9,0.8485,0.42,0.2836,37,69,106,69
4934,7/29/2011,3,0,7,11,0,5,1,1,0.92,0.8788,0.4,0.2985,43,118,161,118
4935,7/29/2011,3,0,7,12,0,5,1,1,0.96,0.8636,0.31,0.2836,40,95,135,95
4936,7/29/2011,3,0,7,13,0,5,1,1,0.94,0.8333,0.31,0,42,114,156,114
4937,7/29/2011,3,0,7,14,0,5,1,1,0.96,0.8636,0.3,0.2239,34,114,148,114
4938,7/29/2011,3,0,7,15,0,5,1,1,0.96,0.8636,0.3,0.2537,40,129,169,129
4939,7/29/2011,3,0,7,16,0,5,1,1,0.96,0.8636,0.3,0.3881,35,198,233,198
4940,7/29/2011,3,0,7,17,0,5,1,1,0.96,0.8636,0.3,0.2985,47,374,421,374
4941,7/29/2011,3,0,7,18,0,5,1,1,0.92,0.8636,0.37,0.3284,49,313,362,313
4942,7/29/2011,3,0,7,19,0,5,1,1,0.9,0.8485,0.42,0.2239,22,219,241,219
4943,7/29/2011,3,0,7,20,0,5,1,1,0.86,0.7879,0.41,0.3284,53,153,206,153
4944,7/29/2011,3,0,7,21,0,5,1,1,0.82,0.7576,0.46,0.1642,29,134,163,134
4945,7/29/2011,3,0,7,22,0,5,1,1,0.8,0.7424,0.49,0.2239,47,127,174,127
4946,7/29/2011,3,0,7,23,0,5,1,1,0.78,0.7121,0.52,0.1045,26,90,116,90
4947,7/30/2011,3,0,7,0,0,6,0,1,0.76,0.697,0.55,0.194,60,73,133,73
4948,7/30/2011,3,0,7,1,0,6,0,1,0.76,0.697,0.55,0.0896,15,75,90,75
4949,7/30/2011,3,0,7,2,0,6,0,1,0.76,0.697,0.55,0.1045,11,31,42,31
4950,7/30/2011,3,0,7,3,0,6,0,1,0.74,0.6818,0.62,0.1642,18,25,43,25
4951,7/30/2011,3,0,7,4,0,6,0,1,0.72,0.6818,0.66,0.1642,4,6,10,6
4952,7/30/2011,3,0,7,5,0,6,0,1,0.72,0.6818,0.7,0.2836,4,9,13,9
4953,7/30/2011,3,0,7,6,0,6,0,1,0.72,0.6818,0.7,0.2985,6,18,24,18
4954,7/30/2011,3,0,7,7,0,6,0,1,0.76,0.7273,0.66,0.194,3,39,42,39
4955,7/30/2011,3,0,7,8,0,6,0,1,0.78,0.7424,0.59,0.2239,27,87,114,87
4956,7/30/2011,3,0,7,9,0,6,0,1,0.82,0.7576,0.46,0.2985,49,125,174,125
4957,7/30/2011,3,0,7,10,0,6,0,1,0.82,0.7424,0.41,0.2985,79,182,261,182
4958,7/30/2011,3,0,7,11,0,6,0,1,0.84,0.7424,0.36,0.194,111,206,317,206
4959,7/30/2011,3,0,7,12,0,6,0,1,0.84,0.7273,0.32,0.1642,111,230,341,230
4960,7/30/2011,3,0,7,13,0,6,0,1,0.88,0.7576,0.29,0,125,183,308,183
4961,7/30/2011,3,0,7,14,0,6,0,1,0.9,0.7879,0.29,0,112,193,305,193
4962,7/30/2011,3,0,7,15,0,6,0,1,0.9,0.803,0.31,0.1343,113,189,302,189
4963,7/30/2011,3,0,7,16,0,6,0,1,0.9,0.7879,0.27,0.2239,126,176,302,176
4964,7/30/2011,3,0,7,17,0,6,0,1,0.9,0.7879,0.29,0.1045,93,209,302,209
4965,7/30/2011,3,0,7,18,0,6,0,1,0.88,0.7576,0.28,0.194,92,207,299,207
4966,7/30/2011,3,0,7,19,0,6,0,1,0.74,0.6515,0.33,0.2239,101,155,256,155
4967,7/30/2011,3,0,7,20,0,6,0,1,0.82,0.7424,0.43,0.1343,74,132,206,132
4968,7/30/2011,3,0,7,21,0,6,0,1,0.8,0.7424,0.49,0.1642,82,123,205,123
4969,7/30/2011,3,0,7,22,0,6,0,1,0.78,0.7121,0.52,0.1045,80,129,209,129
4970,7/30/2011,3,0,7,23,0,6,0,1,0.76,0.697,0.55,0.0896,63,114,177,114
4971,7/31/2011,3,0,7,0,0,0,0,1,0.76,0.697,0.55,0.0896,33,80,113,80
4972,7/31/2011,3,0,7,1,0,0,0,1,0.74,0.6818,0.62,0.0896,8,71,79,71
4973,7/31/2011,3,0,7,2,0,0,0,1,0.74,0.697,0.66,0.0896,19,48,67,48
4974,7/31/2011,3,0,7,3,0,0,0,1,0.74,0.697,0.66,0,24,26,50,26
4975,7/31/2011,3,0,7,4,0,0,0,1,0.72,0.6818,0.7,0,6,7,13,7
4976,7/31/2011,3,0,7,5,0,0,0,1,0.72,0.6818,0.69,0,4,4,8,4
4977,7/31/2011,3,0,7,6,0,0,0,1,0.74,0.697,0.7,0,5,8,13,8
4978,7/31/2011,3,0,7,7,0,0,0,1,0.74,0.6818,0.58,0.1343,19,26,45,26
4979,7/31/2011,3,0,7,8,0,0,0,1,0.76,0.697,0.55,0.2239,54,88,142,88
4980,7/31/2011,3,0,7,9,0,0,0,1,0.8,0.7424,0.49,0,55,128,183,128
4981,7/31/2011,3,0,7,10,0,0,0,1,0.84,0.7424,0.36,0.1642,91,163,254,163
4982,7/31/2011,3,0,7,11,0,0,0,1,0.86,0.7424,0.28,0.1642,112,163,275,163
4983,7/31/2011,3,0,7,12,0,0,0,1,0.9,0.7727,0.25,0.194,146,192,338,192
4984,7/31/2011,3,0,7,13,0,0,0,1,0.9,0.7727,0.24,0.1343,142,152,294,152
4985,7/31/2011,3,0,7,14,0,0,0,1,0.9,0.7727,0.24,0.1642,130,196,326,196
4986,7/31/2011,3,0,7,15,0,0,0,1,0.92,0.7727,0.18,0.2985,109,184,293,184
4987,7/31/2011,3,0,7,16,0,0,0,1,0.92,0.7727,0.17,0.2836,98,208,306,208
4988,7/31/2011,3,0,7,17,0,0,0,1,0.92,0.7727,0.16,0.1642,114,206,320,206
4989,7/31/2011,3,0,7,18,0,0,0,1,0.86,0.7879,0.41,0.2836,91,213,304,213
4990,7/31/2011,3,0,7,19,0,0,0,1,0.8,0.7576,0.55,0.3284,87,187,274,187
4991,7/31/2011,3,0,7,20,0,0,0,1,0.8,0.7576,0.55,0.3284,70,205,275,205
4992,7/31/2011,3,0,7,21,0,0,0,1,0.78,0.7424,0.59,0.2985,68,96,164,96
4993,7/31/2011,3,0,7,22,0,0,0,1,0.74,0.697,0.7,0.2985,25,71,96,71
4994,7/31/2011,3,0,7,23,0,0,0,1,0.74,0.697,0.66,0.2239,14,56,70,56
4995,8/1/2011,3,0,8,0,0,1,1,1,0.72,0.6818,0.7,0.2239,7,22,29,22
4996,8/1/2011,3,0,8,1,0,1,1,1,0.72,0.697,0.74,0.194,5,12,17,12
4997,8/1/2011,3,0,8,2,0,1,1,1,0.7,0.6667,0.74,0.1045,4,7,11,7
4998,8/1/2011,3,0,8,3,0,1,1,1,0.7,0.6667,0.79,0.1642,0,4,4,4
4999,8/1/2011,3,0,8,4,0,1,1,1,0.66,0.6061,0.83,0.1343,2,2,4,2
5000,8/1/2011,3,0,8,5,0,1,1,1,0.66,0.6061,0.83,0.1045,2,24,26,24
5001,8/1/2011,3,0,8,6,0,1,1,1,0.66,0.6061,0.83,0.0896,3,97,100,97
5002,8/1/2011,3,0,8,7,0,1,1,1,0.74,0.6818,0.62,0,24,258,282,258
5003,8/1/2011,3,0,8,8,0,1,1,1,0.8,0.7273,0.43,0.194,35,347,382,347
5004,8/1/2011,3,0,8,9,0,1,1,1,0.82,0.7424,0.41,0,27,139,166,139
5005,8/1/2011,3,0,8,10,0,1,1,1,0.86,0.7576,0.36,0.1642,27,70,97,70
5006,8/1/2011,3,0,8,11,0,1,1,1,0.88,0.7727,0.32,0.1642,53,66,119,66
5007,8/1/2011,3,0,8,12,0,1,1,1,0.9,0.803,0.33,0.2537,53,115,168,115
5008,8/1/2011,3,0,8,13,0,1,1,1,0.9,0.803,0.31,0.2985,38,112,150,112
5009,8/1/2011,3,0,8,14,0,1,1,1,0.92,0.8182,0.29,0.194,37,86,123,86
5010,8/1/2011,3,0,8,15,0,1,1,1,0.9,0.7879,0.27,0,52,77,129,77
5011,8/1/2011,3,0,8,16,0,1,1,1,0.9,0.7879,0.27,0,34,197,231,197
5012,8/1/2011,3,0,8,17,0,1,1,1,0.76,0.6818,0.45,0.2985,69,445,514,445
5013,8/1/2011,3,0,8,18,0,1,1,1,0.78,0.697,0.43,0.194,68,475,543,475
5014,8/1/2011,3,0,8,19,0,1,1,1,0.74,0.6667,0.51,0.2239,63,350,413,350
5015,8/1/2011,3,0,8,20,0,1,1,1,0.72,0.6818,0.62,0.2239,49,256,305,256
5016,8/1/2011,3,0,8,21,0,1,1,1,0.7,0.6515,0.7,0.2537,42,178,220,178
5017,8/1/2011,3,0,8,22,0,1,1,1,0.7,0.6515,0.7,0.0896,21,116,137,116
5018,8/1/2011,3,0,8,23,0,1,1,1,0.68,0.6364,0.74,0.194,14,82,96,82
5019,8/2/2011,3,0,8,0,0,2,1,1,0.66,0.6212,0.74,0,11,18,29,18
5020,8/2/2011,3,0,8,1,0,2,1,1,0.66,0.6212,0.74,0.1045,4,8,12,8
5021,8/2/2011,3,0,8,2,0,2,1,1,0.68,0.6364,0.69,0,2,6,8,6
5022,8/2/2011,3,0,8,3,0,2,1,1,0.66,0.6212,0.74,0.194,0,5,5,5
5023,8/2/2011,3,0,8,4,0,2,1,1,0.66,0.6212,0.74,0.1045,0,10,10,10
5024,8/2/2011,3,0,8,5,0,2,1,1,0.66,0.6212,0.74,0.1343,4,17,21,17
5025,8/2/2011,3,0,8,6,0,2,1,1,0.68,0.6364,0.69,0.1045,12,105,117,105
5026,8/2/2011,3,0,8,7,0,2,1,1,0.72,0.6667,0.61,0.2836,15,320,335,320
5027,8/2/2011,3,0,8,8,0,2,1,1,0.74,0.6818,0.58,0.2836,37,398,435,398
5028,8/2/2011,3,0,8,9,0,2,1,1,0.78,0.697,0.46,0.2985,31,182,213,182
5029,8/2/2011,3,0,8,10,0,2,1,1,0.82,0.7273,0.36,0.2985,50,90,140,90
5030,8/2/2011,3,0,8,11,0,2,1,1,0.84,0.7273,0.32,0.4179,32,96,128,96
5031,8/2/2011,3,0,8,12,0,2,1,1,0.86,0.7424,0.3,0.2836,45,112,157,112
5032,8/2/2011,3,0,8,13,0,2,1,1,0.86,0.7424,0.3,0.2239,50,153,203,153
5033,8/2/2011,3,0,8,14,0,2,1,1,0.9,0.7727,0.25,0.2836,45,114,159,114
5034,8/2/2011,3,0,8,15,0,2,1,1,0.9,0.7727,0.25,0.2836,48,120,168,120
5035,8/2/2011,3,0,8,16,0,2,1,1,0.9,0.7727,0.25,0.2836,58,216,274,216
5036,8/2/2011,3,0,8,17,0,2,1,2,0.9,0.7879,0.27,0.1343,63,493,556,493
5037,8/2/2011,3,0,8,18,0,2,1,2,0.86,0.7576,0.34,0.194,65,491,556,491
5038,8/2/2011,3,0,8,19,0,2,1,2,0.86,0.7576,0.36,0.2239,85,369,454,369
5039,8/2/2011,3,0,8,20,0,2,1,2,0.82,0.7576,0.46,0.2537,40,248,288,248
5040,8/2/2011,3,0,8,21,0,2,1,1,0.8,0.7424,0.52,0.2239,53,201,254,201
5041,8/2/2011,3,0,8,22,0,2,1,2,0.78,0.7424,0.59,0.1642,22,169,191,169
5042,8/2/2011,3,0,8,23,0,2,1,2,0.8,0.7424,0.49,0.1642,29,103,132,103
5043,8/3/2011,3,0,8,0,0,3,1,2,0.8,0.7424,0.49,0.1642,11,32,43,32
5044,8/3/2011,3,0,8,1,0,3,1,2,0.78,0.7121,0.52,0.1642,7,9,16,9
5045,8/3/2011,3,0,8,2,0,3,1,2,0.78,0.7121,0.49,0.1642,2,9,11,9
5046,8/3/2011,3,0,8,3,0,3,1,2,0.76,0.697,0.55,0.0896,0,4,4,4
5047,8/3/2011,3,0,8,4,0,3,1,2,0.76,0.697,0.52,0.1642,0,7,7,7
5048,8/3/2011,3,0,8,5,0,3,1,2,0.76,0.697,0.55,0.0896,2,22,24,22
5049,8/3/2011,3,0,8,6,0,3,1,3,0.72,0.6818,0.66,0.4925,9,101,110,101
5050,8/3/2011,3,0,8,7,0,3,1,2,0.74,0.6667,0.51,0.2239,19,252,271,252
5051,8/3/2011,3,0,8,8,0,3,1,2,0.74,0.6667,0.51,0.1642,29,408,437,408
5052,8/3/2011,3,0,8,9,0,3,1,2,0.74,0.6818,0.55,0.194,23,172,195,172
5053,8/3/2011,3,0,8,10,0,3,1,3,0.74,0.6818,0.58,0.0896,9,59,68,59
5054,8/3/2011,3,0,8,11,0,3,1,2,0.74,0.6818,0.58,0.1045,29,93,122,93
5055,8/3/2011,3,0,8,12,0,3,1,3,0.76,0.697,0.55,0.1343,19,142,161,142
5056,8/3/2011,3,0,8,13,0,3,1,2,0.76,0.7121,0.58,0.2239,37,107,144,107
5057,8/3/2011,3,0,8,14,0,3,1,2,0.76,0.7121,0.58,0.2239,43,104,147,104
5058,8/3/2011,3,0,8,15,0,3,1,2,0.7,0.6667,0.79,0.1343,31,87,118,87
5059,8/3/2011,3,0,8,16,0,3,1,3,0.68,0.6364,0.79,0,21,129,150,129
5060,8/3/2011,3,0,8,17,0,3,1,2,0.7,0.6667,0.79,0,47,378,425,378
5061,8/3/2011,3,0,8,18,0,3,1,3,0.7,0.6667,0.84,0,49,443,492,443
5062,8/3/2011,3,0,8,19,0,3,1,3,0.7,0.6667,0.84,0,51,270,321,270
5063,8/3/2011,3,0,8,20,0,3,1,3,0.7,0.6667,0.84,0.1045,7,80,87,80
5064,8/3/2011,3,0,8,21,0,3,1,2,0.68,0.6364,0.89,0.1343,7,81,88,81
5065,8/3/2011,3,0,8,22,0,3,1,3,0.68,0.6364,0.89,0.1045,11,66,77,66
5066,8/3/2011,3,0,8,23,0,3,1,2,0.68,0.6364,0.89,0.0896,4,52,56,52
5067,8/4/2011,3,0,8,0,0,4,1,2,0.68,0.6364,0.89,0.0896,2,15,17,15
5068,8/4/2011,3,0,8,1,0,4,1,2,0.66,0.5909,0.94,0.0896,3,14,17,14
5069,8/4/2011,3,0,8,2,0,4,1,2,0.66,0.5909,0.94,0.0896,2,5,7,5
5070,8/4/2011,3,0,8,3,0,4,1,3,0.66,0.5909,0.94,0.0896,0,3,3,3
5071,8/4/2011,3,0,8,4,0,4,1,2,0.68,0.6364,0.89,0,0,7,7,7
5072,8/4/2011,3,0,8,5,0,4,1,2,0.68,0.6364,0.89,0,3,17,20,17
5073,8/4/2011,3,0,8,6,0,4,1,2,0.68,0.6364,0.89,0.2985,7,90,97,90
5074,8/4/2011,3,0,8,7,0,4,1,2,0.68,0.6364,0.89,0.2985,11,271,282,271
5075,8/4/2011,3,0,8,8,0,4,1,2,0.7,0.6515,0.82,0.3582,29,369,398,369
5076,8/4/2011,3,0,8,9,0,4,1,1,0.72,0.697,0.74,0.3284,25,162,187,162
5077,8/4/2011,3,0,8,10,0,4,1,1,0.72,0.6667,0.71,0.2985,24,89,113,89
5078,8/4/2011,3,0,8,11,0,4,1,2,0.74,0.697,0.66,0.2239,37,112,149,112
5079,8/4/2011,3,0,8,12,0,4,1,2,0.76,0.7121,0.62,0.2239,53,152,205,152
5080,8/4/2011,3,0,8,13,0,4,1,1,0.76,0.7121,0.58,0,63,142,205,142
5081,8/4/2011,3,0,8,14,0,4,1,1,0.8,0.7576,0.55,0.1642,53,114,167,114
5082,8/4/2011,3,0,8,15,0,4,1,1,0.8,0.7576,0.55,0.2537,50,115,165,115
5083,8/4/2011,3,0,8,16,0,4,1,1,0.76,0.7121,0.62,0.3284,70,220,290,220
5084,8/4/2011,3,0,8,17,0,4,1,1,0.76,0.7121,0.62,0.3284,91,464,555,464
5085,8/4/2011,3,0,8,18,0,4,1,1,0.7,0.6667,0.74,0.2985,88,435,523,435
5086,8/4/2011,3,0,8,19,0,4,1,1,0.7,0.6667,0.74,0.2836,65,301,366,301
5087,8/4/2011,3,0,8,20,0,4,1,2,0.7,0.6667,0.74,0.194,41,245,286,245
5088,8/4/2011,3,0,8,21,0,4,1,2,0.7,0.6667,0.74,0.194,25,186,211,186
5089,8/4/2011,3,0,8,22,0,4,1,1,0.68,0.6364,0.74,0.194,33,141,174,141
5090,8/4/2011,3,0,8,23,0,4,1,1,0.66,0.6212,0.74,0.1045,24,108,132,108
5091,8/5/2011,3,0,8,0,0,5,1,1,0.66,0.6212,0.74,0.1045,13,41,54,41
5092,8/5/2011,3,0,8,1,0,5,1,1,0.64,0.5909,0.78,0.0896,3,16,19,16
5093,8/5/2011,3,0,8,2,0,5,1,1,0.66,0.6212,0.69,0,5,14,19,14
5094,8/5/2011,3,0,8,3,0,5,1,1,0.64,0.5909,0.78,0.0896,0,6,6,6
5095,8/5/2011,3,0,8,4,0,5,1,1,0.64,0.5909,0.78,0.1343,1,6,7,6
5096,8/5/2011,3,0,8,5,0,5,1,1,0.64,0.5909,0.78,0.0896,0,16,16,16
5097,8/5/2011,3,0,8,6,0,5,1,1,0.64,0.5909,0.78,0.1343,7,94,101,94
5098,8/5/2011,3,0,8,7,0,5,1,1,0.66,0.6061,0.78,0.1343,23,247,270,247
5099,8/5/2011,3,0,8,8,0,5,1,1,0.7,0.6515,0.65,0.2239,39,415,454,415
5100,8/5/2011,3,0,8,9,0,5,1,1,0.72,0.6667,0.58,0.1045,43,183,226,183
5101,8/5/2011,3,0,8,10,0,5,1,1,0.74,0.6818,0.55,0.1343,50,113,163,113
5102,8/5/2011,3,0,8,11,0,5,1,2,0.76,0.697,0.52,0.2537,44,103,147,103
5103,8/5/2011,3,0,8,12,0,5,1,1,0.76,0.697,0.52,0.2537,57,159,216,159
5104,8/5/2011,3,0,8,13,0,5,1,1,0.78,0.7121,0.52,0.2537,40,164,204,164
5105,8/5/2011,3,0,8,14,0,5,1,2,0.78,0.7121,0.52,0.2537,81,164,245,164
5106,8/5/2011,3,0,8,15,0,5,1,1,0.76,0.697,0.55,0.2537,50,160,210,160
5107,8/5/2011,3,0,8,16,0,5,1,1,0.8,0.7424,0.49,0.2537,76,254,330,254
5108,8/5/2011,3,0,8,17,0,5,1,1,0.78,0.7121,0.49,0.2985,84,466,550,466
5109,8/5/2011,3,0,8,18,0,5,1,1,0.76,0.697,0.52,0.2537,105,361,466,361
5110,8/5/2011,3,0,8,19,0,5,1,1,0.74,0.6818,0.55,0.2537,90,282,372,282
5111,8/5/2011,3,0,8,20,0,5,1,1,0.72,0.6667,0.58,0.2239,70,221,291,221
5112,8/5/2011,3,0,8,21,0,5,1,1,0.7,0.6515,0.65,0.194,54,119,173,119
5113,8/5/2011,3,0,8,22,0,5,1,1,0.7,0.6515,0.65,0.2239,51,137,188,137
5114,8/5/2011,3,0,8,23,0,5,1,1,0.68,0.6364,0.69,0.2239,37,102,139,102
5115,8/6/2011,3,0,8,0,0,6,0,1,0.66,0.6061,0.78,0.194,29,104,133,104
5116,8/6/2011,3,0,8,1,0,6,0,1,0.66,0.6061,0.78,0.1642,17,50,67,50
5117,8/6/2011,3,0,8,2,0,6,0,1,0.66,0.6061,0.78,0.2239,14,39,53,39
5118,8/6/2011,3,0,8,3,0,6,0,2,0.66,0.6061,0.78,0.1642,14,28,42,28
5119,8/6/2011,3,0,8,4,0,6,0,2,0.66,0.6061,0.83,0.1642,5,5,10,5
5120,8/6/2011,3,0,8,5,0,6,0,1,0.64,0.5758,0.89,0.0896,2,4,6,4
5121,8/6/2011,3,0,8,6,0,6,0,1,0.64,0.5758,0.89,0.1045,5,22,27,22
5122,8/6/2011,3,0,8,7,0,6,0,1,0.68,0.6364,0.83,0.1642,14,49,63,49
5123,8/6/2011,3,0,8,8,0,6,0,1,0.68,0.6364,0.83,0.1642,27,94,121,94
5124,8/6/2011,3,0,8,9,0,6,0,1,0.74,0.697,0.7,0.2239,60,155,215,155
5125,8/6/2011,3,0,8,10,0,6,0,2,0.74,0.697,0.7,0.2836,91,199,290,199
5126,8/6/2011,3,0,8,11,0,6,0,1,0.78,0.7424,0.62,0.2239,138,211,349,211
5127,8/6/2011,3,0,8,12,0,6,0,1,0.8,0.7576,0.55,0.2239,130,252,382,252
5128,8/6/2011,3,0,8,13,0,6,0,2,0.8,0.7727,0.59,0.3284,176,265,441,265
5129,8/6/2011,3,0,8,14,0,6,0,1,0.82,0.7727,0.52,0.2537,176,204,380,204
5130,8/6/2011,3,0,8,15,0,6,0,2,0.84,0.803,0.53,0.2537,130,232,362,232
5131,8/6/2011,3,0,8,16,0,6,0,3,0.74,0.7121,0.79,0.1642,155,188,343,188
5132,8/6/2011,3,0,8,17,0,6,0,3,0.74,0.7121,0.79,0.1642,61,88,149,88
5133,8/6/2011,3,0,8,18,0,6,0,2,0.72,0.697,0.79,0.4478,81,130,211,130
5134,8/6/2011,3,0,8,19,0,6,0,3,0.72,0.7121,0.84,0.2537,57,114,171,114
5135,8/6/2011,3,0,8,20,0,6,0,3,0.72,0.697,0.79,0.2836,58,79,137,79
5136,8/6/2011,3,0,8,21,0,6,0,2,0.7,0.6667,0.84,0.3284,28,86,114,86
5137,8/6/2011,3,0,8,22,0,6,0,2,0.7,0.6667,0.84,0.3284,24,96,120,96
5138,8/6/2011,3,0,8,23,0,6,0,3,0.7,0.6667,0.84,0.2836,29,79,108,79
5139,8/7/2011,3,0,8,0,0,0,0,2,0.7,0.6667,0.84,0.2836,14,66,80,66
5140,8/7/2011,3,0,8,1,0,0,0,2,0.7,0.6667,0.84,0.2537,10,63,73,63
5141,8/7/2011,3,0,8,2,0,0,0,2,0.7,0.6667,0.84,0.2239,18,48,66,48
5142,8/7/2011,3,0,8,3,0,0,0,2,0.7,0.6667,0.84,0.1343,9,23,32,23
5143,8/7/2011,3,0,8,4,0,0,0,1,0.7,0.6667,0.84,0.1343,1,5,6,5
5144,8/7/2011,3,0,8,5,0,0,0,1,0.7,0.6667,0.89,0.194,1,4,5,4
5145,8/7/2011,3,0,8,6,0,0,0,1,0.7,0.6667,0.89,0.1642,3,10,13,10
5146,8/7/2011,3,0,8,7,0,0,0,1,0.7,0.6667,0.84,0.194,11,28,39,28
5147,8/7/2011,3,0,8,8,0,0,0,1,0.72,0.697,0.79,0.194,23,66,89,66
5148,8/7/2011,3,0,8,9,0,0,0,1,0.76,0.7424,0.75,0.1045,82,102,184,102
5149,8/7/2011,3,0,8,10,0,0,0,1,0.8,0.803,0.66,0.1343,88,178,266,178
5150,8/7/2011,3,0,8,11,0,0,0,1,0.82,0.8333,0.63,0,113,156,269,156
5151,8/7/2011,3,0,8,12,0,0,0,1,0.9,0.8485,0.42,0.2985,161,209,370,209
5152,8/7/2011,3,0,8,13,0,0,0,1,0.9,0.8485,0.42,0.2985,118,206,324,206
5153,8/7/2011,3,0,8,14,0,0,0,1,0.86,0.803,0.47,0.194,130,192,322,192
5154,8/7/2011,3,0,8,15,0,0,0,3,0.72,0.697,0.74,0.2985,118,208,326,208
5155,8/7/2011,3,0,8,16,0,0,0,3,0.72,0.697,0.74,0.2985,74,119,193,119
5156,8/7/2011,3,0,8,17,0,0,0,3,0.74,0.7121,0.74,0.6418,63,131,194,131
5157,8/7/2011,3,0,8,18,0,0,0,1,0.72,0.697,0.74,0.0896,74,155,229,155
5158,8/7/2011,3,0,8,19,0,0,0,1,0.72,0.697,0.79,0.1642,68,160,228,160
5159,8/7/2011,3,0,8,20,0,0,0,1,0.72,0.7121,0.84,0.1343,50,133,183,133
5160,8/7/2011,3,0,8,21,0,0,0,1,0.72,0.7121,0.84,0.1045,36,100,136,100
5161,8/7/2011,3,0,8,22,0,0,0,1,0.7,0.6667,0.89,0.194,21,82,103,82
5162,8/7/2011,3,0,8,23,0,0,0,1,0.7,0.6667,0.79,0.1045,12,43,55,43
5163,8/8/2011,3,0,8,0,0,1,1,1,0.7,0.6667,0.79,0.1045,13,17,30,17
5164,8/8/2011,3,0,8,1,0,1,1,1,0.68,0.6364,0.83,0.1343,4,8,12,8
5165,8/8/2011,3,0,8,2,0,1,1,1,0.66,0.5909,0.89,0,4,3,7,3
5166,8/8/2011,3,0,8,3,0,1,1,1,0.66,0.5909,0.89,0,1,0,1,0
5167,8/8/2011,3,0,8,4,0,1,1,1,0.66,0.5909,0.89,0.1045,2,8,10,8
5168,8/8/2011,3,0,8,5,0,1,1,1,0.7,0.6667,0.79,0.0896,1,14,15,14
5169,8/8/2011,3,0,8,6,0,1,1,1,0.7,0.6515,0.65,0.2836,8,87,95,87
5170,8/8/2011,3,0,8,7,0,1,1,1,0.72,0.6818,0.62,0.2985,18,249,267,249
5171,8/8/2011,3,0,8,8,0,1,1,1,0.74,0.6818,0.58,0.3284,29,320,349,320
5172,8/8/2011,3,0,8,9,0,1,1,1,0.76,0.697,0.55,0.3881,37,146,183,146
5173,8/8/2011,3,0,8,10,0,1,1,1,0.8,0.7424,0.52,0.3881,62,62,124,62
5174,8/8/2011,3,0,8,11,0,1,1,1,0.82,0.7424,0.48,0.3582,90,89,179,89
5175,8/8/2011,3,0,8,12,0,1,1,1,0.82,0.7576,0.46,0.2537,48,134,182,134
5176,8/8/2011,3,0,8,13,0,1,1,1,0.84,0.7576,0.44,0.2985,43,108,151,108
5177,8/8/2011,3,0,8,14,0,1,1,1,0.82,0.7424,0.43,0.2985,41,109,150,109
5178,8/8/2011,3,0,8,15,0,1,1,1,0.84,0.7576,0.41,0.2985,40,86,126,86
5179,8/8/2011,3,0,8,16,0,1,1,1,0.86,0.7727,0.39,0.2836,64,218,282,218
5180,8/8/2011,3,0,8,17,0,1,1,1,0.86,0.7727,0.39,0.1642,67,460,527,460
5181,8/8/2011,3,0,8,18,0,1,1,1,0.84,0.7576,0.41,0.1343,64,465,529,465
5182,8/8/2011,3,0,8,19,0,1,1,1,0.82,0.7424,0.43,0.1045,64,352,416,352
5183,8/8/2011,3,0,8,20,0,1,1,1,0.8,0.7576,0.55,0,71,215,286,215
5184,8/8/2011,3,0,8,21,0,1,1,1,0.76,0.7121,0.58,0.0896,30,156,186,156
5185,8/8/2011,3,0,8,22,0,1,1,1,0.76,0.7121,0.58,0.1045,26,121,147,121
5186,8/8/2011,3,0,8,23,0,1,1,1,0.74,0.697,0.66,0.1045,19,53,72,53
5187,8/9/2011,3,0,8,0,0,2,1,1,0.72,0.697,0.79,0.1343,10,25,35,25
5188,8/9/2011,3,0,8,1,0,2,1,1,0.72,0.6818,0.66,0,5,9,14,9
5189,8/9/2011,3,0,8,2,0,2,1,1,0.72,0.6818,0.7,0,9,3,12,3
5190,8/9/2011,3,0,8,3,0,2,1,1,0.72,0.6818,0.62,0,0,3,3,3
5191,8/9/2011,3,0,8,4,0,2,1,1,0.7,0.6667,0.74,0,1,6,7,6
5192,8/9/2011,3,0,8,5,0,2,1,1,0.7,0.6515,0.65,0.0896,5,25,30,25
5193,8/9/2011,3,0,8,6,0,2,1,1,0.72,0.6667,0.64,0,6,95,101,95
5194,8/9/2011,3,0,8,7,0,2,1,1,0.72,0.697,0.74,0.1045,30,313,343,313
5195,8/9/2011,3,0,8,8,0,2,1,1,0.74,0.697,0.66,0,40,352,392,352
5196,8/9/2011,3,0,8,9,0,2,1,2,0.78,0.7424,0.62,0.1343,34,141,175,141
5197,8/9/2011,3,0,8,10,0,2,1,2,0.8,0.7727,0.59,0.2239,55,89,144,89
5198,8/9/2011,3,0,8,11,0,2,1,1,0.8,0.7727,0.59,0.2239,61,88,149,88
5199,8/9/2011,3,0,8,12,0,2,1,1,0.82,0.7879,0.56,0.194,60,125,185,125
5200,8/9/2011,3,0,8,13,0,2,1,1,0.84,0.7879,0.49,0.1642,48,127,175,127
5201,8/9/2011,3,0,8,14,0,2,1,1,0.86,0.7879,0.44,0.2836,53,95,148,95
5202,8/9/2011,3,0,8,15,0,2,1,1,0.86,0.7727,0.39,0.2836,58,106,164,106
5203,8/9/2011,3,0,8,16,0,2,1,1,0.86,0.7727,0.39,0.2985,57,228,285,228
5204,8/9/2011,3,0,8,17,0,2,1,1,0.8,0.7576,0.55,0.1642,79,453,532,453
5205,8/9/2011,3,0,8,18,0,2,1,1,0.8,0.7576,0.55,0.194,97,488,585,488
5206,8/9/2011,3,0,8,19,0,2,1,1,0.8,0.7424,0.49,0.1045,69,302,371,302
5207,8/9/2011,3,0,8,20,0,2,1,1,0.8,0.7273,0.43,0.194,34,258,292,258
5208,8/9/2011,3,0,8,21,0,2,1,1,0.78,0.697,0.46,0.2537,46,184,230,184
5209,8/9/2011,3,0,8,22,0,2,1,1,0.78,0.697,0.46,0.2985,28,127,155,127
5210,8/9/2011,3,0,8,23,0,2,1,1,0.76,0.6818,0.48,0.2836,22,53,75,53
5211,8/10/2011,3,0,8,0,0,3,1,1,0.74,0.6667,0.51,0.2239,19,18,37,18
5212,8/10/2011,3,0,8,1,0,3,1,1,0.72,0.6667,0.54,0.194,7,10,17,10
5213,8/10/2011,3,0,8,2,0,3,1,1,0.72,0.6667,0.54,0.1642,1,10,11,10
5214,8/10/2011,3,0,8,3,0,3,1,1,0.7,0.6515,0.58,0.1642,1,3,4,3
5215,8/10/2011,3,0,8,4,0,3,1,1,0.7,0.6515,0.54,0.1343,1,4,5,4
5216,8/10/2011,3,0,8,5,0,3,1,1,0.68,0.6364,0.61,0.0896,2,30,32,30
5217,8/10/2011,3,0,8,6,0,3,1,1,0.68,0.6364,0.61,0,9,110,119,110
5218,8/10/2011,3,0,8,7,0,3,1,1,0.7,0.6515,0.58,0.0896,16,289,305,289
5219,8/10/2011,3,0,8,8,0,3,1,1,0.74,0.6667,0.51,0.194,38,361,399,361
5220,8/10/2011,3,0,8,9,0,3,1,1,0.76,0.6818,0.48,0.2239,32,148,180,148
5221,8/10/2011,3,0,8,10,0,3,1,1,0.8,0.7273,0.43,0.2239,41,72,113,72
5222,8/10/2011,3,0,8,11,0,3,1,1,0.8,0.7121,0.41,0.3881,54,95,149,95
5223,8/10/2011,3,0,8,12,0,3,1,1,0.82,0.7273,0.38,0.2985,74,166,240,166
5224,8/10/2011,3,0,8,13,0,3,1,1,0.82,0.7273,0.38,0.2836,41,150,191,150
5225,8/10/2011,3,0,8,14,0,3,1,1,0.84,0.7273,0.34,0.3284,62,116,178,116
5226,8/10/2011,3,0,8,15,0,3,1,1,0.86,0.7424,0.3,0.3284,53,141,194,141
5227,8/10/2011,3,0,8,16,0,3,1,1,0.86,0.7424,0.26,0.2985,76,206,282,206
5228,8/10/2011,3,0,8,17,0,3,1,1,0.84,0.7121,0.26,0.2985,71,513,584,513
5229,8/10/2011,3,0,8,18,0,3,1,1,0.82,0.7121,0.28,0.2985,70,489,559,489
5230,8/10/2011,3,0,8,19,0,3,1,1,0.8,0.697,0.26,0.2537,79,334,413,334
5231,8/10/2011,3,0,8,20,0,3,1,1,0.76,0.6667,0.31,0.1343,59,253,312,253
5232,8/10/2011,3,0,8,21,0,3,1,1,0.76,0.6667,0.33,0.1045,47,162,209,162
5233,8/10/2011,3,0,8,22,0,3,1,1,0.74,0.6515,0.37,0,17,122,139,122
5234,8/10/2011,3,0,8,23,0,3,1,1,0.74,0.6515,0.37,0.0896,14,94,108,94
5235,8/11/2011,3,0,8,0,0,4,1,1,0.7,0.6364,0.45,0.1045,6,40,46,40
5236,8/11/2011,3,0,8,1,0,4,1,1,0.7,0.6364,0.45,0.1343,9,17,26,17
5237,8/11/2011,3,0,8,2,0,4,1,1,0.66,0.6212,0.54,0.1343,3,8,11,8
5238,8/11/2011,3,0,8,3,0,4,1,1,0.64,0.6212,0.57,0.1343,2,7,9,7
5239,8/11/2011,3,0,8,4,0,4,1,1,0.64,0.6212,0.57,0.1642,1,4,5,4
5240,8/11/2011,3,0,8,5,0,4,1,1,0.64,0.6212,0.61,0.194,2,23,25,23
5241,8/11/2011,3,0,8,6,0,4,1,1,0.62,0.6061,0.65,0.1642,5,101,106,101
5242,8/11/2011,3,0,8,7,0,4,1,1,0.66,0.6212,0.54,0.1343,15,292,307,292
5243,8/11/2011,3,0,8,8,0,4,1,1,0.7,0.6364,0.45,0.1642,29,361,390,361
5244,8/11/2011,3,0,8,9,0,4,1,1,0.72,0.6515,0.39,0.2239,31,166,197,166
5245,8/11/2011,3,0,8,10,0,4,1,1,0.74,0.6515,0.37,0.2537,36,96,132,96
5246,8/11/2011,3,0,8,11,0,4,1,1,0.76,0.6667,0.35,0.2537,59,128,187,128
5247,8/11/2011,3,0,8,12,0,4,1,1,0.78,0.6818,0.31,0.2537,50,164,214,164
5248,8/11/2011,3,0,8,13,0,4,1,1,0.76,0.6667,0.31,0.2239,51,166,217,166
5249,8/11/2011,3,0,8,14,0,4,1,1,0.8,0.697,0.29,0,39,103,142,103
5250,8/11/2011,3,0,8,15,0,4,1,1,0.8,0.697,0.29,0.2985,52,126,178,126
5251,8/11/2011,3,0,8,16,0,4,1,1,0.8,0.697,0.27,0.194,57,241,298,241
5252,8/11/2011,3,0,8,17,0,4,1,1,0.8,0.697,0.29,0.2537,96,486,582,486
5253,8/11/2011,3,0,8,18,0,4,1,1,0.78,0.6818,0.29,0.0896,74,497,571,497
5254,8/11/2011,3,0,8,19,0,4,1,1,0.74,0.6515,0.35,0.194,48,323,371,323
5255,8/11/2011,3,0,8,20,0,4,1,1,0.72,0.6515,0.37,0.1343,56,232,288,232
5256,8/11/2011,3,0,8,21,0,4,1,1,0.7,0.6515,0.48,0.0896,35,171,206,171
5257,8/11/2011,3,0,8,22,0,4,1,1,0.7,0.6515,0.48,0,34,123,157,123
5258,8/11/2011,3,0,8,23,0,4,1,1,0.66,0.6212,0.5,0.1642,22,105,127,105
5259,8/12/2011,3,0,8,0,0,5,1,1,0.64,0.6212,0.53,0.1642,12,53,65,53
5260,8/12/2011,3,0,8,1,0,5,1,1,0.64,0.6212,0.53,0.1343,4,19,23,19
5261,8/12/2011,3,0,8,2,0,5,1,1,0.62,0.6212,0.57,0.194,0,15,15,15
5262,8/12/2011,3,0,8,3,0,5,1,1,0.62,0.6212,0.53,0.1642,0,9,9,9
5263,8/12/2011,3,0,8,4,0,5,1,1,0.62,0.6212,0.53,0.1343,0,5,5,5
5264,8/12/2011,3,0,8,5,0,5,1,1,0.6,0.6212,0.56,0.1343,2,24,26,24
5265,8/12/2011,3,0,8,6,0,5,1,1,0.62,0.6212,0.5,0.1343,3,73,76,73
5266,8/12/2011,3,0,8,7,0,5,1,1,0.64,0.6212,0.44,0.1642,17,247,264,247
5267,8/12/2011,3,0,8,8,0,5,1,1,0.68,0.6364,0.39,0.2239,29,397,426,397
5268,8/12/2011,3,0,8,9,0,5,1,1,0.72,0.6515,0.34,0.1343,27,178,205,178
5269,8/12/2011,3,0,8,10,0,5,1,1,0.74,0.6515,0.33,0.1045,44,86,130,86
5270,8/12/2011,3,0,8,11,0,5,1,1,0.76,0.6667,0.29,0,48,108,156,108
5271,8/12/2011,3,0,8,12,0,5,1,1,0.8,0.697,0.27,0,55,167,222,167
5272,8/12/2011,3,0,8,13,0,5,1,1,0.78,0.6818,0.29,0.0896,74,179,253,179
5273,8/12/2011,3,0,8,14,0,5,1,1,0.8,0.697,0.29,0.194,51,135,186,135
5274,8/12/2011,3,0,8,15,0,5,1,1,0.8,0.697,0.29,0.1642,59,190,249,190
5275,8/12/2011,3,0,8,16,0,5,1,1,0.82,0.7121,0.28,0,68,266,334,266
5276,8/12/2011,3,0,8,17,0,5,1,1,0.82,0.7121,0.26,0,93,423,516,423
5277,8/12/2011,3,0,8,18,0,5,1,1,0.76,0.6818,0.4,0.2985,89,376,465,376
5278,8/12/2011,3,0,8,19,0,5,1,1,0.74,0.6667,0.42,0.2239,101,284,385,284
5279,8/12/2011,3,0,8,20,0,5,1,1,0.72,0.6515,0.42,0.2239,77,210,287,210
5280,8/12/2011,3,0,8,21,0,5,1,1,0.7,0.6515,0.48,0.1343,73,153,226,153
5281,8/12/2011,3,0,8,22,0,5,1,1,0.68,0.6364,0.51,0,74,157,231,157
5282,8/12/2011,3,0,8,23,0,5,1,1,0.68,0.6364,0.51,0,51,100,151,100
5283,8/13/2011,3,0,8,0,0,6,0,1,0.68,0.6364,0.51,0.1045,15,69,84,69
5284,8/13/2011,3,0,8,1,0,6,0,2,0.68,0.6364,0.57,0.0896,13,64,77,64
5285,8/13/2011,3,0,8,2,0,6,0,1,0.68,0.6364,0.57,0,16,58,74,58
5286,8/13/2011,3,0,8,3,0,6,0,1,0.66,0.6212,0.65,0.1343,9,18,27,18
5287,8/13/2011,3,0,8,4,0,6,0,2,0.64,0.6061,0.73,0.1343,5,5,10,5
5288,8/13/2011,3,0,8,5,0,6,0,1,0.64,0.6061,0.73,0.1045,3,15,18,15
5289,8/13/2011,3,0,8,6,0,6,0,1,0.64,0.6061,0.73,0.0896,3,19,22,19
5290,8/13/2011,3,0,8,7,0,6,0,2,0.66,0.6212,0.74,0.194,10,34,44,34
5291,8/13/2011,3,0,8,8,0,6,0,2,0.7,0.6515,0.65,0.1642,28,90,118,90
5292,8/13/2011,3,0,8,9,0,6,0,2,0.7,0.6667,0.74,0.1642,70,138,208,138
5293,8/13/2011,3,0,8,10,0,6,0,2,0.72,0.697,0.74,0.2239,97,163,260,163
5294,8/13/2011,3,0,8,11,0,6,0,2,0.74,0.697,0.7,0.194,122,192,314,192
5295,8/13/2011,3,0,8,12,0,6,0,2,0.66,0.5909,0.89,0.1642,175,246,421,246
5296,8/13/2011,3,0,8,13,0,6,0,2,0.74,0.7121,0.74,0.3284,61,92,153,92
5297,8/13/2011,3,0,8,14,0,6,0,1,0.74,0.697,0.7,0.2537,113,146,259,146
5298,8/13/2011,3,0,8,15,0,6,0,3,0.68,0.6364,0.79,0.3582,150,208,358,208
5299,8/13/2011,3,0,8,16,0,6,0,2,0.7,0.6667,0.74,0.2836,148,133,281,133
5300,8/13/2011,3,0,8,17,0,6,0,2,0.72,0.697,0.74,0.2537,97,172,269,172
5301,8/13/2011,3,0,8,18,0,6,0,1,0.7,0.6667,0.74,0.2239,123,169,292,169
5302,8/13/2011,3,0,8,19,0,6,0,2,0.68,0.6364,0.79,0.2836,67,170,237,170
5303,8/13/2011,3,0,8,20,0,6,0,2,0.68,0.6364,0.83,0.2239,78,105,183,105
5304,8/13/2011,3,0,8,21,0,6,0,2,0.68,0.6364,0.83,0.3881,40,127,167,127
5305,8/13/2011,3,0,8,22,0,6,0,2,0.68,0.6364,0.83,0.3881,36,118,154,118
5306,8/13/2011,3,0,8,23,0,6,0,2,0.66,0.6061,0.83,0.3284,25,95,120,95
5307,8/14/2011,3,0,8,0,0,0,0,3,0.66,0.6061,0.83,0.2985,19,71,90,71
5308,8/14/2011,3,0,8,1,0,0,0,3,0.64,0.5758,0.89,0.2239,16,57,73,57
5309,8/14/2011,3,0,8,2,0,0,0,3,0.64,0.5758,0.89,0.2239,13,49,62,49
5310,8/14/2011,3,0,8,3,0,0,0,2,0.64,0.5606,0.94,0.2537,5,22,27,22
5311,8/14/2011,3,0,8,4,0,0,0,3,0.64,0.5606,0.94,0.194,1,2,3,2
5312,8/14/2011,3,0,8,5,0,0,0,2,0.64,0.5606,0.94,0.1642,1,9,10,9
5313,8/14/2011,3,0,8,6,0,0,0,2,0.64,0.5606,0.94,0.1045,2,4,6,4
5314,8/14/2011,3,0,8,7,0,0,0,2,0.66,0.5909,0.89,0.194,4,20,24,20
5315,8/14/2011,3,0,8,8,0,0,0,2,0.66,0.5909,0.89,0.2836,20,21,41,21
5316,8/14/2011,3,0,8,9,0,0,0,3,0.66,0.5909,0.89,0.2836,27,76,103,76
5317,8/14/2011,3,0,8,10,0,0,0,1,0.7,0.6667,0.79,0.2239,67,116,183,116
5318,8/14/2011,3,0,8,11,0,0,0,1,0.7,0.6667,0.79,0.194,81,117,198,117
5319,8/14/2011,3,0,8,12,0,0,0,2,0.7,0.6667,0.79,0.2239,98,183,281,183
5320,8/14/2011,3,0,8,13,0,0,0,1,0.72,0.697,0.74,0.2537,144,233,377,233
5321,8/14/2011,3,0,8,14,0,0,0,1,0.74,0.697,0.7,0.194,126,244,370,244
5322,8/14/2011,3,0,8,15,0,0,0,1,0.74,0.697,0.66,0.194,128,203,331,203
5323,8/14/2011,3,0,8,16,0,0,0,1,0.74,0.697,0.66,0.1642,116,176,292,176
5324,8/14/2011,3,0,8,17,0,0,0,1,0.76,0.7121,0.62,0.1343,133,196,329,196
5325,8/14/2011,3,0,8,18,0,0,0,1,0.74,0.697,0.66,0.1642,125,222,347,222
5326,8/14/2011,3,0,8,19,0,0,0,1,0.72,0.697,0.74,0.2239,75,184,259,184
5327,8/14/2011,3,0,8,20,0,0,0,1,0.7,0.6667,0.84,0.1642,67,126,193,126
5328,8/14/2011,3,0,8,21,0,0,0,3,0.6,0.5455,0.88,0.4925,51,104,155,104
5329,8/14/2011,3,0,8,22,0,0,0,3,0.6,0.5455,0.88,0.4925,14,25,39,25
5330,8/14/2011,3,0,8,23,0,0,0,3,0.6,0.5606,0.83,0,5,22,27,22
5331,8/15/2011,3,0,8,0,0,1,1,3,0.6,0.5455,0.88,0.0896,7,18,25,18
5332,8/15/2011,3,0,8,1,0,1,1,2,0.6,0.5455,0.88,0.1343,1,9,10,9
5333,8/15/2011,3,0,8,2,0,1,1,2,0.6,0.5606,0.83,0,0,3,3,3
5334,8/15/2011,3,0,8,3,0,1,1,1,0.6,0.5606,0.83,0.194,1,6,7,6
5335,8/15/2011,3,0,8,4,0,1,1,1,0.6,0.5606,0.83,0.1343,1,4,5,4
5336,8/15/2011,3,0,8,5,0,1,1,2,0.6,0.5455,0.88,0.194,3,14,17,14
5337,8/15/2011,3,0,8,6,0,1,1,1,0.6,0.5455,0.88,0.2537,3,87,90,87
5338,8/15/2011,3,0,8,7,0,1,1,1,0.6,0.5455,0.88,0.2537,10,248,258,248
5339,8/15/2011,3,0,8,8,0,1,1,1,0.64,0.5909,0.78,0.3284,29,326,355,326
5340,8/15/2011,3,0,8,9,0,1,1,1,0.64,0.5909,0.78,0.3284,52,170,222,170
5341,8/15/2011,3,0,8,10,0,1,1,1,0.68,0.6364,0.69,0.2836,54,87,141,87
5342,8/15/2011,3,0,8,11,0,1,1,2,0.72,0.6818,0.62,0.2537,41,112,153,112
5343,8/15/2011,3,0,8,12,0,1,1,1,0.74,0.6818,0.58,0.2836,62,116,178,116
5344,8/15/2011,3,0,8,13,0,1,1,1,0.78,0.7121,0.52,0.2836,53,140,193,140
5345,8/15/2011,3,0,8,14,0,1,1,1,0.74,0.6818,0.55,0.0896,56,95,151,95
5346,8/15/2011,3,0,8,15,0,1,1,3,0.74,0.6818,0.55,0.2985,49,133,182,133
5347,8/15/2011,3,0,8,16,0,1,1,1,0.74,0.6818,0.55,0.3284,58,225,283,225
5348,8/15/2011,3,0,8,17,0,1,1,1,0.74,0.6667,0.51,0.2836,59,471,530,471
5349,8/15/2011,3,0,8,18,0,1,1,1,0.7,0.6515,0.65,0.194,70,413,483,413
5350,8/15/2011,3,0,8,19,0,1,1,1,0.7,0.6515,0.65,0,54,343,397,343
5351,8/15/2011,3,0,8,20,0,1,1,1,0.66,0.6212,0.74,0.1343,45,240,285,240
5352,8/15/2011,3,0,8,21,0,1,1,1,0.66,0.6212,0.65,0.194,34,150,184,150
5353,8/15/2011,3,0,8,22,0,1,1,1,0.66,0.6212,0.69,0.2537,22,76,98,76
5354,8/15/2011,3,0,8,23,0,1,1,1,0.64,0.6061,0.69,0.2239,11,77,88,77
5355,8/16/2011,3,0,8,0,0,2,1,1,0.64,0.6061,0.69,0.1045,8,23,31,23
5356,8/16/2011,3,0,8,1,0,2,1,1,0.64,0.6061,0.69,0.1642,4,12,16,12
5357,8/16/2011,3,0,8,2,0,2,1,1,0.62,0.5909,0.73,0.2239,1,3,4,3
5358,8/16/2011,3,0,8,3,0,2,1,1,0.62,0.5909,0.73,0.2239,1,5,6,5
5359,8/16/2011,3,0,8,4,0,2,1,1,0.64,0.6061,0.69,0.2985,0,5,5,5
5360,8/16/2011,3,0,8,5,0,2,1,1,0.62,0.5909,0.73,0.2836,1,29,30,29
5361,8/16/2011,3,0,8,6,0,2,1,1,0.62,0.5909,0.73,0.3284,4,115,119,115
5362,8/16/2011,3,0,8,7,0,2,1,1,0.64,0.6061,0.69,0.2537,18,328,346,328
5363,8/16/2011,3,0,8,8,0,2,1,1,0.7,0.6515,0.58,0.4478,24,417,441,417
5364,8/16/2011,3,0,8,9,0,2,1,1,0.68,0.6364,0.61,0.2836,27,171,198,171
5365,8/16/2011,3,0,8,10,0,2,1,1,0.7,0.6515,0.58,0.3881,28,83,111,83
5366,8/16/2011,3,0,8,11,0,2,1,1,0.74,0.6667,0.51,0.2239,40,110,150,110
5367,8/16/2011,3,0,8,12,0,2,1,1,0.76,0.6818,0.48,0.3284,42,120,162,120
5368,8/16/2011,3,0,8,13,0,2,1,1,0.76,0.6818,0.48,0.2985,45,147,192,147
5369,8/16/2011,3,0,8,14,0,2,1,1,0.76,0.6818,0.45,0.4179,65,117,182,117
5370,8/16/2011,3,0,8,15,0,2,1,1,0.8,0.7121,0.41,0.2985,36,123,159,123
5371,8/16/2011,3,0,8,16,0,2,1,1,0.8,0.7121,0.41,0.2239,55,248,303,248
5372,8/16/2011,3,0,8,17,0,2,1,1,0.76,0.6818,0.45,0.3284,75,525,600,525
5373,8/16/2011,3,0,8,18,0,2,1,1,0.76,0.6818,0.45,0.2239,54,516,570,516
5374,8/16/2011,3,0,8,19,0,2,1,1,0.74,0.6667,0.48,0.194,56,320,376,320
5375,8/16/2011,3,0,8,20,0,2,1,1,0.74,0.6667,0.51,0,48,232,280,232
5376,8/16/2011,3,0,8,21,0,2,1,1,0.72,0.6667,0.54,0,38,177,215,177
5377,8/16/2011,3,0,8,22,0,2,1,1,0.7,0.6515,0.61,0,31,121,152,121
5378,8/16/2011,3,0,8,23,0,2,1,1,0.66,0.6212,0.65,0.1343,20,57,77,57
5379,8/17/2011,3,0,8,0,0,3,1,1,0.66,0.6212,0.69,0.0896,8,16,24,16
5380,8/17/2011,3,0,8,1,0,3,1,1,0.64,0.6061,0.73,0.1642,2,12,14,12
5381,8/17/2011,3,0,8,2,0,3,1,1,0.66,0.6212,0.69,0,0,6,6,6
5382,8/17/2011,3,0,8,3,0,3,1,1,0.64,0.5909,0.78,0,1,4,5,4
5383,8/17/2011,3,0,8,4,0,3,1,1,0.64,0.6061,0.73,0,0,5,5,5
5384,8/17/2011,3,0,8,5,0,3,1,1,0.64,0.6061,0.73,0,0,28,28,28
5385,8/17/2011,3,0,8,6,0,3,1,1,0.62,0.5909,0.78,0,4,101,105,101
5386,8/17/2011,3,0,8,7,0,3,1,1,0.66,0.6212,0.65,0.0896,12,296,308,296
5387,8/17/2011,3,0,8,8,0,3,1,1,0.7,0.6515,0.54,0.1642,35,452,487,452
5388,8/17/2011,3,0,8,9,0,3,1,1,0.74,0.6667,0.48,0.0896,31,178,209,178
5389,8/17/2011,3,0,8,10,0,3,1,1,0.76,0.6818,0.43,0.0896,27,91,118,91
5390,8/17/2011,3,0,8,11,0,3,1,1,0.78,0.697,0.43,0.1045,20,108,128,108
5391,8/17/2011,3,0,8,12,0,3,1,1,0.8,0.7273,0.43,0.2836,26,163,189,163
5392,8/17/2011,3,0,8,13,0,3,1,1,0.8,0.7121,0.41,0.194,38,138,176,138
5393,8/17/2011,3,0,8,14,0,3,1,1,0.82,0.7273,0.36,0.1642,54,138,192,138
5394,8/17/2011,3,0,8,15,0,3,1,1,0.8,0.7273,0.43,0.1343,42,117,159,117
5395,8/17/2011,3,0,8,16,0,3,1,1,0.82,0.7424,0.43,0.2239,62,238,300,238
5396,8/17/2011,3,0,8,17,0,3,1,1,0.8,0.7424,0.49,0.2239,46,506,552,506
5397,8/17/2011,3,0,8,18,0,3,1,1,0.76,0.697,0.55,0.2537,86,470,556,470
5398,8/17/2011,3,0,8,19,0,3,1,1,0.76,0.697,0.55,0.2239,50,297,347,297
5399,8/17/2011,3,0,8,20,0,3,1,1,0.74,0.6818,0.58,0.2537,37,243,280,243
5400,8/17/2011,3,0,8,21,0,3,1,1,0.72,0.6818,0.62,0.2239,38,192,230,192
5401,8/17/2011,3,0,8,22,0,3,1,1,0.7,0.6515,0.65,0.194,29,142,171,142
5402,8/17/2011,3,0,8,23,0,3,1,1,0.7,0.6515,0.65,0.2836,20,85,105,85
5403,8/18/2011,3,0,8,0,0,4,1,1,0.68,0.6364,0.65,0.1343,18,38,56,38
5404,8/18/2011,3,0,8,1,0,4,1,2,0.66,0.6212,0.65,0.1642,13,11,24,11
5405,8/18/2011,3,0,8,2,0,4,1,1,0.66,0.6212,0.65,0.2239,2,4,6,4
5406,8/18/2011,3,0,8,3,0,4,1,1,0.66,0.6212,0.69,0.2836,0,6,6,6
5407,8/18/2011,3,0,8,4,0,4,1,1,0.64,0.6061,0.73,0.2239,0,9,9,9
5408,8/18/2011,3,0,8,5,0,4,1,1,0.64,0.5909,0.78,0.2836,0,27,27,27
5409,8/18/2011,3,0,8,6,0,4,1,2,0.64,0.5909,0.78,0.2537,6,97,103,97
5410,8/18/2011,3,0,8,7,0,4,1,1,0.64,0.5909,0.78,0.2985,19,289,308,289
5411,8/18/2011,3,0,8,8,0,4,1,1,0.66,0.6212,0.74,0.2836,27,393,420,393
5412,8/18/2011,3,0,8,9,0,4,1,1,0.72,0.6818,0.66,0.2537,42,186,228,186
5413,8/18/2011,3,0,8,10,0,4,1,1,0.74,0.697,0.66,0.2537,37,92,129,92
5414,8/18/2011,3,0,8,11,0,4,1,1,0.76,0.7121,0.58,0.2537,44,97,141,97
5415,8/18/2011,3,0,8,12,0,4,1,1,0.8,0.7424,0.52,0.2836,34,139,173,139
5416,8/18/2011,3,0,8,13,0,4,1,1,0.8,0.7424,0.52,0.3582,33,154,187,154
5417,8/18/2011,3,0,8,14,0,4,1,1,0.82,0.7576,0.46,0.3284,67,115,182,115
5418,8/18/2011,3,0,8,15,0,4,1,1,0.8,0.7273,0.46,0.3582,56,118,174,118
5419,8/18/2011,3,0,8,16,0,4,1,1,0.8,0.7273,0.46,0.3582,49,196,245,196
5420,8/18/2011,3,0,8,17,0,4,1,3,0.8,0.7273,0.46,0.2985,44,365,409,365
5421,8/18/2011,3,0,8,18,0,4,1,3,0.76,0.697,0.55,0.2537,48,226,274,226
5422,8/18/2011,3,0,8,19,0,4,1,1,0.66,0.6061,0.83,0.1045,26,115,141,115
5423,8/18/2011,3,0,8,20,0,4,1,1,0.66,0.6061,0.83,0.1045,24,141,165,141
5424,8/18/2011,3,0,8,21,0,4,1,2,0.68,0.6364,0.79,0,12,137,149,137
5425,8/18/2011,3,0,8,22,0,4,1,2,0.7,0.6667,0.74,0.1045,18,117,135,117
5426,8/18/2011,3,0,8,23,0,4,1,2,0.7,0.6667,0.74,0.1343,20,94,114,94
5427,8/19/2011,3,0,8,0,0,5,1,3,0.68,0.6364,0.69,0.194,9,53,62,53
5428,8/19/2011,3,0,8,1,0,5,1,3,0.64,0.5758,0.89,0,1,19,20,19
5429,8/19/2011,3,0,8,2,0,5,1,3,0.64,0.5758,0.83,0,0,8,8,8
5430,8/19/2011,3,0,8,3,0,5,1,1,0.64,0.5909,0.78,0,2,1,3,1
5431,8/19/2011,3,0,8,4,0,5,1,1,0.64,0.5758,0.83,0,1,7,8,7
5432,8/19/2011,3,0,8,5,0,5,1,1,0.64,0.5758,0.83,0,1,16,17,16
5433,8/19/2011,3,0,8,6,0,5,1,1,0.64,0.5758,0.83,0,2,91,93,91
5434,8/19/2011,3,0,8,7,0,5,1,2,0.66,0.6061,0.83,0.0896,12,251,263,251
5435,8/19/2011,3,0,8,8,0,5,1,2,0.66,0.6061,0.83,0,30,368,398,368
5436,8/19/2011,3,0,8,9,0,5,1,1,0.7,0.6515,0.65,0.1343,31,187,218,187
5437,8/19/2011,3,0,8,10,0,5,1,1,0.72,0.6818,0.62,0.0896,57,108,165,108
5438,8/19/2011,3,0,8,11,0,5,1,2,0.72,0.6818,0.66,0.0896,45,120,165,120
5439,8/19/2011,3,0,8,12,0,5,1,2,0.74,0.6818,0.62,0.0896,54,168,222,168
5440,8/19/2011,3,0,8,13,0,5,1,2,0.76,0.7121,0.62,0.194,63,169,232,169
5441,8/19/2011,3,0,8,14,0,5,1,1,0.78,0.7273,0.55,0.194,78,142,220,142
5442,8/19/2011,3,0,8,15,0,5,1,1,0.8,0.7424,0.49,0.1045,66,156,222,156
5443,8/19/2011,3,0,8,16,0,5,1,1,0.8,0.7424,0.49,0,66,261,327,261
5444,8/19/2011,3,0,8,17,0,5,1,1,0.76,0.7121,0.58,0.5224,85,442,527,442
5445,8/19/2011,3,0,8,18,0,5,1,1,0.76,0.7121,0.58,0.5224,88,337,425,337
5446,8/19/2011,3,0,8,19,0,5,1,3,0.62,0.5909,0.73,0.4627,33,132,165,132
5447,8/19/2011,3,0,8,20,0,5,1,3,0.62,0.5758,0.83,0.2985,12,46,58,46
5448,8/19/2011,3,0,8,21,0,5,1,1,0.62,0.5758,0.83,0.1343,18,89,107,89
5449,8/19/2011,3,0,8,22,0,5,1,1,0.6,0.5455,0.88,0.1343,25,97,122,97
5450,8/19/2011,3,0,8,23,0,5,1,2,0.6,0.5455,0.88,0.0896,18,88,106,88
5451,8/20/2011,3,0,8,0,0,6,0,1,0.6,0.5455,0.88,0,21,107,128,107
5452,8/20/2011,3,0,8,1,0,6,0,1,0.62,0.5758,0.83,0,12,35,47,35
5453,8/20/2011,3,0,8,2,0,6,0,1,0.62,0.5909,0.78,0,10,59,69,59
5454,8/20/2011,3,0,8,3,0,6,0,1,0.62,0.5909,0.78,0,9,42,51,42
5455,8/20/2011,3,0,8,4,0,6,0,2,0.6,0.5455,0.88,0,1,6,7,6
5456,8/20/2011,3,0,8,5,0,6,0,1,0.6,0.5606,0.83,0,0,8,8,8
5457,8/20/2011,3,0,8,6,0,6,0,2,0.6,0.5606,0.83,0.1343,6,18,24,18
5458,8/20/2011,3,0,8,7,0,6,0,1,0.62,0.5758,0.83,0,8,36,44,36
5459,8/20/2011,3,0,8,8,0,6,0,1,0.66,0.6212,0.69,0,27,106,133,106
5460,8/20/2011,3,0,8,9,0,6,0,1,0.7,0.6515,0.65,0,51,139,190,139
5461,8/20/2011,3,0,8,10,0,6,0,1,0.72,0.6818,0.62,0.1045,114,192,306,192
5462,8/20/2011,3,0,8,11,0,6,0,1,0.72,0.6667,0.58,0,115,223,338,223
5463,8/20/2011,3,0,8,12,0,6,0,1,0.74,0.6818,0.58,0.1343,156,253,409,253
5464,8/20/2011,3,0,8,13,0,6,0,1,0.76,0.697,0.55,0.1343,158,220,378,220
5465,8/20/2011,3,0,8,14,0,6,0,1,0.8,0.7424,0.49,0.194,147,228,375,228
5466,8/20/2011,3,0,8,15,0,6,0,1,0.8,0.7273,0.43,0.194,175,215,390,215
5467,8/20/2011,3,0,8,16,0,6,0,1,0.8,0.7273,0.46,0.194,151,222,373,222
5468,8/20/2011,3,0,8,17,0,6,0,1,0.8,0.7424,0.49,0.194,180,203,383,203
5469,8/20/2011,3,0,8,18,0,6,0,1,0.76,0.7121,0.58,0.2537,169,225,394,225
5470,8/20/2011,3,0,8,19,0,6,0,1,0.74,0.6818,0.62,0.194,109,182,291,182
5471,8/20/2011,3,0,8,20,0,6,0,1,0.74,0.6818,0.62,0.2239,78,170,248,170
5472,8/20/2011,3,0,8,21,0,6,0,1,0.72,0.6818,0.7,0.2239,81,144,225,144
5473,8/20/2011,3,0,8,22,0,6,0,2,0.7,0.6667,0.74,0.194,77,146,223,146
5474,8/20/2011,3,0,8,23,0,6,0,1,0.7,0.6667,0.74,0.1343,59,98,157,98
5475,8/21/2011,3,0,8,0,0,0,0,1,0.7,0.6667,0.74,0.194,6,68,74,68
5476,8/21/2011,3,0,8,1,0,0,0,1,0.68,0.6364,0.79,0.2239,17,69,86,69
5477,8/21/2011,3,0,8,2,0,0,0,1,0.68,0.6364,0.79,0.194,13,51,64,51
5478,8/21/2011,3,0,8,3,0,0,0,1,0.66,0.6061,0.83,0.2239,25,26,51,26
5479,8/21/2011,3,0,8,4,0,0,0,1,0.68,0.6364,0.83,0.2239,1,5,6,5
5480,8/21/2011,3,0,8,5,0,0,0,1,0.66,0.5909,0.89,0.2985,0,8,8,8
5481,8/21/2011,3,0,8,6,0,0,0,1,0.66,0.5909,0.89,0.2836,4,10,14,10
5482,8/21/2011,3,0,8,7,0,0,0,1,0.68,0.6364,0.83,0.2985,12,19,31,19
5483,8/21/2011,3,0,8,8,0,0,0,1,0.7,0.6667,0.79,0.2239,30,62,92,62
5484,8/21/2011,3,0,8,9,0,0,0,1,0.72,0.697,0.74,0.2239,80,151,231,151
5485,8/21/2011,3,0,8,10,0,0,0,1,0.74,0.7121,0.74,0.2537,97,177,274,177
5486,8/21/2011,3,0,8,11,0,0,0,1,0.8,0.7879,0.63,0.2836,132,181,313,181
5487,8/21/2011,3,0,8,12,0,0,0,1,0.82,0.803,0.59,0.2836,135,239,374,239
5488,8/21/2011,3,0,8,13,0,0,0,1,0.8,0.7727,0.59,0.4179,94,216,310,216
5489,8/21/2011,3,0,8,14,0,0,0,3,0.7,0.6667,0.79,0.3881,78,157,235,157
5490,8/21/2011,3,0,8,15,0,0,0,1,0.7,0.6667,0.84,0.2836,17,51,68,51
5491,8/21/2011,3,0,8,16,0,0,0,1,0.72,0.697,0.79,0.1642,97,161,258,161
5492,8/21/2011,3,0,8,17,0,0,0,1,0.72,0.697,0.79,0.1343,91,179,270,179
5493,8/21/2011,3,0,8,18,0,0,0,1,0.72,0.697,0.79,0.2537,96,215,311,215
5494,8/21/2011,3,0,8,19,0,0,0,1,0.72,0.6818,0.7,0.2537,81,201,282,201
5495,8/21/2011,3,0,8,20,0,0,0,1,0.7,0.6667,0.79,0.2537,41,140,181,140
5496,8/21/2011,3,0,8,21,0,0,0,1,0.7,0.6667,0.79,0.2537,45,93,138,93
5497,8/21/2011,3,0,8,22,0,0,0,2,0.7,0.6667,0.79,0.194,37,97,134,97
5498,8/21/2011,3,0,8,23,0,0,0,1,0.7,0.6667,0.74,0.1642,20,48,68,48
5499,8/22/2011,3,0,8,0,0,1,1,1,0.68,0.6364,0.79,0.1642,18,22,40,22
5500,8/22/2011,3,0,8,1,0,1,1,1,0.68,0.6364,0.79,0.0896,8,13,21,13
5501,8/22/2011,3,0,8,2,0,1,1,2,0.7,0.6515,0.65,0.1045,2,6,8,6
5502,8/22/2011,3,0,8,3,0,1,1,3,0.7,0.6515,0.65,0.1343,0,5,5,5
5503,8/22/2011,3,0,8,4,0,1,1,1,0.68,0.6364,0.65,0.194,2,10,12,10
5504,8/22/2011,3,0,8,5,0,1,1,1,0.66,0.6212,0.65,0.3582,1,23,24,23
5505,8/22/2011,3,0,8,6,0,1,1,1,0.66,0.6212,0.61,0.2985,6,106,112,106
5506,8/22/2011,3,0,8,7,0,1,1,1,0.66,0.6212,0.61,0.3284,11,270,281,270
5507,8/22/2011,3,0,8,8,0,1,1,1,0.66,0.6212,0.61,0.3284,20,331,351,331
5508,8/22/2011,3,0,8,9,0,1,1,1,0.68,0.6364,0.54,0.2537,36,151,187,151
5509,8/22/2011,3,0,8,10,0,1,1,1,0.7,0.6515,0.48,0.2836,36,85,121,85
5510,8/22/2011,3,0,8,11,0,1,1,1,0.72,0.6515,0.34,0.3284,46,85,131,85
5511,8/22/2011,3,0,8,12,0,1,1,1,0.74,0.6515,0.35,0.3881,54,153,207,153
5512,8/22/2011,3,0,8,13,0,1,1,1,0.74,0.6515,0.3,0.4627,47,158,205,158
5513,8/22/2011,3,0,8,14,0,1,1,1,0.74,0.6515,0.3,0.3881,88,137,225,137
5514,8/22/2011,3,0,8,15,0,1,1,1,0.74,0.6515,0.3,0.2985,72,127,199,127
5515,8/22/2011,3,0,8,16,0,1,1,1,0.74,0.6515,0.3,0.3881,66,254,320,254
5516,8/22/2011,3,0,8,17,0,1,1,1,0.74,0.6515,0.27,0.3284,82,509,591,509
5517,8/22/2011,3,0,8,18,0,1,1,1,0.72,0.6515,0.28,0.2985,72,537,609,537
5518,8/22/2011,3,0,8,19,0,1,1,1,0.7,0.6364,0.3,0.2836,66,350,416,350
5519,8/22/2011,3,0,8,20,0,1,1,1,0.66,0.6212,0.34,0.194,21,247,268,247
5520,8/22/2011,3,0,8,21,0,1,1,1,0.64,0.6212,0.38,0.194,28,180,208,180
5521,8/22/2011,3,0,8,22,0,1,1,1,0.64,0.6212,0.38,0.2985,32,121,153,121
5522,8/22/2011,3,0,8,23,0,1,1,1,0.62,0.6212,0.41,0.2537,19,45,64,45
5523,8/23/2011,3,0,8,0,0,2,1,1,0.6,0.6212,0.43,0.194,13,22,35,22
5524,8/23/2011,3,0,8,1,0,2,1,1,0.58,0.5455,0.49,0.194,6,13,19,13
5525,8/23/2011,3,0,8,2,0,2,1,1,0.56,0.5303,0.52,0.194,2,4,6,4
5526,8/23/2011,3,0,8,3,0,2,1,1,0.56,0.5303,0.52,0.2836,2,4,6,4
5527,8/23/2011,3,0,8,4,0,2,1,1,0.54,0.5152,0.56,0.1642,0,5,5,5
5528,8/23/2011,3,0,8,5,0,2,1,1,0.54,0.5152,0.56,0.194,1,35,36,35
5529,8/23/2011,3,0,8,6,0,2,1,1,0.54,0.5152,0.6,0.194,3,111,114,111
5530,8/23/2011,3,0,8,7,0,2,1,1,0.6,0.6212,0.49,0.194,11,333,344,333
5531,8/23/2011,3,0,8,8,0,2,1,2,0.62,0.6212,0.5,0,43,461,504,461
5532,8/23/2011,3,0,8,9,0,2,1,2,0.66,0.6212,0.44,0,34,191,225,191
5533,8/23/2011,3,0,8,10,0,2,1,1,0.7,0.6364,0.37,0,56,92,148,92
5534,8/23/2011,3,0,8,11,0,2,1,1,0.7,0.6364,0.34,0.1045,62,124,186,124
5535,8/23/2011,3,0,8,12,0,2,1,1,0.7,0.6364,0.39,0.0896,60,177,237,177
5536,8/23/2011,3,0,8,13,0,2,1,1,0.72,0.6515,0.3,0.1045,70,164,234,164
5537,8/23/2011,3,0,8,14,0,2,1,1,0.72,0.6515,0.3,0.0896,149,502,651,502
5538,8/23/2011,3,0,8,15,0,2,1,1,0.72,0.6515,0.34,0.2239,178,423,601,423
5539,8/23/2011,3,0,8,16,0,2,1,1,0.72,0.6515,0.32,0.1343,133,311,444,311
5540,8/23/2011,3,0,8,17,0,2,1,1,0.72,0.6515,0.34,0.2239,133,339,472,339
5541,8/23/2011,3,0,8,18,0,2,1,1,0.72,0.6515,0.34,0.194,98,421,519,421
5542,8/23/2011,3,0,8,19,0,2,1,1,0.66,0.6212,0.5,0.2239,70,297,367,297
5543,8/23/2011,3,0,8,20,0,2,1,1,0.64,0.6212,0.53,0.2537,54,206,260,206
5544,8/23/2011,3,0,8,21,0,2,1,1,0.62,0.6212,0.57,0,38,173,211,173
5545,8/23/2011,3,0,8,22,0,2,1,1,0.62,0.6212,0.57,0.1343,46,145,191,145
5546,8/23/2011,3,0,8,23,0,2,1,1,0.62,0.6061,0.61,0.1343,19,61,80,61
5547,8/24/2011,3,0,8,0,0,3,1,1,0.62,0.6212,0.57,0.1343,9,29,38,29
5548,8/24/2011,3,0,8,1,0,3,1,1,0.6,0.6061,0.6,0.1045,7,17,24,17
5549,8/24/2011,3,0,8,2,0,3,1,1,0.58,0.5455,0.68,0.1343,2,4,6,4
5550,8/24/2011,3,0,8,3,0,3,1,1,0.58,0.5455,0.68,0.1343,0,1,1,1
5551,8/24/2011,3,0,8,4,0,3,1,1,0.56,0.5303,0.73,0.1045,0,7,7,7
5552,8/24/2011,3,0,8,5,0,3,1,1,0.56,0.5303,0.73,0.1045,1,26,27,26
5553,8/24/2011,3,0,8,6,0,3,1,1,0.56,0.5303,0.73,0,3,105,108,105
5554,8/24/2011,3,0,8,7,0,3,1,1,0.6,0.6061,0.64,0.0896,11,297,308,297
5555,8/24/2011,3,0,8,8,0,3,1,1,0.62,0.6061,0.69,0.1343,32,436,468,436
5556,8/24/2011,3,0,8,9,0,3,1,1,0.64,0.6061,0.69,0.2537,44,169,213,169
5557,8/24/2011,3,0,8,10,0,3,1,1,0.7,0.6515,0.58,0.2836,51,95,146,95
5558,8/24/2011,3,0,8,11,0,3,1,1,0.72,0.6667,0.54,0.2985,57,128,185,128
5559,8/24/2011,3,0,8,12,0,3,1,1,0.74,0.6818,0.55,0.3284,60,175,235,175
5560,8/24/2011,3,0,8,13,0,3,1,1,0.76,0.6818,0.48,0.4179,56,180,236,180
5561,8/24/2011,3,0,8,14,0,3,1,1,0.76,0.6818,0.48,0.4179,77,127,204,127
5562,8/24/2011,3,0,8,15,0,3,1,1,0.76,0.6818,0.48,0.4478,63,141,204,141
5563,8/24/2011,3,0,8,16,0,3,1,1,0.76,0.697,0.52,0.4179,49,222,271,222
5564,8/24/2011,3,0,8,17,0,3,1,1,0.76,0.697,0.52,0.3582,83,484,567,484
5565,8/24/2011,3,0,8,18,0,3,1,1,0.74,0.6818,0.55,0.2985,102,519,621,519
5566,8/24/2011,3,0,8,19,0,3,1,1,0.74,0.6818,0.55,0.2985,93,347,440,347
5567,8/24/2011,3,0,8,20,0,3,1,1,0.72,0.6667,0.58,0.2985,45,289,334,289
5568,8/24/2011,3,0,8,21,0,3,1,1,0.7,0.6515,0.61,0.3582,47,189,236,189
5569,8/24/2011,3,0,8,22,0,3,1,1,0.7,0.6515,0.65,0.3582,41,140,181,140
5570,8/24/2011,3,0,8,23,0,3,1,1,0.68,0.6364,0.69,0.2985,16,54,70,54
5571,8/25/2011,3,0,8,0,0,4,1,1,0.68,0.6364,0.74,0.2985,11,41,52,41
5572,8/25/2011,3,0,8,1,0,4,1,1,0.68,0.6364,0.69,0.3881,4,11,15,11
5573,8/25/2011,3,0,8,2,0,4,1,1,0.68,0.6364,0.69,0.3881,3,2,5,2
5574,8/25/2011,3,0,8,3,0,4,1,1,0.66,0.6212,0.74,0.3284,2,2,4,2
5575,8/25/2011,3,0,8,4,0,4,1,1,0.66,0.6061,0.78,0.3881,1,6,7,6
5576,8/25/2011,3,0,8,5,0,4,1,1,0.66,0.6061,0.83,0.4179,1,25,26,25
5577,8/25/2011,3,0,8,6,0,4,1,1,0.66,0.6061,0.83,0.3284,1,101,102,101
5578,8/25/2011,3,0,8,7,0,4,1,2,0.68,0.6364,0.79,0.3284,17,296,313,296
5579,8/25/2011,3,0,8,8,0,4,1,2,0.7,0.6667,0.74,0.2985,23,461,484,461
5580,8/25/2011,3,0,8,9,0,4,1,2,0.72,0.6818,0.7,0.2985,21,141,162,141
5581,8/25/2011,3,0,8,10,0,4,1,2,0.74,0.697,0.66,0.2985,37,105,142,105
5582,8/25/2011,3,0,8,11,0,4,1,3,0.7,0.6667,0.79,0,39,112,151,112
5583,8/25/2011,3,0,8,12,0,4,1,3,0.7,0.6667,0.79,0,9,32,41,32
5584,8/25/2011,3,0,8,13,0,4,1,1,0.7,0.6667,0.79,0.1045,7,30,37,30
5585,8/25/2011,3,0,8,14,0,4,1,2,0.72,0.697,0.74,0,27,86,113,86
5586,8/25/2011,3,0,8,15,0,4,1,2,0.74,0.697,0.7,0,28,104,132,104
5587,8/25/2011,3,0,8,16,0,4,1,1,0.72,0.7121,0.84,0,16,105,121,105
5588,8/25/2011,3,0,8,17,0,4,1,1,0.72,0.7121,0.84,0,28,284,312,284
5589,8/25/2011,3,0,8,18,0,4,1,2,0.72,0.7121,0.84,0.1343,31,377,408,377
5590,8/25/2011,3,0,8,19,0,4,1,2,0.66,0.6061,0.78,0.3284,31,241,272,241
5591,8/25/2011,3,0,8,20,0,4,1,1,0.64,0.5909,0.78,0.3582,33,192,225,192
5592,8/25/2011,3,0,8,21,0,4,1,1,0.64,0.5909,0.78,0.2836,29,158,187,158
5593,8/25/2011,3,0,8,22,0,4,1,1,0.62,0.5758,0.83,0,21,126,147,126
5594,8/25/2011,3,0,8,23,0,4,1,1,0.62,0.5758,0.83,0.0896,15,69,84,69
5595,8/26/2011,3,0,8,0,0,5,1,1,0.62,0.5758,0.83,0.1343,9,42,51,42
5596,8/26/2011,3,0,8,1,0,5,1,1,0.62,0.5758,0.83,0,10,13,23,13
5597,8/26/2011,3,0,8,2,0,5,1,1,0.62,0.5606,0.88,0.1343,4,16,20,16
5598,8/26/2011,3,0,8,3,0,5,1,1,0.6,0.5455,0.88,0.1045,3,8,11,8
5599,8/26/2011,3,0,8,4,0,5,1,1,0.62,0.5606,0.88,0,2,6,8,6
5600,8/26/2011,3,0,8,5,0,5,1,2,0.62,0.5606,0.88,0,3,23,26,23
5601,8/26/2011,3,0,8,6,0,5,1,1,0.62,0.5606,0.88,0,5,100,105,100
5602,8/26/2011,3,0,8,7,0,5,1,1,0.64,0.5758,0.83,0,3,263,266,263
5603,8/26/2011,3,0,8,8,0,5,1,1,0.66,0.6061,0.83,0.1045,17,387,404,387
5604,8/26/2011,3,0,8,9,0,5,1,1,0.7,0.6667,0.74,0,39,191,230,191
5605,8/26/2011,3,0,8,10,0,5,1,1,0.74,0.697,0.66,0.0896,34,89,123,89
5606,8/26/2011,3,0,8,11,0,5,1,2,0.76,0.7121,0.62,0,63,151,214,151
5607,8/26/2011,3,0,8,12,0,5,1,2,0.76,0.7273,0.66,0.1045,70,173,243,173
5608,8/26/2011,3,0,8,13,0,5,1,2,0.78,0.7424,0.59,0.1045,72,165,237,165
5609,8/26/2011,3,0,8,14,0,5,1,1,0.8,0.7727,0.59,0,55,164,219,164
5610,8/26/2011,3,0,8,15,0,5,1,2,0.8,0.7727,0.59,0.194,53,196,249,196
5611,8/26/2011,3,0,8,16,0,5,1,1,0.78,0.7424,0.62,0.1045,50,293,343,293
5612,8/26/2011,3,0,8,17,0,5,1,1,0.74,0.7121,0.74,0.2537,56,433,489,433
5613,8/26/2011,3,0,8,18,0,5,1,2,0.74,0.7121,0.74,0.1343,40,370,410,370
5614,8/26/2011,3,0,8,19,0,5,1,1,0.72,0.697,0.79,0.1045,55,235,290,235
5615,8/26/2011,3,0,8,20,0,5,1,1,0.72,0.697,0.79,0.0896,39,183,222,183
5616,8/26/2011,3,0,8,21,0,5,1,1,0.72,0.697,0.79,0.1642,38,152,190,152
5617,8/26/2011,3,0,8,22,0,5,1,1,0.72,0.697,0.79,0.1045,26,126,152,126
5618,8/26/2011,3,0,8,23,0,5,1,1,0.7,0.6667,0.84,0.0896,22,114,136,114
5619,8/27/2011,3,0,8,0,0,6,0,1,0.7,0.6667,0.84,0.1045,33,112,145,112
5620,8/27/2011,3,0,8,1,0,6,0,1,0.7,0.6667,0.84,0.1642,13,51,64,51
5621,8/27/2011,3,0,8,2,0,6,0,1,0.7,0.6667,0.84,0.194,18,59,77,59
5622,8/27/2011,3,0,8,3,0,6,0,2,0.7,0.6667,0.84,0.2239,8,22,30,22
5623,8/27/2011,3,0,8,4,0,6,0,2,0.7,0.6667,0.84,0.2239,1,3,4,3
5624,8/27/2011,3,0,8,5,0,6,0,2,0.7,0.6667,0.84,0.2985,1,11,12,11
5625,8/27/2011,3,0,8,6,0,6,0,2,0.7,0.6667,0.84,0.2985,3,15,18,15
5626,8/27/2011,3,0,8,7,0,6,0,2,0.7,0.6667,0.84,0.3582,2,26,28,26
5627,8/27/2011,3,0,8,8,0,6,0,2,0.7,0.6667,0.84,0.2537,14,62,76,62
5628,8/27/2011,3,0,8,9,0,6,0,2,0.7,0.6667,0.84,0.4179,28,128,156,128
5629,8/27/2011,3,0,8,10,0,6,0,2,0.7,0.6667,0.79,0.4627,51,154,205,154
5630,8/27/2011,3,0,8,11,0,6,0,3,0.66,0.5909,0.89,0.4179,15,73,88,73
5631,8/27/2011,3,0,8,12,0,6,0,3,0.66,0.6061,0.83,0.4925,11,65,76,65
5632,8/27/2011,3,0,8,13,0,6,0,3,0.66,0.6061,0.83,0.3881,10,33,43,33
5633,8/27/2011,3,0,8,14,0,6,0,3,0.64,0.5758,0.89,0.5522,4,19,23,19
5634,8/27/2011,3,0,8,15,0,6,0,3,0.64,0.5758,0.89,0.5522,2,28,30,28
5635,8/27/2011,3,0,8,16,0,6,0,3,0.64,0.5758,0.89,0.5224,10,14,24,14
5636,8/27/2011,3,0,8,17,0,6,0,3,0.64,0.5758,0.89,0.8358,2,14,16,14
5637,8/28/2011,3,0,8,7,0,0,0,3,0.62,0.5758,0.83,0.3582,0,1,1,1
5638,8/28/2011,3,0,8,8,0,0,0,3,0.62,0.5758,0.83,0.4179,2,6,8,6
5639,8/28/2011,3,0,8,9,0,0,0,1,0.66,0.6212,0.74,0.4179,7,46,53,46
5640,8/28/2011,3,0,8,10,0,0,0,1,0.7,0.6515,0.61,0.6119,27,115,142,115
5641,8/28/2011,3,0,8,11,0,0,0,1,0.7,0.6515,0.58,0.3881,59,178,237,178
5642,8/28/2011,3,0,8,12,0,0,0,1,0.74,0.6667,0.51,0.3881,88,218,306,218
5643,8/28/2011,3,0,8,13,0,0,0,1,0.76,0.6818,0.45,0.3582,129,302,431,302
5644,8/28/2011,3,0,8,14,0,0,0,1,0.78,0.697,0.43,0.4179,157,290,447,290
5645,8/28/2011,3,0,8,15,0,0,0,1,0.78,0.697,0.43,0.3582,155,314,469,314
5646,8/28/2011,3,0,8,16,0,0,0,1,0.8,0.7121,0.36,0.3881,196,295,491,295
5647,8/28/2011,3,0,8,17,0,0,0,1,0.76,0.6818,0.4,0.2985,145,253,398,253
5648,8/28/2011,3,0,8,18,0,0,0,1,0.74,0.6667,0.42,0.2239,145,257,402,257
5649,8/28/2011,3,0,8,19,0,0,0,1,0.72,0.6667,0.48,0.1045,140,247,387,247
5650,8/28/2011,3,0,8,20,0,0,0,1,0.72,0.6515,0.45,0.1045,64,150,214,150
5651,8/28/2011,3,0,8,21,0,0,0,1,0.66,0.6212,0.61,0.1343,60,126,186,126
5652,8/28/2011,3,0,8,22,0,0,0,1,0.64,0.6061,0.69,0.1045,25,73,98,73
5653,8/28/2011,3,0,8,23,0,0,0,1,0.62,0.5909,0.73,0.1045,16,48,64,48
5654,8/29/2011,3,0,8,0,0,1,1,1,0.62,0.5909,0.73,0.1045,13,21,34,21
5655,8/29/2011,3,0,8,1,0,1,1,1,0.6,0.5909,0.69,0.1045,5,15,20,15
5656,8/29/2011,3,0,8,2,0,1,1,1,0.6,0.5909,0.69,0.194,8,5,13,5
5657,8/29/2011,3,0,8,3,0,1,1,1,0.6,0.5909,0.69,0.1045,1,5,6,5
5658,8/29/2011,3,0,8,4,0,1,1,1,0.56,0.5303,0.68,0.1343,0,3,3,3
5659,8/29/2011,3,0,8,5,0,1,1,1,0.56,0.5303,0.73,0.1343,0,17,17,17
5660,8/29/2011,3,0,8,6,0,1,1,1,0.56,0.5303,0.73,0.1343,3,99,102,99
5661,8/29/2011,3,0,8,7,0,1,1,1,0.6,0.6061,0.6,0.2239,11,273,284,273
5662,8/29/2011,3,0,8,8,0,1,1,1,0.62,0.6212,0.57,0.2537,20,384,404,384
5663,8/29/2011,3,0,8,9,0,1,1,1,0.62,0.6212,0.53,0.2537,22,166,188,166
5664,8/29/2011,3,0,8,10,0,1,1,1,0.66,0.6212,0.47,0.2239,42,73,115,73
5665,8/29/2011,3,0,8,11,0,1,1,1,0.66,0.6212,0.47,0.1642,38,100,138,100
5666,8/29/2011,3,0,8,12,0,1,1,2,0.68,0.6364,0.44,0.1642,48,159,207,159
5667,8/29/2011,3,0,8,13,0,1,1,2,0.7,0.6364,0.39,0,48,170,218,170
5668,8/29/2011,3,0,8,14,0,1,1,1,0.7,0.6364,0.42,0,55,127,182,127
5669,8/29/2011,3,0,8,15,0,1,1,1,0.7,0.6364,0.42,0.1642,56,164,220,164
5670,8/29/2011,3,0,8,16,0,1,1,1,0.72,0.6515,0.42,0.1642,56,226,282,226
5671,8/29/2011,3,0,8,17,0,1,1,2,0.7,0.6364,0.47,0.2239,67,524,591,524
5672,8/29/2011,3,0,8,18,0,1,1,1,0.66,0.6212,0.47,0.2537,60,487,547,487
5673,8/29/2011,3,0,8,19,0,1,1,1,0.66,0.6212,0.47,0.2537,50,317,367,317
5674,8/29/2011,3,0,8,20,0,1,1,1,0.64,0.6212,0.53,0.1642,50,227,277,227
5675,8/29/2011,3,0,8,21,0,1,1,1,0.64,0.6212,0.53,0.194,34,168,202,168
5676,8/29/2011,3,0,8,22,0,1,1,1,0.62,0.6212,0.57,0.1343,23,119,142,119
5677,8/29/2011,3,0,8,23,0,1,1,1,0.6,0.6061,0.6,0.0896,19,56,75,56
5678,8/30/2011,3,0,8,0,0,2,1,1,0.56,0.5303,0.73,0.1343,10,17,27,17
5679,8/30/2011,3,0,8,1,0,2,1,1,0.56,0.5303,0.68,0.1045,6,7,13,7
5680,8/30/2011,3,0,8,2,0,2,1,1,0.54,0.5152,0.73,0.1045,2,8,10,8
5681,8/30/2011,3,0,8,3,0,2,1,1,0.54,0.5152,0.73,0.194,2,2,4,2
5682,8/30/2011,3,0,8,4,0,2,1,1,0.52,0.5,0.77,0.1642,0,6,6,6
5683,8/30/2011,3,0,8,5,0,2,1,1,0.52,0.5,0.77,0.0896,1,27,28,27
5684,8/30/2011,3,0,8,6,0,2,1,1,0.54,0.5152,0.73,0.1045,4,115,119,115
5685,8/30/2011,3,0,8,7,0,2,1,1,0.56,0.5303,0.68,0.1343,19,338,357,338
5686,8/30/2011,3,0,8,8,0,2,1,1,0.62,0.6212,0.57,0.1343,34,459,493,459
5687,8/30/2011,3,0,8,9,0,2,1,1,0.66,0.6212,0.5,0.2239,38,180,218,180
5688,8/30/2011,3,0,8,10,0,2,1,1,0.7,0.6364,0.39,0.2239,28,109,137,109
5689,8/30/2011,3,0,8,11,0,2,1,1,0.72,0.6515,0.37,0.194,60,115,175,115
5690,8/30/2011,3,0,8,12,0,2,1,1,0.72,0.6515,0.37,0,65,172,237,172
5691,8/30/2011,3,0,8,13,0,2,1,1,0.74,0.6515,0.35,0.1045,59,170,229,170
5692,8/30/2011,3,0,8,14,0,2,1,1,0.74,0.6515,0.33,0.1642,58,151,209,151
5693,8/30/2011,3,0,8,15,0,2,1,1,0.74,0.6515,0.35,0.2239,34,162,196,162
5694,8/30/2011,3,0,8,16,0,2,1,1,0.74,0.6515,0.37,0.1642,42,295,337,295
5695,8/30/2011,3,0,8,17,0,2,1,1,0.72,0.6515,0.42,0.194,62,549,611,549
5696,8/30/2011,3,0,8,18,0,2,1,1,0.7,0.6364,0.45,0.1642,60,516,576,516
5697,8/30/2011,3,0,8,19,0,2,1,1,0.66,0.6212,0.5,0.0896,68,397,465,397
5698,8/30/2011,3,0,8,20,0,2,1,1,0.66,0.6212,0.5,0,39,259,298,259
5699,8/30/2011,3,0,8,21,0,2,1,1,0.64,0.6061,0.65,0.0896,43,180,223,180
5700,8/30/2011,3,0,8,22,0,2,1,1,0.62,0.6061,0.61,0,22,121,143,121
5701,8/30/2011,3,0,8,23,0,2,1,1,0.62,0.6061,0.61,0,19,74,93,74
5702,8/31/2011,3,0,8,0,0,3,1,1,0.6,0.5909,0.69,0,8,24,32,24
5703,8/31/2011,3,0,8,1,0,3,1,1,0.6,0.5909,0.69,0,2,13,15,13
5704,8/31/2011,3,0,8,2,0,3,1,1,0.56,0.5303,0.73,0,1,5,6,5
5705,8/31/2011,3,0,8,3,0,3,1,1,0.56,0.5303,0.78,0,2,4,6,4
5706,8/31/2011,3,0,8,4,0,3,1,1,0.56,0.5303,0.73,0,0,5,5,5
5707,8/31/2011,3,0,8,5,0,3,1,1,0.54,0.5152,0.83,0.0896,2,25,27,25
5708,8/31/2011,3,0,8,6,0,3,1,1,0.54,0.5152,0.77,0,4,107,111,107
5709,8/31/2011,3,0,8,7,0,3,1,1,0.6,0.5758,0.78,0,12,316,328,316
5710,8/31/2011,3,0,8,8,0,3,1,1,0.62,0.6061,0.69,0,27,440,467,440
5711,8/31/2011,3,0,8,9,0,3,1,1,0.64,0.6061,0.69,0.0896,27,217,244,217
5712,8/31/2011,3,0,8,10,0,3,1,1,0.7,0.6364,0.45,0.1045,33,105,138,105
5713,8/31/2011,3,0,8,11,0,3,1,1,0.72,0.6515,0.42,0.1343,28,143,171,143
5714,8/31/2011,3,0,8,12,0,3,1,1,0.74,0.6667,0.43,0.1343,68,192,260,192
5715,8/31/2011,3,0,8,13,0,3,1,1,0.74,0.6515,0.37,0.1045,39,182,221,182
5716,8/31/2011,3,0,8,14,0,3,1,1,0.74,0.6515,0.4,0.1343,48,148,196,148
5717,8/31/2011,3,0,8,15,0,3,1,1,0.74,0.6515,0.4,0.1343,34,138,172,138
5718,8/31/2011,3,0,8,16,0,3,1,1,0.74,0.6667,0.42,0.1343,46,263,309,263
5719,8/31/2011,3,0,8,17,0,3,1,1,0.72,0.6515,0.45,0.1343,83,525,608,525
5720,8/31/2011,3,0,8,18,0,3,1,1,0.7,0.6515,0.51,0.2239,70,495,565,495
5721,8/31/2011,3,0,8,19,0,3,1,1,0.84,0.7727,0.47,0.2537,53,393,446,393
5722,8/31/2011,3,0,8,20,0,3,1,1,0.66,0.6212,0.57,0.1343,30,259,289,259
5723,8/31/2011,3,0,8,21,0,3,1,1,0.66,0.6212,0.61,0.0896,27,174,201,174
5724,8/31/2011,3,0,8,22,0,3,1,1,0.64,0.6061,0.69,0,20,137,157,137
5725,8/31/2011,3,0,8,23,0,3,1,1,0.6,0.5758,0.78,0.1045,24,60,84,60
5726,9/1/2011,3,0,9,0,0,4,1,1,0.6,0.5758,0.78,0.1045,18,33,51,33
5727,9/1/2011,3,0,9,1,0,4,1,1,0.6,0.5909,0.73,0.0896,7,14,21,14
5728,9/1/2011,3,0,9,2,0,4,1,1,0.58,0.5455,0.78,0.0896,14,11,25,11
5729,9/1/2011,3,0,9,3,0,4,1,1,0.58,0.5455,0.78,0.0896,7,7,14,7
5730,9/1/2011,3,0,9,4,0,4,1,1,0.56,0.5303,0.83,0.0896,0,7,7,7
5731,9/1/2011,3,0,9,5,0,4,1,1,0.56,0.5303,0.73,0.0896,1,22,23,22
5732,9/1/2011,3,0,9,6,0,4,1,1,0.6,0.5758,0.78,0,2,103,105,103
5733,9/1/2011,3,0,9,7,0,4,1,1,0.6,0.5758,0.78,0,7,335,342,335
5734,9/1/2011,3,0,9,8,0,4,1,1,0.62,0.5909,0.73,0.1343,31,467,498,467
5735,9/1/2011,3,0,9,9,0,4,1,1,0.64,0.6061,0.69,0.1045,29,178,207,178
5736,9/1/2011,3,0,9,10,0,4,1,1,0.68,0.6364,0.61,0.1343,46,92,138,92
5737,9/1/2011,3,0,9,11,0,4,1,1,0.72,0.6667,0.51,0.1343,51,141,192,141
5738,9/1/2011,3,0,9,12,0,4,1,2,0.72,0.6667,0.51,0.1343,64,165,229,165
5739,9/1/2011,3,0,9,13,0,4,1,2,0.72,0.6667,0.48,0.0896,50,169,219,169
5740,9/1/2011,3,0,9,14,0,4,1,3,0.72,0.6667,0.54,0.2537,54,144,198,144
5741,9/1/2011,3,0,9,15,0,4,1,1,0.72,0.6667,0.51,0.1343,39,135,174,135
5742,9/1/2011,3,0,9,16,0,4,1,1,0.74,0.6667,0.51,0.194,55,253,308,253
5743,9/1/2011,3,0,9,17,0,4,1,1,0.72,0.6667,0.54,0.2537,61,567,628,567
5744,9/1/2011,3,0,9,18,0,4,1,1,0.72,0.6667,0.54,0.2239,69,462,531,462
5745,9/1/2011,3,0,9,19,0,4,1,1,0.7,0.6515,0.58,0.1642,79,364,443,364
5746,9/1/2011,3,0,9,20,0,4,1,1,0.66,0.6212,0.61,0.2239,33,247,280,247
5747,9/1/2011,3,0,9,21,0,4,1,2,0.66,0.6212,0.57,0.194,17,160,177,160
5748,9/1/2011,3,0,9,22,0,4,1,2,0.66,0.6212,0.57,0.2239,34,145,179,145
5749,9/1/2011,3,0,9,23,0,4,1,1,0.64,0.6061,0.65,0.2537,15,111,126,111
5750,9/2/2011,3,0,9,0,0,5,1,1,0.64,0.6061,0.65,0.194,6,58,64,58
5751,9/2/2011,3,0,9,1,0,5,1,3,0.62,0.5909,0.73,0.1045,4,28,32,28
5752,9/2/2011,3,0,9,2,0,5,1,3,0.62,0.5909,0.73,0.1045,9,11,20,11
5753,9/2/2011,3,0,9,3,0,5,1,2,0.6,0.5606,0.83,0.1642,4,4,8,4
5754,9/2/2011,3,0,9,4,0,5,1,1,0.6,0.5606,0.83,0.0896,2,2,4,2
5755,9/2/2011,3,0,9,5,0,5,1,2,0.6,0.5606,0.83,0.1343,0,20,20,20
5756,9/2/2011,3,0,9,6,0,5,1,1,0.6,0.5606,0.83,0.1343,3,73,76,73
5757,9/2/2011,3,0,9,7,0,5,1,1,0.6,0.5606,0.83,0.1045,6,253,259,253
5758,9/2/2011,3,0,9,8,0,5,1,1,0.62,0.5909,0.78,0.194,22,434,456,434
5759,9/2/2011,3,0,9,9,0,5,1,2,0.62,0.5758,0.83,0.1045,30,190,220,190
5760,9/2/2011,3,0,9,10,0,5,1,2,0.64,0.6061,0.76,0.1642,34,106,140,106
5761,9/2/2011,3,0,9,11,0,5,1,2,0.66,0.6212,0.74,0.1045,51,141,192,141
5762,9/2/2011,3,0,9,12,0,5,1,2,0.66,0.6212,0.69,0.2239,82,178,260,178
5763,9/2/2011,3,0,9,13,0,5,1,2,0.68,0.6364,0.65,0.1343,72,207,279,207
5764,9/2/2011,3,0,9,14,0,5,1,2,0.7,0.6515,0.61,0.1045,75,208,283,208
5765,9/2/2011,3,0,9,15,0,5,1,2,0.7,0.6515,0.61,0.2537,69,277,346,277
5766,9/2/2011,3,0,9,16,0,5,1,2,0.7,0.6515,0.61,0.1343,82,299,381,299
5767,9/2/2011,3,0,9,17,0,5,1,2,0.68,0.6364,0.65,0.1642,78,377,455,377
5768,9/2/2011,3,0,9,18,0,5,1,2,0.68,0.6364,0.65,0.194,50,305,355,305
5769,9/2/2011,3,0,9,19,0,5,1,1,0.66,0.6212,0.69,0.1343,67,220,287,220
5770,9/2/2011,3,0,9,20,0,5,1,1,0.64,0.6061,0.73,0,38,158,196,158
5771,9/2/2011,3,0,9,21,0,5,1,2,0.64,0.6061,0.73,0.0896,28,121,149,121
5772,9/2/2011,3,0,9,22,0,5,1,2,0.64,0.6061,0.73,0.1642,33,114,147,114
5773,9/2/2011,3,0,9,23,0,5,1,2,0.64,0.6061,0.73,0.1642,30,68,98,68
5774,9/3/2011,3,0,9,0,0,6,0,2,0.64,0.6061,0.73,0.1045,22,65,87,65
5775,9/3/2011,3,0,9,1,0,6,0,2,0.64,0.6061,0.69,0.2537,17,57,74,57
5776,9/3/2011,3,0,9,2,0,6,0,2,0.64,0.6061,0.69,0.2239,15,26,41,26
5777,9/3/2011,3,0,9,3,0,6,0,1,0.62,0.5909,0.73,0.1642,17,18,35,18
5778,9/3/2011,3,0,9,4,0,6,0,1,0.62,0.5909,0.73,0.1642,3,4,7,4
5779,9/3/2011,3,0,9,5,0,6,0,1,0.62,0.6061,0.69,0.194,3,9,12,9
5780,9/3/2011,3,0,9,6,0,6,0,1,0.62,0.5909,0.73,0.1642,4,19,23,19
5781,9/3/2011,3,0,9,7,0,6,0,1,0.62,0.5909,0.73,0.194,5,33,38,33
5782,9/3/2011,3,0,9,8,0,6,0,1,0.64,0.6061,0.69,0.1642,24,65,89,65
5783,9/3/2011,3,0,9,9,0,6,0,2,0.66,0.6212,0.69,0.2537,83,118,201,118
5784,9/3/2011,3,0,9,10,0,6,0,3,0.66,0.6212,0.65,0.2537,90,168,258,168
5785,9/3/2011,3,0,9,11,0,6,0,3,0.66,0.6212,0.69,0.2836,66,128,194,128
5786,9/3/2011,3,0,9,12,0,6,0,1,0.7,0.6515,0.61,0.2239,97,160,257,160
5787,9/3/2011,3,0,9,13,0,6,0,1,0.7,0.6515,0.65,0.2239,153,200,353,200
5788,9/3/2011,3,0,9,14,0,6,0,2,0.72,0.6818,0.66,0.1642,204,176,380,176
5789,9/3/2011,3,0,9,15,0,6,0,1,0.72,0.6818,0.7,0.1642,187,201,388,201
5790,9/3/2011,3,0,9,16,0,6,0,1,0.72,0.6818,0.7,0.194,186,188,374,188
5791,9/3/2011,3,0,9,17,0,6,0,1,0.72,0.6818,0.7,0.2239,170,201,371,201
5792,9/3/2011,3,0,9,18,0,6,0,1,0.72,0.6818,0.7,0.1642,160,179,339,179
5793,9/3/2011,3,0,9,19,0,6,0,1,0.7,0.6667,0.74,0.1343,147,148,295,148
5794,9/3/2011,3,0,9,20,0,6,0,1,0.7,0.6667,0.79,0.1642,99,120,219,120
5795,9/3/2011,3,0,9,21,0,6,0,1,0.68,0.6364,0.83,0.1343,71,93,164,93
5796,9/3/2011,3,0,9,22,0,6,0,1,0.68,0.6364,0.83,0.1045,66,96,162,96
5797,9/3/2011,3,0,9,23,0,6,0,1,0.66,0.6212,0.85,0.1343,46,77,123,77
5798,9/4/2011,3,0,9,0,0,0,0,1,0.66,0.5909,0.89,0.194,33,76,109,76
5799,9/4/2011,3,0,9,1,0,0,0,1,0.66,0.6061,0.83,0.1343,37,38,75,38
5800,9/4/2011,3,0,9,2,0,0,0,1,0.66,0.6061,0.83,0.194,17,43,60,43
5801,9/4/2011,3,0,9,3,0,0,0,1,0.64,0.5758,0.89,0.194,20,23,43,23
5802,9/4/2011,3,0,9,4,0,0,0,1,0.64,0.5758,0.83,0.1642,0,4,4,4
5803,9/4/2011,3,0,9,5,0,0,0,1,0.64,0.5758,0.83,0.1343,1,5,6,5
5804,9/4/2011,3,0,9,6,0,0,0,1,0.64,0.5758,0.84,0.2239,0,3,3,3
5805,9/4/2011,3,0,9,7,0,0,0,1,0.66,0.6061,0.78,0.194,10,20,30,20
5806,9/4/2011,3,0,9,8,0,0,0,1,0.66,0.6061,0.78,0.1642,21,49,70,49
5807,9/4/2011,3,0,9,9,0,0,0,1,0.66,0.6061,0.78,0.1642,87,102,189,102
5808,9/4/2011,3,0,9,10,0,0,0,1,0.7,0.6667,0.74,0.1343,150,147,297,147
5809,9/4/2011,3,0,9,11,0,0,0,1,0.74,0.697,0.7,0.1642,174,163,337,163
5810,9/4/2011,3,0,9,12,0,0,0,1,0.76,0.7273,0.66,0.1642,214,221,435,221
5811,9/4/2011,3,0,9,13,0,0,0,2,0.78,0.7424,0.62,0.2836,245,174,419,174
5812,9/4/2011,3,0,9,14,0,0,0,1,0.78,0.7576,0.66,0.3284,205,156,361,156
5813,9/4/2011,3,0,9,15,0,0,0,1,0.78,0.7576,0.66,0.2836,218,192,410,192
5814,9/4/2011,3,0,9,16,0,0,0,1,0.8,0.7727,0.59,0.2239,196,141,337,141
5815,9/4/2011,3,0,9,17,0,0,0,1,0.76,0.7273,0.66,0.2239,204,172,376,172
5816,9/4/2011,3,0,9,18,0,0,0,1,0.76,0.7273,0.66,0.194,187,169,356,169
5817,9/4/2011,3,0,9,19,0,0,0,1,0.74,0.697,0.7,0.194,178,150,328,150
5818,9/4/2011,3,0,9,20,0,0,0,1,0.74,0.697,0.7,0.2985,104,125,229,125
5819,9/4/2011,3,0,9,21,0,0,0,1,0.72,0.697,0.74,0.2537,104,103,207,103
5820,9/4/2011,3,0,9,22,0,0,0,2,0.72,0.697,0.74,0.2836,70,85,155,85
5821,9/4/2011,3,0,9,23,0,0,0,2,0.72,0.6818,0.7,0.1642,46,58,104,58
5822,9/5/2011,3,0,9,0,1,1,0,2,0.7,0.6667,0.74,0.2239,31,66,97,66
5823,9/5/2011,3,0,9,1,1,1,0,2,0.68,0.6364,0.79,0.1045,19,35,54,35
5824,9/5/2011,3,0,9,2,1,1,0,2,0.68,0.6364,0.79,0.1642,17,22,39,22
5825,9/5/2011,3,0,9,3,1,1,0,2,0.68,0.6364,0.74,0.2985,4,12,16,12
5826,9/5/2011,3,0,9,4,1,1,0,2,0.68,0.6364,0.69,0.2836,3,5,8,5
5827,9/5/2011,3,0,9,5,1,1,0,2,0.66,0.6212,0.74,0.1642,2,4,6,4
5828,9/5/2011,3,0,9,6,1,1,0,2,0.66,0.6212,0.74,0.1343,6,5,11,5
5829,9/5/2011,3,0,9,7,1,1,0,1,0.66,0.6212,0.74,0.1642,11,30,41,30
5830,9/5/2011,3,0,9,8,1,1,0,2,0.66,0.6061,0.78,0.194,45,56,101,56
5831,9/5/2011,3,0,9,9,1,1,0,3,0.68,0.6364,0.74,0.1642,63,89,152,89
5832,9/5/2011,3,0,9,10,1,1,0,2,0.7,0.6515,0.7,0.1642,107,137,244,137
5833,9/5/2011,3,0,9,11,1,1,0,2,0.7,0.6667,0.74,0.1642,101,207,308,207
5834,9/5/2011,3,0,9,12,1,1,0,2,0.72,0.6818,0.7,0.194,141,212,353,212
5835,9/5/2011,3,0,9,13,1,1,0,2,0.74,0.697,0.7,0.1343,154,235,389,235
5836,9/5/2011,3,0,9,14,1,1,0,1,0.74,0.697,0.7,0.1642,145,212,357,212
5837,9/5/2011,3,0,9,15,1,1,0,2,0.68,0.6364,0.79,0.2836,111,142,253,142
5838,9/5/2011,3,0,9,16,1,1,0,2,0.68,0.6364,0.79,0.2836,92,192,284,192
5839,9/5/2011,3,0,9,17,1,1,0,2,0.66,0.5909,0.89,0.1045,37,77,114,77
5840,9/5/2011,3,0,9,18,1,1,0,1,0.66,0.5909,0.89,0.0896,31,92,123,92
5841,9/5/2011,3,0,9,19,1,1,0,3,0.66,0.5909,0.94,0.1045,52,123,175,123
5842,9/5/2011,3,0,9,20,1,1,0,3,0.66,0.5909,0.94,0.2537,26,56,82,56
5843,9/5/2011,3,0,9,21,1,1,0,2,0.66,0.5909,0.94,0.2985,20,40,60,40
5844,9/5/2011,3,0,9,22,1,1,0,2,0.6,0.5455,0.88,0.5821,15,49,64,49
5845,9/5/2011,3,0,9,23,1,1,0,3,0.56,0.5303,0.88,0.3881,3,17,20,17
5846,9/6/2011,3,0,9,0,0,2,1,3,0.54,0.5152,0.94,0.3582,1,7,8,7
5847,9/6/2011,3,0,9,2,0,2,1,3,0.54,0.5152,0.94,0.2537,0,2,2,2
5848,9/6/2011,3,0,9,3,0,2,1,3,0.54,0.5152,0.94,0.2985,1,0,1,0
5849,9/6/2011,3,0,9,4,0,2,1,2,0.54,0.5152,0.94,0.2985,1,3,4,3
5850,9/6/2011,3,0,9,5,0,2,1,3,0.54,0.5152,0.88,0.3582,1,20,21,20
5851,9/6/2011,3,0,9,6,0,2,1,2,0.54,0.5152,0.88,0.3284,0,72,72,72
5852,9/6/2011,3,0,9,7,0,2,1,2,0.54,0.5152,0.83,0.3582,6,166,172,166
5853,9/6/2011,3,0,9,8,0,2,1,3,0.54,0.5152,0.83,0.3881,15,349,364,349
5854,9/6/2011,3,0,9,9,0,2,1,2,0.54,0.5152,0.81,0.4179,18,167,185,167
5855,9/6/2011,3,0,9,10,0,2,1,3,0.54,0.5152,0.83,0.3582,16,90,106,90
5856,9/6/2011,3,0,9,11,0,2,1,3,0.54,0.5152,0.83,0.3881,11,78,89,78
5857,9/6/2011,3,0,9,12,0,2,1,3,0.54,0.5152,0.83,0.3881,16,51,67,51
5858,9/6/2011,3,0,9,13,0,2,1,3,0.54,0.5152,0.88,0.2985,5,24,29,24
5859,9/6/2011,3,0,9,14,0,2,1,3,0.54,0.5152,0.88,0.2836,3,21,24,21
5860,9/6/2011,3,0,9,15,0,2,1,3,0.54,0.5152,0.94,0.3881,18,71,89,71
5861,9/6/2011,3,0,9,16,0,2,1,3,0.54,0.5152,0.94,0.3881,11,95,106,95
5862,9/6/2011,3,0,9,17,0,2,1,2,0.54,0.5152,0.88,0.3881,15,276,291,276
5863,9/6/2011,3,0,9,18,0,2,1,2,0.54,0.5152,0.88,0.3881,22,351,373,351
5864,9/6/2011,3,0,9,19,0,2,1,2,0.54,0.5152,0.88,0.4179,12,269,281,269
5865,9/6/2011,3,0,9,20,0,2,1,3,0.54,0.5152,0.88,0.2985,13,150,163,150
5866,9/6/2011,3,0,9,21,0,2,1,3,0.54,0.5152,0.88,0.2836,12,109,121,109
5867,9/6/2011,3,0,9,22,0,2,1,2,0.54,0.5152,0.94,0.3284,5,79,84,79
5868,9/6/2011,3,0,9,23,0,2,1,3,0.54,0.5152,0.94,0.2537,2,56,58,56
5869,9/7/2011,3,0,9,0,0,3,1,2,0.54,0.5152,0.94,0.2239,1,12,13,12
5870,9/7/2011,3,0,9,1,0,3,1,3,0.54,0.5152,0.94,0.2537,2,3,5,3
5871,9/7/2011,3,0,9,2,0,3,1,2,0.54,0.5152,0.94,0.2239,2,4,6,4
5872,9/7/2011,3,0,9,3,0,3,1,3,0.56,0.5303,0.94,0.1343,1,1,2,1
5873,9/7/2011,3,0,9,4,0,3,1,3,0.56,0.5303,0.94,0.1642,0,4,4,4
5874,9/7/2011,3,0,9,5,0,3,1,2,0.56,0.5303,1,0.1343,1,15,16,15
5875,9/7/2011,3,0,9,6,0,3,1,3,0.6,0.5455,0.88,0.1045,1,74,75,74
5876,9/7/2011,3,0,9,7,0,3,1,3,0.6,0.5455,0.88,0.0896,3,83,86,83
5877,9/7/2011,3,0,9,8,0,3,1,3,0.62,0.5455,0.94,0.0896,9,319,328,319
5878,9/7/2011,3,0,9,9,0,3,1,3,0.6,0.5455,0.88,0.1343,14,176,190,176
5879,9/7/2011,3,0,9,10,0,3,1,3,0.6,0.5455,0.88,0.1343,3,63,66,63
5880,9/7/2011,3,0,9,11,0,3,1,3,0.6,0.5152,0.94,0,1,9,10,9
5881,9/7/2011,3,0,9,12,0,3,1,3,0.56,0.5303,0.94,0,1,21,22,21
5882,9/7/2011,3,0,9,13,0,3,1,3,0.6,0.5455,0.88,0,2,9,11,9
5883,9/7/2011,3,0,9,14,0,3,1,3,0.6,0.5152,0.93,0,1,24,25,24
5884,9/7/2011,3,0,9,15,0,3,1,3,0.62,0.5455,0.94,0.1045,3,55,58,55
5885,9/7/2011,3,0,9,16,0,3,1,1,0.64,0.5758,0.89,0,7,137,144,137
5886,9/7/2011,3,0,9,17,0,3,1,3,0.64,0.5758,0.89,0,21,264,285,264
5887,9/7/2011,3,0,9,18,0,3,1,3,0.64,0.5758,0.89,0,18,219,237,219
5888,9/7/2011,3,0,9,19,0,3,1,2,0.64,0.5758,0.89,0,14,212,226,212
5889,9/7/2011,3,0,9,20,0,3,1,3,0.64,0.5758,0.89,0.0896,3,93,96,93
5890,9/7/2011,3,0,9,21,0,3,1,3,0.64,0.5758,0.89,0.0896,4,34,38,34
5891,9/7/2011,3,0,9,22,0,3,1,3,0.62,0.5455,0.94,0.1642,3,26,29,26
5892,9/7/2011,3,0,9,23,0,3,1,3,0.62,0.5455,0.94,0.194,3,21,24,21
5893,9/8/2011,3,0,9,0,0,4,1,3,0.6,0.5,1,0.194,3,11,14,11
5894,9/8/2011,3,0,9,1,0,4,1,3,0.62,0.5455,0.94,0.1045,0,4,4,4
5895,9/8/2011,3,0,9,3,0,4,1,3,0.62,0.5455,0.94,0,0,2,2,2
5896,9/8/2011,3,0,9,4,0,4,1,2,0.62,0.5455,0.94,0.0896,0,3,3,3
5897,9/8/2011,3,0,9,5,0,4,1,3,0.62,0.5455,0.94,0.0896,1,13,14,13
5898,9/8/2011,3,0,9,6,0,4,1,3,0.62,0.5455,0.94,0.1642,1,55,56,55
5899,9/8/2011,3,0,9,7,0,4,1,3,0.62,0.5455,0.94,0.1045,7,172,179,172
5900,9/8/2011,3,0,9,8,0,4,1,3,0.62,0.5455,0.94,0.1343,7,188,195,188
5901,9/8/2011,3,0,9,9,0,4,1,2,0.62,0.5152,1,0.2537,4,65,69,65
5902,9/8/2011,3,0,9,10,0,4,1,2,0.64,0.5606,0.94,0.1045,8,57,65,57
5903,9/8/2011,3,0,9,11,0,4,1,2,0.64,0.5606,0.94,0.2239,16,82,98,82
5904,9/8/2011,3,0,9,12,0,4,1,2,0.66,0.5909,0.94,0.2239,17,85,102,85
5905,9/8/2011,3,0,9,13,0,4,1,2,0.68,0.6364,0.83,0.3881,14,112,126,112
5906,9/8/2011,3,0,9,14,0,4,1,2,0.7,0.6667,0.79,0.3582,15,105,120,105
5907,9/8/2011,3,0,9,15,0,4,1,3,0.66,0.5909,0.89,0.2985,24,115,139,115
5908,9/8/2011,3,0,9,16,0,4,1,3,0.64,0.5606,0.94,0.2836,5,151,156,151
5909,9/8/2011,3,0,9,17,0,4,1,3,0.64,0.5606,0.94,0.2836,11,102,113,102
5910,9/8/2011,3,0,9,18,0,4,1,3,0.64,0.5606,0.94,0.3582,2,66,68,66
5911,9/8/2011,3,0,9,19,0,4,1,3,0.62,0.5152,1,0.3284,1,51,52,51
5912,9/8/2011,3,0,9,20,0,4,1,2,0.62,0.5455,0.94,0.1642,6,83,89,83
5913,9/8/2011,3,0,9,21,0,4,1,3,0.64,0.5606,0.94,0.1045,6,76,82,76
5914,9/8/2011,3,0,9,22,0,4,1,3,0.62,0.5152,1,0.0896,5,65,70,65
5915,9/8/2011,3,0,9,23,0,4,1,3,0.62,0.5152,1,0.0896,0,26,26,26
5916,9/9/2011,3,0,9,0,0,5,1,3,0.64,0.5606,0.94,0.194,1,15,16,15
5917,9/9/2011,3,0,9,1,0,5,1,2,0.62,0.5152,1,0.1642,0,8,8,8
5918,9/9/2011,3,0,9,2,0,5,1,2,0.62,0.5152,1,0.2537,1,7,8,7
5919,9/9/2011,3,0,9,3,0,5,1,2,0.62,0.5455,0.94,0.2537,1,1,2,1
5920,9/9/2011,3,0,9,4,0,5,1,3,0.62,0.5455,0.94,0.1642,0,3,3,3
5921,9/9/2011,3,0,9,5,0,5,1,2,0.62,0.5455,0.94,0.1343,0,14,14,14
5922,9/9/2011,3,0,9,6,0,5,1,2,0.62,0.5152,1,0.1343,3,54,57,54
5923,9/9/2011,3,0,9,7,0,5,1,3,0.62,0.5152,1,0.2537,4,104,108,104
5924,9/9/2011,3,0,9,8,0,5,1,3,0.62,0.5455,0.94,0.1642,12,276,288,276
5925,9/9/2011,3,0,9,9,0,5,1,3,0.62,0.5455,0.94,0.1642,5,131,136,131
5926,9/9/2011,3,0,9,10,0,5,1,2,0.62,0.5152,1,0,2,27,29,27
5927,9/9/2011,3,0,9,11,0,5,1,2,0.62,0.5455,0.94,0,6,66,72,66
5928,9/9/2011,3,0,9,12,0,5,1,1,0.64,0.5606,0.94,0,4,71,75,71
5929,9/9/2011,3,0,9,13,0,5,1,1,0.7,0.6667,0.79,0.0896,14,108,122,108
5930,9/9/2011,3,0,9,14,0,5,1,1,0.72,0.697,0.74,0.0896,29,119,148,119
5931,9/9/2011,3,0,9,15,0,5,1,1,0.74,0.697,0.66,0,27,161,188,161
5932,9/9/2011,3,0,9,16,0,5,1,1,0.74,0.697,0.66,0.1343,41,244,285,244
5933,9/9/2011,3,0,9,17,0,5,1,1,0.7,0.6667,0.79,0.2537,54,451,505,451
5934,9/9/2011,3,0,9,18,0,5,1,1,0.7,0.6667,0.79,0.194,33,377,410,377
5935,9/9/2011,3,0,9,19,0,5,1,1,0.66,0.5909,0.89,0.1642,33,316,349,316
5936,9/9/2011,3,0,9,20,0,5,1,1,0.64,0.5606,0.94,0.0896,30,180,210,180
5937,9/9/2011,3,0,9,21,0,5,1,1,0.66,0.5909,0.89,0,49,154,203,154
5938,9/9/2011,3,0,9,22,0,5,1,1,0.62,0.5455,0.94,0,33,127,160,127
5939,9/9/2011,3,0,9,23,0,5,1,1,0.62,0.5455,0.94,0.0896,35,113,148,113
5940,9/10/2011,3,0,9,0,0,6,0,1,0.62,0.5455,0.94,0,32,84,116,84
5941,9/10/2011,3,0,9,1,0,6,0,2,0.62,0.5455,0.94,0,16,67,83,67
5942,9/10/2011,3,0,9,2,0,6,0,2,0.6,0.5,0.97,0.1045,18,46,64,46
5943,9/10/2011,3,0,9,3,0,6,0,1,0.58,0.5455,1,0.1343,8,29,37,29
5944,9/10/2011,3,0,9,4,0,6,0,1,0.58,0.5455,0.94,0.0896,3,4,7,4
5945,9/10/2011,3,0,9,5,0,6,0,1,0.58,0.5455,0.94,0.1343,2,6,8,6
5946,9/10/2011,3,0,9,6,0,6,0,1,0.58,0.5455,0.94,0.1642,0,6,6,6
5947,9/10/2011,3,0,9,7,0,6,0,1,0.6,0.5455,0.88,0.1343,9,43,52,43
5948,9/10/2011,3,0,9,8,0,6,0,1,0.62,0.5758,0.83,0.1642,16,103,119,103
5949,9/10/2011,3,0,9,9,0,6,0,1,0.64,0.5909,0.78,0.2985,39,168,207,168
5950,9/10/2011,3,0,9,10,0,6,0,1,0.7,0.6515,0.65,0.2537,85,233,318,233
5951,9/10/2011,3,0,9,11,0,6,0,1,0.72,0.6818,0.62,0.2537,108,252,360,252
5952,9/10/2011,3,0,9,12,0,6,0,1,0.72,0.6818,0.62,0.2239,144,260,404,260
5953,9/10/2011,3,0,9,13,0,6,0,1,0.74,0.6818,0.55,0.2836,131,239,370,239
5954,9/10/2011,3,0,9,14,0,6,0,1,0.74,0.6818,0.55,0.2836,129,230,359,230
5955,9/10/2011,3,0,9,15,0,6,0,1,0.74,0.6818,0.55,0.2239,217,263,480,263
5956,9/10/2011,3,0,9,16,0,6,0,1,0.74,0.6818,0.55,0.194,170,261,431,261
5957,9/10/2011,3,0,9,17,0,6,0,1,0.74,0.6818,0.55,0.2239,185,275,460,275
5958,9/10/2011,3,0,9,18,0,6,0,1,0.72,0.6667,0.58,0.194,119,241,360,241
5959,9/10/2011,3,0,9,19,0,6,0,1,0.7,0.6515,0.58,0.1343,101,214,315,214
5960,9/10/2011,3,0,9,20,0,6,0,1,0.66,0.6212,0.69,0.1045,78,167,245,167
5961,9/10/2011,3,0,9,21,0,6,0,1,0.64,0.5909,0.78,0.0896,59,171,230,171
5962,9/10/2011,3,0,9,22,0,6,0,1,0.64,0.5909,0.78,0,49,126,175,126
5963,9/10/2011,3,0,9,23,0,6,0,2,0.62,0.5606,0.88,0,32,107,139,107
5964,9/11/2011,3,0,9,0,0,0,0,1,0.62,0.5606,0.88,0,29,79,108,79
5965,9/11/2011,3,0,9,1,0,0,0,2,0.62,0.5606,0.88,0,22,66,88,66
5966,9/11/2011,3,0,9,2,0,0,0,2,0.62,0.5909,0.78,0.194,16,60,76,60
5967,9/11/2011,3,0,9,3,0,0,0,2,0.62,0.5909,0.78,0.0896,15,30,45,30
5968,9/11/2011,3,0,9,4,0,0,0,1,0.6,0.5606,0.83,0.1343,3,6,9,6
5969,9/11/2011,3,0,9,5,0,0,0,1,0.6,0.5606,0.83,0.1343,15,24,39,24
5970,9/11/2011,3,0,9,6,0,0,0,1,0.58,0.5455,0.88,0.1045,4,16,20,16
5971,9/11/2011,3,0,9,7,0,0,0,1,0.6,0.5455,0.88,0,9,28,37,28
5972,9/11/2011,3,0,9,8,0,0,0,1,0.64,0.5909,0.78,0,25,69,94,69
5973,9/11/2011,3,0,9,9,0,0,0,1,0.66,0.6212,0.74,0,59,168,227,168
5974,9/11/2011,3,0,9,10,0,0,0,1,0.7,0.6515,0.65,0,120,214,334,214
5975,9/11/2011,3,0,9,11,0,0,0,1,0.7,0.6515,0.65,0,144,258,402,258
5976,9/11/2011,3,0,9,12,0,0,0,1,0.7,0.6515,0.65,0,113,298,411,298
5977,9/11/2011,3,0,9,13,0,0,0,1,0.74,0.6818,0.58,0.1045,119,231,350,231
5978,9/11/2011,3,0,9,14,0,0,0,1,0.72,0.6667,0.58,0.2836,120,222,342,222
5979,9/11/2011,3,0,9,15,0,0,0,1,0.74,0.6667,0.51,0.2985,134,270,404,270
5980,9/11/2011,3,0,9,16,0,0,0,1,0.72,0.6667,0.51,0.2985,180,303,483,303
5981,9/11/2011,3,0,9,17,0,0,0,1,0.72,0.6667,0.51,0.1343,152,228,380,228
5982,9/11/2011,3,0,9,18,0,0,0,1,0.68,0.6364,0.65,0.2985,110,229,339,229
5983,9/11/2011,3,0,9,19,0,0,0,1,0.64,0.6061,0.69,0.1045,101,232,333,232
5984,9/11/2011,3,0,9,20,0,0,0,1,0.62,0.5909,0.73,0.1045,65,161,226,161
5985,9/11/2011,3,0,9,21,0,0,0,1,0.64,0.6061,0.69,0,45,114,159,114
5986,9/11/2011,3,0,9,22,0,0,0,1,0.62,0.6061,0.69,0.3881,21,74,95,74
5987,9/11/2011,3,0,9,23,0,0,0,3,0.58,0.5455,0.78,0.0896,12,33,45,33
5988,9/12/2011,3,0,9,0,0,1,1,1,0.56,0.5303,0.88,0.0896,5,11,16,11
5989,9/12/2011,3,0,9,1,0,1,1,1,0.56,0.5303,0.88,0,1,11,12,11
5990,9/12/2011,3,0,9,2,0,1,1,1,0.56,0.5303,0.88,0,2,0,2,0
5991,9/12/2011,3,0,9,4,0,1,1,1,0.54,0.5152,0.94,0.1045,0,4,4,4
5992,9/12/2011,3,0,9,5,0,1,1,1,0.56,0.5303,0.83,0,1,23,24,23
5993,9/12/2011,3,0,9,6,0,1,1,1,0.56,0.5303,0.83,0,1,108,109,108
5994,9/12/2011,3,0,9,7,0,1,1,1,0.58,0.5455,0.83,0,12,300,312,300
5995,9/12/2011,3,0,9,8,0,1,1,1,0.6,0.5758,0.78,0.0896,26,382,408,382
5996,9/12/2011,3,0,9,9,0,1,1,1,0.64,0.6061,0.69,0,21,155,176,155
5997,9/12/2011,3,0,9,10,0,1,1,1,0.68,0.6364,0.62,0.1642,40,89,129,89
5998,9/12/2011,3,0,9,11,0,1,1,1,0.7,0.6515,0.58,0.194,34,131,165,131
5999,9/12/2011,3,0,9,12,0,1,1,1,0.72,0.6667,0.51,0.194,37,147,184,147
6000,9/12/2011,3,0,9,13,0,1,1,1,0.72,0.6667,0.54,0.1045,43,120,163,120
6001,9/12/2011,3,0,9,14,0,1,1,1,0.74,0.6667,0.51,0.1642,60,129,189,129
6002,9/12/2011,3,0,9,15,0,1,1,1,0.74,0.6667,0.48,0.0896,60,152,212,152
6003,9/12/2011,3,0,9,16,0,1,1,1,0.72,0.6667,0.48,0,60,238,298,238
6004,9/12/2011,3,0,9,17,0,1,1,1,0.72,0.6667,0.51,0.1642,75,515,590,515
6005,9/12/2011,3,0,9,18,0,1,1,1,0.7,0.6515,0.54,0.194,56,515,571,515
6006,9/12/2011,3,0,9,19,0,1,1,1,0.68,0.6364,0.57,0.1343,63,373,436,373
6007,9/12/2011,3,0,9,20,0,1,1,1,0.66,0.6212,0.65,0,41,258,299,258
6008,9/12/2011,3,0,9,21,0,1,1,1,0.64,0.6061,0.73,0.0896,29,166,195,166
6009,9/12/2011,3,0,9,22,0,1,1,1,0.62,0.5758,0.83,0.1642,16,134,150,134
6010,9/12/2011,3,0,9,23,0,1,1,1,0.62,0.5758,0.83,0.1045,7,62,69,62
6011,9/13/2011,3,0,9,0,0,2,1,1,0.6,0.5455,0.88,0.1045,7,19,26,19
6012,9/13/2011,3,0,9,1,0,2,1,1,0.58,0.5455,0.83,0.1045,4,6,10,6
6013,9/13/2011,3,0,9,2,0,2,1,1,0.6,0.5758,0.78,0,2,0,2,0
6014,9/13/2011,3,0,9,3,0,2,1,1,0.58,0.5455,0.83,0,2,2,4,2
6015,9/13/2011,3,0,9,4,0,2,1,1,0.56,0.5303,0.88,0,2,6,8,6
6016,9/13/2011,3,0,9,5,0,2,1,1,0.56,0.5303,0.88,0,1,19,20,19
6017,9/13/2011,3,0,9,6,0,2,1,1,0.56,0.5303,0.88,0.1045,6,116,122,116
6018,9/13/2011,3,0,9,7,0,2,1,1,0.58,0.5455,0.83,0.0896,14,348,362,348
6019,9/13/2011,3,0,9,8,0,2,1,1,0.6,0.5606,0.81,0.1045,26,399,425,399
6020,9/13/2011,3,0,9,9,0,2,1,1,0.64,0.6061,0.69,0.0896,35,179,214,179
6021,9/13/2011,3,0,9,10,0,2,1,1,0.68,0.6364,0.69,0.1343,42,93,135,93
6022,9/13/2011,3,0,9,11,0,2,1,1,0.7,0.6515,0.61,0.1642,33,120,153,120
6023,9/13/2011,3,0,9,12,0,2,1,1,0.72,0.6667,0.58,0.2239,43,144,187,144
6024,9/13/2011,3,0,9,13,0,2,1,1,0.74,0.6667,0.51,0.2836,48,136,184,136
6025,9/13/2011,3,0,9,14,0,2,1,1,0.74,0.6667,0.51,0.3284,51,139,190,139
6026,9/13/2011,3,0,9,15,0,2,1,1,0.74,0.6667,0.51,0.2985,35,145,180,145
6027,9/13/2011,3,0,9,16,0,2,1,1,0.74,0.6667,0.51,0.2239,41,251,292,251
6028,9/13/2011,3,0,9,17,0,2,1,1,0.74,0.6667,0.51,0.2239,72,507,579,507
6029,9/13/2011,3,0,9,18,0,2,1,1,0.7,0.6515,0.61,0.1642,67,472,539,472
6030,9/13/2011,3,0,9,19,0,2,1,1,0.68,0.6364,0.69,0.1642,55,341,396,341
6031,9/13/2011,3,0,9,20,0,2,1,1,0.66,0.6212,0.74,0.194,31,241,272,241
6032,9/13/2011,3,0,9,21,0,2,1,1,0.64,0.5909,0.78,0.1642,45,200,245,200
6033,9/13/2011,3,0,9,22,0,2,1,1,0.64,0.5909,0.78,0.1343,24,120,144,120
6034,9/13/2011,3,0,9,23,0,2,1,1,0.64,0.5909,0.78,0.1045,15,59,74,59
6035,9/14/2011,3,0,9,0,0,3,1,1,0.62,0.5909,0.78,0.0896,5,28,33,28
6036,9/14/2011,3,0,9,1,0,3,1,1,0.62,0.5909,0.78,0.0896,1,7,8,7
6037,9/14/2011,3,0,9,2,0,3,1,1,0.6,0.5606,0.83,0,1,4,5,4
6038,9/14/2011,3,0,9,3,0,3,1,1,0.6,0.5455,0.88,0.1343,1,7,8,7
6039,9/14/2011,3,0,9,4,0,3,1,1,0.6,0.5606,0.83,0.0896,1,8,9,8
6040,9/14/2011,3,0,9,5,0,3,1,1,0.58,0.5455,0.88,0.1045,1,30,31,30
6041,9/14/2011,3,0,9,6,0,3,1,1,0.58,0.5455,0.88,0.1045,7,138,145,138
6042,9/14/2011,3,0,9,7,0,3,1,1,0.6,0.5606,0.83,0.1045,20,350,370,350
6043,9/14/2011,3,0,9,8,0,3,1,1,0.62,0.5758,0.83,0.1642,33,396,429,396
6044,9/14/2011,3,0,9,9,0,3,1,1,0.64,0.5909,0.78,0.1642,19,183,202,183
6045,9/14/2011,3,0,9,10,0,3,1,1,0.7,0.6515,0.7,0.1343,27,115,142,115
6046,9/14/2011,3,0,9,11,0,3,1,1,0.72,0.6818,0.66,0.1642,43,121,164,121
6047,9/14/2011,3,0,9,12,0,3,1,1,0.74,0.6818,0.58,0.2239,56,156,212,156
6048,9/14/2011,3,0,9,13,0,3,1,1,0.76,0.697,0.55,0.2537,39,139,178,139
6049,9/14/2011,3,0,9,14,0,3,1,1,0.78,0.7121,0.52,0.2239,19,105,124,105
6050,9/14/2011,3,0,9,15,0,3,1,1,0.78,0.7121,0.49,0.2537,30,146,176,146
6051,9/14/2011,3,0,9,16,0,3,1,1,0.76,0.697,0.52,0.2836,36,241,277,241
6052,9/14/2011,3,0,9,17,0,3,1,1,0.76,0.697,0.52,0.2836,87,512,599,512
6053,9/14/2011,3,0,9,18,0,3,1,1,0.72,0.6818,0.62,0.1642,83,503,586,503
6054,9/14/2011,3,0,9,19,0,3,1,2,0.7,0.6515,0.7,0.1045,44,337,381,337
6055,9/14/2011,3,0,9,20,0,3,1,2,0.72,0.6667,0.58,0.4179,40,221,261,221
6056,9/14/2011,3,0,9,21,0,3,1,2,0.66,0.6212,0.65,0.2239,24,189,213,189
6057,9/14/2011,3,0,9,22,0,3,1,2,0.66,0.6212,0.65,0.1343,20,140,160,140
6058,9/14/2011,3,0,9,23,0,3,1,2,0.64,0.6061,0.69,0.1045,10,62,72,62
6059,9/15/2011,3,0,9,0,0,4,1,1,0.64,0.6061,0.69,0.1343,3,34,37,34
6060,9/15/2011,3,0,9,1,0,4,1,1,0.64,0.6061,0.69,0.1642,0,20,20,20
6061,9/15/2011,3,0,9,2,0,4,1,1,0.62,0.5909,0.73,0.1045,0,5,5,5
6062,9/15/2011,3,0,9,3,0,4,1,1,0.62,0.5909,0.73,0.0896,3,5,8,5
6063,9/15/2011,3,0,9,4,0,4,1,1,0.6,0.5758,0.78,0.1045,2,5,7,5
6064,9/15/2011,3,0,9,5,0,4,1,1,0.6,0.5758,0.78,0,1,30,31,30
6065,9/15/2011,3,0,9,6,0,4,1,2,0.6,0.5606,0.83,0.2537,5,119,124,119
6066,9/15/2011,3,0,9,7,0,4,1,2,0.62,0.5909,0.78,0.194,17,321,338,321
6067,9/15/2011,3,0,9,8,0,4,1,1,0.64,0.6061,0.73,0.1343,27,364,391,364
6068,9/15/2011,3,0,9,9,0,4,1,2,0.64,0.6061,0.73,0.3582,23,186,209,186
6069,9/15/2011,3,0,9,10,0,4,1,2,0.66,0.6212,0.69,0.2537,25,96,121,96
6070,9/15/2011,3,0,9,11,0,4,1,2,0.68,0.6364,0.65,0.1343,39,120,159,120
6071,9/15/2011,3,0,9,12,0,4,1,2,0.66,0.6212,0.69,0.2985,31,148,179,148
6072,9/15/2011,3,0,9,13,0,4,1,2,0.64,0.6061,0.65,0.2836,38,151,189,151
6073,9/15/2011,3,0,9,14,0,4,1,2,0.64,0.6061,0.65,0.4179,36,134,170,134
6074,9/15/2011,3,0,9,15,0,4,1,2,0.6,0.5909,0.69,0.4179,25,110,135,110
6075,9/15/2011,3,0,9,16,0,4,1,2,0.54,0.5152,0.77,0.4627,29,193,222,193
6076,9/15/2011,3,0,9,17,0,4,1,3,0.48,0.4697,0.82,0.4627,31,230,261,230
6077,9/15/2011,3,0,9,18,0,4,1,3,0.48,0.4697,0.67,0.6119,22,222,244,222
6078,9/15/2011,3,0,9,19,0,4,1,1,0.46,0.4545,0.67,0.4627,20,212,232,212
6079,9/15/2011,3,0,9,20,0,4,1,1,0.46,0.4545,0.63,0.3284,25,223,248,223
6080,9/15/2011,3,0,9,21,0,4,1,1,0.46,0.4545,0.63,0.3284,11,134,145,134
6081,9/15/2011,3,0,9,22,0,4,1,1,0.44,0.4394,0.67,0.2836,7,108,115,108
6082,9/15/2011,3,0,9,23,0,4,1,1,0.44,0.4394,0.67,0.2239,8,61,69,61
6083,9/16/2011,3,0,9,0,0,5,1,1,0.42,0.4242,0.71,0.2239,5,43,48,43
6084,9/16/2011,3,0,9,1,0,5,1,1,0.42,0.4242,0.67,0.194,7,19,26,19
6085,9/16/2011,3,0,9,2,0,5,1,1,0.4,0.4091,0.71,0.2836,3,7,10,7
6086,9/16/2011,3,0,9,3,0,5,1,1,0.4,0.4091,0.71,0.2537,2,4,6,4
6087,9/16/2011,3,0,9,4,0,5,1,1,0.4,0.4091,0.71,0.2836,1,3,4,3
6088,9/16/2011,3,0,9,5,0,5,1,1,0.38,0.3939,0.76,0.194,2,30,32,30
6089,9/16/2011,3,0,9,6,0,5,1,1,0.38,0.3939,0.71,0.2239,6,87,93,87
6090,9/16/2011,3,0,9,7,0,5,1,1,0.4,0.4091,0.71,0.2836,16,283,299,283
6091,9/16/2011,3,0,9,8,0,5,1,1,0.42,0.4242,0.67,0.2239,23,386,409,386
6092,9/16/2011,3,0,9,9,0,5,1,1,0.46,0.4545,0.55,0.2537,21,189,210,189
6093,9/16/2011,3,0,9,10,0,5,1,2,0.5,0.4848,0.51,0.2836,36,104,140,104
6094,9/16/2011,3,0,9,11,0,5,1,2,0.5,0.4848,0.51,0.1343,40,139,179,139
6095,9/16/2011,3,0,9,12,0,5,1,2,0.52,0.5,0.45,0,39,212,251,212
6096,9/16/2011,3,0,9,13,0,5,1,2,0.54,0.5152,0.42,0,55,168,223,168
6097,9/16/2011,3,0,9,14,0,5,1,2,0.54,0.5152,0.45,0.1642,49,176,225,176
6098,9/16/2011,3,0,9,15,0,5,1,2,0.54,0.5152,0.45,0.2239,38,165,203,165
6099,9/16/2011,3,0,9,16,0,5,1,2,0.52,0.5,0.48,0.1642,67,291,358,291
6100,9/16/2011,3,0,9,17,0,5,1,2,0.52,0.5,0.48,0.1343,86,480,566,480
6101,9/16/2011,3,0,9,18,0,5,1,2,0.52,0.5,0.52,0.1642,55,427,482,427
6102,9/16/2011,3,0,9,19,0,5,1,2,0.5,0.4848,0.55,0.1642,59,256,315,256
6103,9/16/2011,3,0,9,20,0,5,1,2,0.5,0.4848,0.55,0,41,184,225,184
6104,9/16/2011,3,0,9,21,0,5,1,2,0.5,0.4848,0.63,0,39,124,163,124
6105,9/16/2011,3,0,9,22,0,5,1,1,0.48,0.4697,0.67,0.0896,32,135,167,135
6106,9/16/2011,3,0,9,23,0,5,1,1,0.5,0.4848,0.59,0,20,106,126,106
6107,9/17/2011,3,0,9,0,0,6,0,1,0.46,0.4545,0.72,0.1642,28,80,108,80
6108,9/17/2011,3,0,9,1,0,6,0,1,0.46,0.4545,0.72,0.1045,28,52,80,52
6109,9/17/2011,3,0,9,2,0,6,0,1,0.46,0.4545,0.82,0.0896,18,61,79,61
6110,9/17/2011,3,0,9,3,0,6,0,1,0.46,0.4545,0.72,0.1343,7,21,28,21
6111,9/17/2011,3,0,9,4,0,6,0,1,0.46,0.4545,0.72,0.1343,1,4,5,4
6112,9/17/2011,3,0,9,5,0,6,0,1,0.46,0.4545,0.72,0.1642,2,3,5,3
6113,9/17/2011,3,0,9,6,0,6,0,2,0.46,0.4545,0.72,0.2239,5,17,22,17
6114,9/17/2011,3,0,9,7,0,6,0,2,0.46,0.4545,0.77,0.194,4,33,37,33
6115,9/17/2011,3,0,9,8,0,6,0,2,0.46,0.4545,0.77,0.2537,27,81,108,81
6116,9/17/2011,3,0,9,9,0,6,0,2,0.48,0.4697,0.67,0.2239,32,145,177,145
6117,9/17/2011,3,0,9,10,0,6,0,2,0.5,0.4848,0.68,0.2836,72,177,249,177
6118,9/17/2011,3,0,9,11,0,6,0,2,0.52,0.5,0.68,0.2239,119,248,367,248
6119,9/17/2011,3,0,9,12,0,6,0,2,0.52,0.5,0.67,0.2239,115,257,372,257
6120,9/17/2011,3,0,9,13,0,6,0,2,0.52,0.5,0.68,0.194,124,225,349,225
6121,9/17/2011,3,0,9,14,0,6,0,2,0.52,0.5,0.72,0.194,123,174,297,174
6122,9/17/2011,3,0,9,15,0,6,0,2,0.52,0.5,0.72,0.194,148,206,354,206
6123,9/17/2011,3,0,9,16,0,6,0,1,0.54,0.5152,0.68,0.2537,116,189,305,189
6124,9/17/2011,3,0,9,17,0,6,0,1,0.52,0.5,0.72,0.2239,141,218,359,218
6125,9/17/2011,3,0,9,18,0,6,0,2,0.52,0.5,0.72,0.2239,95,234,329,234
6126,9/17/2011,3,0,9,19,0,6,0,1,0.52,0.5,0.68,0.1343,70,186,256,186
6127,9/17/2011,3,0,9,20,0,6,0,1,0.52,0.5,0.68,0.1343,43,133,176,133
6128,9/17/2011,3,0,9,21,0,6,0,2,0.5,0.4848,0.72,0.194,49,121,170,121
6129,9/17/2011,3,0,9,22,0,6,0,1,0.5,0.4848,0.72,0.2239,31,112,143,112
6130,9/17/2011,3,0,9,23,0,6,0,1,0.46,0.4545,0.82,0.1642,36,100,136,100
6131,9/18/2011,3,0,9,0,0,0,0,1,0.46,0.4545,0.77,0.2239,24,88,112,88
6132,9/18/2011,3,0,9,1,0,0,0,1,0.46,0.4545,0.77,0.2239,13,66,79,66
6133,9/18/2011,3,0,9,2,0,0,0,1,0.44,0.4394,0.82,0.2537,21,68,89,68
6134,9/18/2011,3,0,9,3,0,0,0,1,0.44,0.4394,0.82,0.194,11,25,36,25
6135,9/18/2011,3,0,9,4,0,0,0,1,0.44,0.4394,0.77,0.2239,1,0,1,0
6136,9/18/2011,3,0,9,5,0,0,0,1,0.44,0.4394,0.77,0.2239,1,5,6,5
6137,9/18/2011,3,0,9,6,0,0,0,1,0.44,0.4394,0.77,0.2537,2,10,12,10
6138,9/18/2011,3,0,9,7,0,0,0,1,0.46,0.4545,0.72,0.2239,15,29,44,29
6139,9/18/2011,3,0,9,8,0,0,0,1,0.46,0.4545,0.72,0.2537,16,53,69,53
6140,9/18/2011,3,0,9,9,0,0,0,1,0.48,0.4697,0.67,0.2537,46,94,140,94
6141,9/18/2011,3,0,9,10,0,0,0,1,0.5,0.4848,0.72,0.1642,82,178,260,178
6142,9/18/2011,3,0,9,11,0,0,0,1,0.52,0.5,0.68,0.2239,116,201,317,201
6143,9/18/2011,3,0,9,12,0,0,0,1,0.54,0.5152,0.64,0.1343,135,229,364,229
6144,9/18/2011,3,0,9,13,0,0,0,1,0.56,0.5303,0.6,0.1343,162,214,376,214
6145,9/18/2011,3,0,9,14,0,0,0,2,0.58,0.5455,0.56,0.1343,127,184,311,184
6146,9/18/2011,3,0,9,15,0,0,0,2,0.58,0.5455,0.6,0.1343,132,233,365,233
6147,9/18/2011,3,0,9,16,0,0,0,2,0.56,0.5303,0.64,0.1642,134,235,369,235
6148,9/18/2011,3,0,9,17,0,0,0,2,0.56,0.5303,0.64,0.194,95,230,325,230
6149,9/18/2011,3,0,9,18,0,0,0,2,0.56,0.5303,0.6,0.1045,66,223,289,223
6150,9/18/2011,3,0,9,19,0,0,0,2,0.54,0.5152,0.68,0.1045,54,191,245,191
6151,9/18/2011,3,0,9,20,0,0,0,2,0.54,0.5152,0.68,0.0896,44,136,180,136
6152,9/18/2011,3,0,9,21,0,0,0,2,0.54,0.5152,0.68,0.0896,37,110,147,110
6153,9/18/2011,3,0,9,22,0,0,0,2,0.54,0.5152,0.68,0.0896,9,75,84,75
6154,9/18/2011,3,0,9,23,0,0,0,1,0.54,0.5152,0.68,0.194,10,44,54,44
6155,9/19/2011,3,0,9,0,0,1,1,2,0.52,0.5,0.72,0.1642,14,23,37,23
6156,9/19/2011,3,0,9,1,0,1,1,2,0.52,0.5,0.72,0.1045,3,7,10,7
6157,9/19/2011,3,0,9,2,0,1,1,2,0.52,0.5,0.72,0.1343,6,7,13,7
6158,9/19/2011,3,0,9,3,0,1,1,2,0.5,0.4848,0.77,0.1343,1,4,5,4
6159,9/19/2011,3,0,9,4,0,1,1,2,0.5,0.4848,0.77,0.1642,2,6,8,6
6160,9/19/2011,3,0,9,5,0,1,1,2,0.5,0.4848,0.77,0.194,2,26,28,26
6161,9/19/2011,3,0,9,6,0,1,1,1,0.5,0.4848,0.77,0.2239,6,107,113,107
6162,9/19/2011,3,0,9,7,0,1,1,2,0.5,0.4848,0.82,0.2239,20,312,332,312
6163,9/19/2011,3,0,9,8,0,1,1,2,0.52,0.5,0.77,0.1343,29,391,420,391
6164,9/19/2011,3,0,9,9,0,1,1,2,0.54,0.5152,0.68,0.1642,32,183,215,183
6165,9/19/2011,3,0,9,10,0,1,1,2,0.56,0.5303,0.64,0.1343,21,84,105,84
6166,9/19/2011,3,0,9,11,0,1,1,2,0.58,0.5455,0.64,0.1642,41,98,139,98
6167,9/19/2011,3,0,9,12,0,1,1,2,0.58,0.5455,0.6,0.0896,51,138,189,138
6168,9/19/2011,3,0,9,13,0,1,1,2,0.6,0.6061,0.6,0,53,124,177,124
6169,9/19/2011,3,0,9,14,0,1,1,2,0.6,0.6061,0.6,0.194,45,143,188,143
6170,9/19/2011,3,0,9,15,0,1,1,2,0.6,0.6061,0.6,0.2239,44,143,187,143
6171,9/19/2011,3,0,9,16,0,1,1,2,0.6,0.6061,0.6,0.1642,55,208,263,208
6172,9/19/2011,3,0,9,17,0,1,1,2,0.58,0.5455,0.64,0.1343,85,483,568,483
6173,9/19/2011,3,0,9,18,0,1,1,2,0.56,0.5303,0.68,0.1343,56,484,540,484
6174,9/19/2011,3,0,9,19,0,1,1,2,0.56,0.5303,0.68,0.1045,41,333,374,333
6175,9/19/2011,3,0,9,20,0,1,1,2,0.56,0.5303,0.68,0.1343,27,204,231,204
6176,9/19/2011,3,0,9,21,0,1,1,2,0.56,0.5303,0.68,0.1642,19,181,200,181
6177,9/19/2011,3,0,9,22,0,1,1,2,0.56,0.5303,0.68,0.1642,25,104,129,104
6178,9/19/2011,3,0,9,23,0,1,1,2,0.56,0.5303,0.73,0.194,13,55,68,55
6179,9/20/2011,3,0,9,0,0,2,1,2,0.56,0.5303,0.73,0.1642,4,21,25,21
6180,9/20/2011,3,0,9,1,0,2,1,2,0.54,0.5152,0.88,0.1642,3,11,14,11
6181,9/20/2011,3,0,9,2,0,2,1,2,0.54,0.5152,0.88,0.1642,1,4,5,4
6182,9/20/2011,3,0,9,3,0,2,1,2,0.54,0.5152,0.83,0.2239,0,3,3,3
6183,9/20/2011,3,0,9,4,0,2,1,1,0.54,0.5152,0.88,0.194,2,4,6,4
6184,9/20/2011,3,0,9,5,0,2,1,2,0.54,0.5152,0.88,0.194,1,21,22,21
6185,9/20/2011,3,0,9,6,0,2,1,2,0.54,0.5152,0.88,0.194,3,111,114,111
6186,9/20/2011,3,0,9,7,0,2,1,2,0.54,0.5152,0.88,0.1642,23,306,329,306
6187,9/20/2011,3,0,9,8,0,2,1,3,0.54,0.5152,0.94,0.2537,13,196,209,196
6188,9/20/2011,3,0,9,9,0,2,1,3,0.54,0.5152,0.94,0.2239,5,64,69,64
6189,9/20/2011,3,0,9,10,0,2,1,3,0.56,0.5303,0.88,0.1642,4,26,30,26
6190,9/20/2011,3,0,9,11,0,2,1,3,0.56,0.5303,0.88,0.1642,8,48,56,48
6191,9/20/2011,3,0,9,12,0,2,1,2,0.56,0.5303,0.94,0.1642,13,47,60,47
6192,9/20/2011,3,0,9,13,0,2,1,2,0.56,0.5303,0.94,0.1343,22,81,103,81
6193,9/20/2011,3,0,9,14,0,2,1,2,0.58,0.5455,0.88,0.194,27,85,112,85
6194,9/20/2011,3,0,9,15,0,2,1,2,0.62,0.5909,0.78,0.1045,34,158,192,158
6195,9/20/2011,3,0,9,16,0,2,1,2,0.6,0.5606,0.83,0.1642,23,241,264,241
6196,9/20/2011,3,0,9,17,0,2,1,1,0.6,0.5606,0.83,0.1045,66,445,511,445
6197,9/20/2011,3,0,9,18,0,2,1,1,0.6,0.5606,0.83,0.1045,39,453,492,453
6198,9/20/2011,3,0,9,19,0,2,1,1,0.58,0.5455,0.88,0,43,294,337,294
6199,9/20/2011,3,0,9,20,0,2,1,1,0.56,0.5303,0.94,0,41,212,253,212
6200,9/20/2011,3,0,9,21,0,2,1,1,0.56,0.5303,0.94,0,29,177,206,177
6201,9/20/2011,3,0,9,22,0,2,1,1,0.56,0.5303,0.94,0,23,125,148,125
6202,9/20/2011,3,0,9,23,0,2,1,1,0.56,0.5303,0.94,0,11,70,81,70
6203,9/21/2011,3,0,9,0,0,3,1,1,0.54,0.5152,1,0,7,20,27,20
6204,9/21/2011,3,0,9,1,0,3,1,1,0.54,0.5152,0.94,0,0,17,17,17
6205,9/21/2011,3,0,9,2,0,3,1,1,0.54,0.5152,0.94,0,1,5,6,5
6206,9/21/2011,3,0,9,3,0,3,1,2,0.54,0.5152,0.94,0.0896,0,6,6,6
6207,9/21/2011,3,0,9,4,0,3,1,2,0.54,0.5152,1,0.1343,2,5,7,5
6208,9/21/2011,3,0,9,5,0,3,1,2,0.54,0.5152,1,0.1642,1,30,31,30
6209,9/21/2011,3,0,9,6,0,3,1,2,0.54,0.5152,1,0.194,5,112,117,112
6210,9/21/2011,3,0,9,7,0,3,1,2,0.54,0.5152,1,0.194,18,312,330,312
6211,9/21/2011,3,0,9,8,0,3,1,2,0.54,0.5152,1,0.1045,18,444,462,444
6212,9/21/2011,3,0,9,9,0,3,1,2,0.56,0.5303,1,0.0896,21,187,208,187
6213,9/21/2011,3,0,9,10,0,3,1,2,0.6,0.5455,0.88,0,30,103,133,103
6214,9/21/2011,3,0,9,11,0,3,1,2,0.62,0.5758,0.83,0.1642,42,138,180,138
6215,9/21/2011,3,0,9,12,0,3,1,2,0.64,0.5909,0.78,0.0896,42,151,193,151
6216,9/21/2011,3,0,9,13,0,3,1,2,0.66,0.6212,0.74,0.1642,37,144,181,144
6217,9/21/2011,3,0,9,14,0,3,1,2,0.66,0.6212,0.74,0.194,40,139,179,139
6218,9/21/2011,3,0,9,15,0,3,1,2,0.66,0.6212,0.74,0.1045,43,142,185,142
6219,9/21/2011,3,0,9,16,0,3,1,2,0.66,0.6212,0.74,0.1045,51,230,281,230
6220,9/21/2011,3,0,9,17,0,3,1,3,0.66,0.6212,0.74,0.1642,61,475,536,475
6221,9/21/2011,3,0,9,18,0,3,1,3,0.64,0.5758,0.83,0.1642,24,384,408,384
6222,9/21/2011,3,0,9,19,0,3,1,3,0.62,0.5455,0.94,0,30,253,283,253
6223,9/21/2011,3,0,9,20,0,3,1,3,0.62,0.5455,0.94,0,11,149,160,149
6224,9/21/2011,3,0,9,21,0,3,1,2,0.6,0.5,1,0.0896,25,175,200,175
6225,9/21/2011,3,0,9,22,0,3,1,2,0.62,0.5455,0.94,0,15,112,127,112
6226,9/21/2011,3,0,9,23,0,3,1,1,0.6,0.5152,0.94,0.1045,15,80,95,80
6227,9/22/2011,3,0,9,0,0,4,1,1,0.6,0.5152,0.94,0.1045,11,30,41,30
6228,9/22/2011,3,0,9,1,0,4,1,2,0.6,0.5152,0.94,0.0896,5,6,11,6
6229,9/22/2011,3,0,9,2,0,4,1,2,0.6,0.5152,0.94,0.1045,2,8,10,8
6230,9/22/2011,3,0,9,3,0,4,1,2,0.6,0.5152,0.94,0.0896,5,7,12,7
6231,9/22/2011,3,0,9,4,0,4,1,2,0.6,0.5152,0.94,0.0896,0,2,2,2
6232,9/22/2011,3,0,9,5,0,4,1,2,0.6,0.5152,0.94,0.1045,2,28,30,28
6233,9/22/2011,3,0,9,6,0,4,1,2,0.6,0.5,1,0.1343,7,94,101,94
6234,9/22/2011,3,0,9,7,0,4,1,2,0.6,0.5,1,0.1045,16,295,311,295
6235,9/22/2011,3,0,9,8,0,4,1,2,0.6,0.5,1,0.1642,26,389,415,389
6236,9/22/2011,3,0,9,9,0,4,1,2,0.62,0.5455,0.94,0.194,35,168,203,168
6237,9/22/2011,3,0,9,10,0,4,1,2,0.64,0.5758,0.89,0.2239,19,101,120,101
6238,9/22/2011,3,0,9,11,0,4,1,2,0.64,0.5758,0.89,0.194,23,142,165,142
6239,9/22/2011,3,0,9,12,0,4,1,2,0.66,0.6061,0.83,0.1642,25,151,176,151
6240,9/22/2011,3,0,9,13,0,4,1,2,0.66,0.6061,0.83,0.194,38,155,193,155
6241,9/22/2011,3,0,9,14,0,4,1,2,0.66,0.6061,0.83,0.2239,41,142,183,142
6242,9/22/2011,3,0,9,15,0,4,1,2,0.68,0.6364,0.79,0.1642,32,149,181,149
6243,9/22/2011,3,0,9,16,0,4,1,2,0.68,0.6364,0.74,0.1343,39,262,301,262
6244,9/22/2011,3,0,9,17,0,4,1,2,0.66,0.6061,0.78,0.0896,50,513,563,513
6245,9/22/2011,3,0,9,18,0,4,1,2,0.64,0.5758,0.83,0.1045,50,501,551,501
6246,9/22/2011,3,0,9,19,0,4,1,2,0.64,0.5758,0.89,0.0896,32,388,420,388
6247,9/22/2011,3,0,9,20,0,4,1,2,0.62,0.5455,0.94,0.1343,35,250,285,250
6248,9/22/2011,3,0,9,21,0,4,1,2,0.64,0.5758,0.89,0.0896,27,194,221,194
6249,9/22/2011,3,0,9,22,0,4,1,2,0.62,0.5152,1,0.0896,21,166,187,166
6250,9/22/2011,3,0,9,23,0,4,1,2,0.62,0.5455,0.94,0,14,99,113,99
6251,9/23/2011,4,0,9,0,0,5,1,2,0.62,0.5455,0.94,0.0896,11,41,52,41
6252,9/23/2011,4,0,9,1,0,5,1,2,0.6,0.5,1,0,2,29,31,29
6253,9/23/2011,4,0,9,2,0,5,1,2,0.6,0.5,1,0.1045,6,14,20,14
6254,9/23/2011,4,0,9,3,0,5,1,2,0.6,0.5,1,0,3,5,8,5
6255,9/23/2011,4,0,9,4,0,5,1,3,0.6,0.5,1,0,6,7,13,7
6256,9/23/2011,4,0,9,5,0,5,1,2,0.62,0.5455,0.94,0,2,20,22,20
6257,9/23/2011,4,0,9,6,0,5,1,2,0.62,0.5455,0.94,0.0896,5,99,104,99
6258,9/23/2011,4,0,9,7,0,5,1,3,0.62,0.5455,0.94,0.1343,14,240,254,240
6259,9/23/2011,4,0,9,8,0,5,1,3,0.62,0.5455,0.94,0.1343,20,297,317,297
6260,9/23/2011,4,0,9,9,0,5,1,3,0.62,0.5152,1,0.1343,3,108,111,108
6261,9/23/2011,4,0,9,10,0,5,1,3,0.62,0.5152,1,0.1045,7,28,35,28
6262,9/23/2011,4,0,9,11,0,5,1,3,0.62,0.5152,1,0.1045,1,20,21,20
6263,9/23/2011,4,0,9,12,0,5,1,3,0.62,0.5455,0.94,0.1045,1,28,29,28
6264,9/23/2011,4,0,9,13,0,5,1,3,0.6,0.5,1,0.0896,7,27,34,27
6265,9/23/2011,4,0,9,14,0,5,1,3,0.6,0.5,1,0.0896,3,21,24,21
6266,9/23/2011,4,0,9,15,0,5,1,3,0.62,0.5455,0.94,0.1045,9,52,61,52
6267,9/23/2011,4,0,9,16,0,5,1,3,0.62,0.5455,0.94,0,5,51,56,51
6268,9/23/2011,4,0,9,17,0,5,1,2,0.6,0.5,1,0,13,86,99,86
6269,9/23/2011,4,0,9,18,0,5,1,1,0.6,0.5,1,0,14,220,234,220
6270,9/23/2011,4,0,9,19,0,5,1,1,0.62,0.5455,0.94,0.1343,16,232,248,232
6271,9/23/2011,4,0,9,20,0,5,1,1,0.6,0.5152,0.94,0,21,158,179,158
6272,9/23/2011,4,0,9,21,0,5,1,1,0.6,0.5,1,0.1642,17,121,138,121
6273,9/23/2011,4,0,9,22,0,5,1,1,0.6,0.5152,0.94,0.1642,31,126,157,126
6274,9/23/2011,4,0,9,23,0,5,1,2,0.58,0.5455,1,0.1343,41,107,148,107
6275,9/24/2011,4,0,9,0,0,6,0,1,0.58,0.5455,1,0.0896,7,86,93,86
6276,9/24/2011,4,0,9,1,0,6,0,2,0.58,0.5455,0.94,0.0896,18,61,79,61
6277,9/24/2011,4,0,9,2,0,6,0,2,0.58,0.5455,0.94,0.0896,14,54,68,54
6278,9/24/2011,4,0,9,3,0,6,0,1,0.58,0.5455,0.94,0,4,27,31,27
6279,9/24/2011,4,0,9,4,0,6,0,1,0.56,0.5303,0.94,0.1045,1,7,8,7
6280,9/24/2011,4,0,9,5,0,6,0,2,0.56,0.5303,0.94,0.1045,2,3,5,3
6281,9/24/2011,4,0,9,6,0,6,0,2,0.56,0.5303,0.94,0.1045,6,12,18,12
6282,9/24/2011,4,0,9,7,0,6,0,2,0.56,0.5303,0.88,0.1045,12,34,46,34
6283,9/24/2011,4,0,9,8,0,6,0,2,0.58,0.5455,0.9,0.0896,19,102,121,102
6284,9/24/2011,4,0,9,9,0,6,0,2,0.6,0.5455,0.88,0.0896,41,134,175,134
6285,9/24/2011,4,0,9,10,0,6,0,2,0.6,0.5455,0.88,0.0896,90,203,293,203
6286,9/24/2011,4,0,9,11,0,6,0,2,0.62,0.5758,0.83,0.0896,118,268,386,268
6287,9/24/2011,4,0,9,12,0,6,0,2,0.62,0.5758,0.83,0.0896,141,266,407,266
6288,9/24/2011,4,0,9,13,0,6,0,1,0.64,0.5909,0.78,0,170,290,460,290
6289,9/24/2011,4,0,9,14,0,6,0,2,0.66,0.6212,0.74,0.1343,164,226,390,226
6290,9/24/2011,4,0,9,15,0,6,0,2,0.66,0.6212,0.74,0.1343,168,284,452,284
6291,9/24/2011,4,0,9,16,0,6,0,2,0.64,0.5909,0.78,0.0896,167,282,449,282
6292,9/24/2011,4,0,9,17,0,6,0,1,0.66,0.6212,0.74,0.1045,180,246,426,246
6293,9/24/2011,4,0,9,18,0,6,0,1,0.64,0.5909,0.78,0.1045,157,243,400,243
6294,9/24/2011,4,0,9,19,0,6,0,1,0.62,0.5606,0.88,0,77,231,308,231
6295,9/24/2011,4,0,9,20,0,6,0,1,0.62,0.5758,0.83,0,77,166,243,166
6296,9/24/2011,4,0,9,21,0,6,0,1,0.62,0.5758,0.83,0.0896,66,156,222,156
6297,9/24/2011,4,0,9,22,0,6,0,2,0.62,0.5606,0.88,0,50,143,193,143
6298,9/24/2011,4,0,9,23,0,6,0,2,0.6,0.5455,0.88,0.0896,27,123,150,123
6299,9/25/2011,4,0,9,0,0,0,0,2,0.6,0.5455,0.88,0,37,136,173,136
6300,9/25/2011,4,0,9,1,0,0,0,2,0.6,0.5455,0.88,0.1045,31,93,124,93
6301,9/25/2011,4,0,9,2,0,0,0,3,0.6,0.5152,0.94,0,27,79,106,79
6302,9/25/2011,4,0,9,3,0,0,0,3,0.6,0.5152,0.94,0,20,39,59,39
6303,9/25/2011,4,0,9,4,0,0,0,3,0.6,0.5152,0.94,0.1343,3,5,8,5
6304,9/25/2011,4,0,9,5,0,0,0,1,0.6,0.5455,0.88,0.0896,1,2,3,2
6305,9/25/2011,4,0,9,6,0,0,0,2,0.6,0.5455,0.88,0.1045,4,13,17,13
6306,9/25/2011,4,0,9,7,0,0,0,2,0.6,0.5152,0.94,0.1343,15,23,38,23
6307,9/25/2011,4,0,9,8,0,0,0,2,0.62,0.5606,0.88,0,27,59,86,59
6308,9/25/2011,4,0,9,9,0,0,0,2,0.64,0.5758,0.83,0,55,100,155,100
6309,9/25/2011,4,0,9,10,0,0,0,2,0.64,0.5758,0.83,0,85,190,275,190
6310,9/25/2011,4,0,9,11,0,0,0,2,0.66,0.6061,0.78,0.1343,131,230,361,230
6311,9/25/2011,4,0,9,12,0,0,0,2,0.66,0.6061,0.78,0,143,270,413,270
6312,9/25/2011,4,0,9,13,0,0,0,2,0.68,0.6364,0.74,0,122,247,369,247
6313,9/25/2011,4,0,9,14,0,0,0,2,0.66,0.6061,0.78,0,116,231,347,231
6314,9/25/2011,4,0,9,15,0,0,0,2,0.66,0.6061,0.78,0,119,234,353,234
6315,9/25/2011,4,0,9,16,0,0,0,1,0.7,0.6515,0.7,0,144,320,464,320
6316,9/25/2011,4,0,9,17,0,0,0,1,0.68,0.6364,0.74,0,145,275,420,275
6317,9/25/2011,4,0,9,18,0,0,0,1,0.68,0.6364,0.74,0,125,279,404,279
6318,9/25/2011,4,0,9,19,0,0,0,1,0.64,0.5758,0.83,0.1343,87,242,329,242
6319,9/25/2011,4,0,9,20,0,0,0,1,0.64,0.5758,0.83,0.0896,51,135,186,135
6320,9/25/2011,4,0,9,21,0,0,0,1,0.62,0.5455,0.94,0.0896,24,113,137,113
6321,9/25/2011,4,0,9,22,0,0,0,1,0.62,0.5606,0.88,0.0896,20,84,104,84
6322,9/25/2011,4,0,9,23,0,0,0,2,0.62,0.5455,0.94,0.1045,12,67,79,67
6323,9/26/2011,4,0,9,0,0,1,1,2,0.62,0.5455,0.94,0,6,23,29,23
6324,9/26/2011,4,0,9,1,0,1,1,2,0.62,0.5606,0.88,0.1045,3,14,17,14
6325,9/26/2011,4,0,9,2,0,1,1,2,0.62,0.5606,0.88,0.1045,4,4,8,4
6326,9/26/2011,4,0,9,3,0,1,1,2,0.62,0.5455,0.94,0,0,5,5,5
6327,9/26/2011,4,0,9,4,0,1,1,2,0.62,0.5455,0.94,0.0896,2,4,6,4
6328,9/26/2011,4,0,9,5,0,1,1,2,0.62,0.5606,0.88,0,0,25,25,25
6329,9/26/2011,4,0,9,6,0,1,1,2,0.62,0.5455,0.94,0.0896,6,107,113,107
6330,9/26/2011,4,0,9,7,0,1,1,2,0.62,0.5455,0.94,0,17,315,332,315
6331,9/26/2011,4,0,9,8,0,1,1,2,0.62,0.5455,0.94,0,29,326,355,326
6332,9/26/2011,4,0,9,9,0,1,1,2,0.64,0.5758,0.89,0.194,44,161,205,161
6333,9/26/2011,4,0,9,10,0,1,1,2,0.64,0.5758,0.89,0.194,37,117,154,117
6334,9/26/2011,4,0,9,11,0,1,1,1,0.68,0.6364,0.79,0.2239,43,116,159,116
6335,9/26/2011,4,0,9,12,0,1,1,2,0.68,0.6364,0.79,0.1642,48,161,209,161
6336,9/26/2011,4,0,9,13,0,1,1,2,0.7,0.6667,0.74,0.1642,48,139,187,139
6337,9/26/2011,4,0,9,14,0,1,1,1,0.7,0.6515,0.7,0.1642,44,110,154,110
6338,9/26/2011,4,0,9,15,0,1,1,1,0.72,0.6818,0.62,0.1343,52,157,209,157
6339,9/26/2011,4,0,9,16,0,1,1,1,0.7,0.6515,0.65,0.1642,74,239,313,239
6340,9/26/2011,4,0,9,17,0,1,1,1,0.7,0.6515,0.7,0.1343,61,509,570,509
6341,9/26/2011,4,0,9,18,0,1,1,1,0.66,0.6061,0.83,0.1045,63,490,553,490
6342,9/26/2011,4,0,9,19,0,1,1,1,0.66,0.6061,0.82,0.0896,36,347,383,347
6343,9/26/2011,4,0,9,20,0,1,1,1,0.64,0.5758,0.89,0.1343,24,227,251,227
6344,9/26/2011,4,0,9,21,0,1,1,1,0.64,0.5758,0.89,0.1343,18,164,182,164
6345,9/26/2011,4,0,9,22,0,1,1,1,0.62,0.5455,0.94,0.1343,14,122,136,122
6346,9/26/2011,4,0,9,23,0,1,1,1,0.62,0.5455,0.94,0.1343,11,64,75,64
6347,9/27/2011,4,0,9,0,0,2,1,1,0.62,0.5455,0.94,0.1343,9,28,37,28
6348,9/27/2011,4,0,9,1,0,2,1,1,0.62,0.5455,0.94,0.1642,4,6,10,6
6349,9/27/2011,4,0,9,2,0,2,1,1,0.62,0.5455,0.94,0.1045,7,4,11,4
6350,9/27/2011,4,0,9,3,0,2,1,2,0.62,0.5455,0.94,0,5,5,10,5
6351,9/27/2011,4,0,9,4,0,2,1,3,0.62,0.5455,0.94,0.0896,5,3,8,3
6352,9/27/2011,4,0,9,5,0,2,1,3,0.62,0.5455,0.94,0.0896,0,24,24,24
6353,9/27/2011,4,0,9,6,0,2,1,2,0.62,0.5455,0.94,0.1045,8,116,124,116
6354,9/27/2011,4,0,9,7,0,2,1,2,0.62,0.5455,0.94,0.1045,15,234,249,234
6355,9/27/2011,4,0,9,8,0,2,1,2,0.64,0.5758,0.89,0.1045,27,400,427,400
6356,9/27/2011,4,0,9,9,0,2,1,3,0.64,0.5758,0.89,0.194,20,173,193,173
6357,9/27/2011,4,0,9,10,0,2,1,3,0.64,0.5606,0.94,0.1642,21,101,122,101
6358,9/27/2011,4,0,9,11,0,2,1,2,0.66,0.5909,0.89,0.1045,26,97,123,97
6359,9/27/2011,4,0,9,12,0,2,1,2,0.66,0.5909,0.89,0.1343,33,129,162,129
6360,9/27/2011,4,0,9,13,0,2,1,2,0.7,0.6667,0.74,0.2239,29,122,151,122
6361,9/27/2011,4,0,9,14,0,2,1,2,0.68,0.6364,0.79,0.1045,29,123,152,123
6362,9/27/2011,4,0,9,15,0,2,1,2,0.68,0.6364,0.83,0.0896,35,170,205,170
6363,9/27/2011,4,0,9,16,0,2,1,2,0.66,0.6061,0.83,0.194,33,225,258,225
6364,9/27/2011,4,0,9,17,0,2,1,2,0.66,0.5909,0.89,0.194,50,480,530,480
6365,9/27/2011,4,0,9,18,0,2,1,2,0.64,0.5758,0.89,0.2239,31,325,356,325
6366,9/27/2011,4,0,9,19,0,2,1,2,0.64,0.5758,0.89,0.1343,26,294,320,294
6367,9/27/2011,4,0,9,20,0,2,1,1,0.62,0.5909,0.78,0,17,221,238,221
6368,9/27/2011,4,0,9,21,0,2,1,1,0.6,0.5606,0.83,0,17,179,196,179
6369,9/27/2011,4,0,9,22,0,2,1,1,0.6,0.5455,0.88,0.0896,19,102,121,102
6370,9/27/2011,4,0,9,23,0,2,1,1,0.6,0.5455,0.88,0.0896,11,82,93,82
6371,9/28/2011,4,0,9,0,0,3,1,1,0.6,0.5455,0.88,0,7,29,36,29
6372,9/28/2011,4,0,9,1,0,3,1,1,0.6,0.5455,0.88,0,1,13,14,13
6373,9/28/2011,4,0,9,2,0,3,1,1,0.6,0.5455,0.88,0.2537,0,9,9,9
6374,9/28/2011,4,0,9,3,0,3,1,2,0.6,0.5152,0.94,0.0896,0,3,3,3
6375,9/28/2011,4,0,9,4,0,3,1,1,0.6,0.5455,0.88,0,1,3,4,3
6376,9/28/2011,4,0,9,5,0,3,1,2,0.6,0.5152,0.94,0,2,20,22,20
6377,9/28/2011,4,0,9,6,0,3,1,3,0.6,0.5152,0.94,0.1642,3,111,114,111
6378,9/28/2011,4,0,9,7,0,3,1,3,0.6,0.5152,0.94,0.1642,8,177,185,177
6379,9/28/2011,4,0,9,8,0,3,1,3,0.62,0.5455,0.94,0.2239,17,270,287,270
6380,9/28/2011,4,0,9,9,0,3,1,3,0.62,0.5455,0.94,0.2239,14,141,155,141
6381,9/28/2011,4,0,9,10,0,3,1,2,0.62,0.5455,0.94,0,20,109,129,109
6382,9/28/2011,4,0,9,11,0,3,1,2,0.66,0.6061,0.83,0.1045,24,127,151,127
6383,9/28/2011,4,0,9,12,0,3,1,2,0.68,0.6364,0.79,0,25,159,184,159
6384,9/28/2011,4,0,9,13,0,3,1,1,0.7,0.6667,0.74,0.2537,24,138,162,138
6385,9/28/2011,4,0,9,14,0,3,1,1,0.72,0.6818,0.62,0.2537,25,145,170,145
6386,9/28/2011,4,0,9,15,0,3,1,1,0.7,0.6515,0.7,0.1343,35,146,181,146
6387,9/28/2011,4,0,9,16,0,3,1,1,0.7,0.6515,0.7,0.194,39,241,280,241
6388,9/28/2011,4,0,9,17,0,3,1,1,0.7,0.6515,0.7,0.2239,64,527,591,527
6389,9/28/2011,4,0,9,18,0,3,1,3,0.66,0.6061,0.83,0.2537,65,459,524,459
6390,9/28/2011,4,0,9,19,0,3,1,3,0.66,0.6061,0.83,0.2537,57,315,372,315
6391,9/28/2011,4,0,9,20,0,3,1,3,0.6,0.5606,0.83,0.2985,11,91,102,91
6392,9/28/2011,4,0,9,21,0,3,1,3,0.6,0.5455,0.88,0.2537,7,67,74,67
6393,9/28/2011,4,0,9,22,0,3,1,1,0.6,0.5455,0.88,0.0896,19,68,87,68
6394,9/28/2011,4,0,9,23,0,3,1,1,0.6,0.5152,0.94,0.1343,12,59,71,59
6395,9/29/2011,4,0,9,0,0,4,1,1,0.6,0.5152,0.94,0.194,7,33,40,33
6396,9/29/2011,4,0,9,1,0,4,1,2,0.6,0.5,1,0.194,3,20,23,20
6397,9/29/2011,4,0,9,2,0,4,1,2,0.6,0.5,1,0.194,0,2,2,2
6398,9/29/2011,4,0,9,3,0,4,1,2,0.6,0.5152,0.94,0.194,0,8,8,8
6399,9/29/2011,4,0,9,4,0,4,1,2,0.6,0.5455,0.88,0.194,2,5,7,5
6400,9/29/2011,4,0,9,5,0,4,1,2,0.6,0.5455,0.88,0.1045,0,22,22,22
6401,9/29/2011,4,0,9,6,0,4,1,2,0.6,0.5455,0.88,0.0896,5,106,111,106
6402,9/29/2011,4,0,9,7,0,4,1,1,0.6,0.5455,0.88,0.1343,14,269,283,269
6403,9/29/2011,4,0,9,8,0,4,1,1,0.6,0.5606,0.83,0,29,402,431,402
6404,9/29/2011,4,0,9,9,0,4,1,1,0.62,0.5909,0.78,0.2537,27,198,225,198
6405,9/29/2011,4,0,9,10,0,4,1,1,0.64,0.6061,0.65,0.194,24,103,127,103
6406,9/29/2011,4,0,9,11,0,4,1,1,0.62,0.6061,0.61,0.194,36,122,158,122
6407,9/29/2011,4,0,9,12,0,4,1,1,0.66,0.6212,0.61,0.1642,38,157,195,157
6408,9/29/2011,4,0,9,13,0,4,1,1,0.64,0.6212,0.61,0.194,36,175,211,175
6409,9/29/2011,4,0,9,14,0,4,1,1,0.68,0.6364,0.51,0.2985,33,134,167,134
6410,9/29/2011,4,0,9,15,0,4,1,1,0.68,0.6364,0.45,0.3881,42,185,227,185
6411,9/29/2011,4,0,9,16,0,4,1,1,0.68,0.6364,0.41,0.3582,64,227,291,227
6412,9/29/2011,4,0,9,17,0,4,1,1,0.66,0.6212,0.47,0.2985,62,527,589,527
6413,9/29/2011,4,0,9,18,0,4,1,1,0.64,0.6212,0.41,0.2239,84,500,584,500
6414,9/29/2011,4,0,9,19,0,4,1,1,0.62,0.6212,0.5,0.0896,36,348,384,348
6415,9/29/2011,4,0,9,20,0,4,1,1,0.6,0.6212,0.53,0.0896,39,234,273,234
6416,9/29/2011,4,0,9,21,0,4,1,1,0.58,0.5455,0.56,0,30,195,225,195
6417,9/29/2011,4,0,9,22,0,4,1,1,0.56,0.5303,0.68,0,25,150,175,150
6418,9/29/2011,4,0,9,23,0,4,1,1,0.52,0.5,0.77,0.1045,17,64,81,64
6419,9/30/2011,4,0,9,0,0,5,1,1,0.52,0.5,0.83,0.1045,7,53,60,53
6420,9/30/2011,4,0,9,1,0,5,1,1,0.52,0.5,0.77,0.0896,5,18,23,18
6421,9/30/2011,4,0,9,2,0,5,1,1,0.52,0.5,0.83,0.1045,6,9,15,9
6422,9/30/2011,4,0,9,3,0,5,1,1,0.52,0.5,0.83,0.1045,0,3,3,3
6423,9/30/2011,4,0,9,4,0,5,1,1,0.52,0.5,0.83,0.194,2,6,8,6
6424,9/30/2011,4,0,9,5,0,5,1,1,0.52,0.5,0.83,0.194,3,23,26,23
6425,9/30/2011,4,0,9,6,0,5,1,1,0.52,0.5,0.83,0.2239,0,98,98,98
6426,9/30/2011,4,0,9,7,0,5,1,1,0.52,0.5,0.83,0.2239,14,283,297,283
6427,9/30/2011,4,0,9,8,0,5,1,1,0.54,0.5152,0.77,0.1343,31,425,456,425
6428,9/30/2011,4,0,9,9,0,5,1,1,0.56,0.5303,0.73,0.194,23,214,237,214
6429,9/30/2011,4,0,9,10,0,5,1,1,0.6,0.6061,0.64,0,46,122,168,122
6430,9/30/2011,4,0,9,11,0,5,1,1,0.64,0.6212,0.57,0.0896,49,168,217,168
6431,9/30/2011,4,0,9,12,0,5,1,2,0.64,0.6212,0.57,0.194,59,195,254,195
6432,9/30/2011,4,0,9,13,0,5,1,2,0.66,0.6212,0.47,0.3284,72,194,266,194
6433,9/30/2011,4,0,9,14,0,5,1,2,0.64,0.6212,0.47,0.2985,93,173,266,173
6434,9/30/2011,4,0,9,15,0,5,1,1,0.64,0.6212,0.5,0.2836,52,193,245,193
6435,9/30/2011,4,0,9,16,0,5,1,1,0.62,0.6212,0.53,0.2239,62,298,360,298
6436,9/30/2011,4,0,9,17,0,5,1,1,0.62,0.6212,0.53,0.194,94,497,591,497
6437,9/30/2011,4,0,9,18,0,5,1,1,0.58,0.5455,0.49,0.3582,62,449,511,449
6438,9/30/2011,4,0,9,19,0,5,1,1,0.54,0.5152,0.52,0.2836,42,332,374,332
6439,9/30/2011,4,0,9,20,0,5,1,1,0.54,0.5152,0.52,0.2836,28,202,230,202
6440,9/30/2011,4,0,9,21,0,5,1,1,0.52,0.5,0.55,0.194,27,179,206,179
6441,9/30/2011,4,0,9,22,0,5,1,1,0.52,0.5,0.55,0.3284,30,129,159,129
6442,9/30/2011,4,0,9,23,0,5,1,1,0.52,0.5,0.55,0.3284,23,109,132,109
6443,10/1/2011,4,0,10,0,0,6,0,1,0.5,0.4848,0.63,0.3881,24,106,130,106
6444,10/1/2011,4,0,10,1,0,6,0,1,0.48,0.4697,0.67,0.3284,11,47,58,47
6445,10/1/2011,4,0,10,2,0,6,0,1,0.46,0.4545,0.63,0.4179,21,46,67,46
6446,10/1/2011,4,0,10,3,0,6,0,1,0.46,0.4545,0.59,0.4179,8,17,25,17
6447,10/1/2011,4,0,10,4,0,6,0,1,0.44,0.4394,0.58,0.4179,2,6,8,6
6448,10/1/2011,4,0,10,5,0,6,0,2,0.44,0.4394,0.62,0.2985,1,4,5,4
6449,10/1/2011,4,0,10,6,0,6,0,1,0.42,0.4242,0.67,0.3284,4,15,19,15
6450,10/1/2011,4,0,10,7,0,6,0,3,0.42,0.4242,0.67,0.2537,6,30,36,30
6451,10/1/2011,4,0,10,8,0,6,0,2,0.4,0.4091,0.76,0.3284,9,58,67,58
6452,10/1/2011,4,0,10,9,0,6,0,3,0.4,0.4091,0.82,0.3582,17,112,129,112
6453,10/1/2011,4,0,10,10,0,6,0,3,0.4,0.4091,0.76,0.3582,21,100,121,100
6454,10/1/2011,4,0,10,11,0,6,0,3,0.38,0.3939,0.82,0.3284,30,102,132,102
6455,10/1/2011,4,0,10,12,0,6,0,2,0.4,0.4091,0.82,0.2537,28,130,158,130
6456,10/1/2011,4,0,10,13,0,6,0,2,0.4,0.4091,0.82,0.3284,27,98,125,98
6457,10/1/2011,4,0,10,14,0,6,0,2,0.42,0.4242,0.71,0.3582,33,147,180,147
6458,10/1/2011,4,0,10,15,0,6,0,2,0.42,0.4242,0.71,0.2836,41,154,195,154
6459,10/1/2011,4,0,10,16,0,6,0,2,0.4,0.4091,0.76,0.2985,58,165,223,165
6460,10/1/2011,4,0,10,17,0,6,0,3,0.4,0.4091,0.76,0.194,58,170,228,170
6461,10/1/2011,4,0,10,18,0,6,0,3,0.38,0.3939,0.87,0.2239,23,117,140,117
6462,10/1/2011,4,0,10,19,0,6,0,2,0.38,0.3939,0.82,0.194,27,99,126,99
6463,10/1/2011,4,0,10,20,0,6,0,3,0.36,0.3636,0.87,0.1045,8,58,66,58
6464,10/1/2011,4,0,10,21,0,6,0,3,0.36,0.3636,0.87,0.1045,3,53,56,53
6465,10/1/2011,4,0,10,22,0,6,0,2,0.36,0.3485,0.93,0.2239,12,58,70,58
6466,10/1/2011,4,0,10,23,0,6,0,3,0.36,0.3485,0.93,0.2239,8,57,65,57
6467,10/2/2011,4,0,10,0,0,0,0,3,0.36,0.3333,0.93,0.2985,4,43,47,43
6468,10/2/2011,4,0,10,1,0,0,0,3,0.34,0.3182,0.87,0.2537,1,23,24,23
6469,10/2/2011,4,0,10,2,0,0,0,3,0.34,0.303,0.87,0.2985,3,27,30,27
6470,10/2/2011,4,0,10,3,0,0,0,3,0.34,0.3182,0.87,0.2836,4,5,9,5
6471,10/2/2011,4,0,10,4,0,0,0,2,0.34,0.3182,0.87,0.2537,4,3,7,3
6472,10/2/2011,4,0,10,5,0,0,0,1,0.32,0.303,0.87,0.2836,0,7,7,7
6473,10/2/2011,4,0,10,6,0,0,0,1,0.32,0.3182,0.81,0.1642,2,13,15,13
6474,10/2/2011,4,0,10,7,0,0,0,1,0.34,0.3333,0.76,0.194,5,24,29,24
6475,10/2/2011,4,0,10,8,0,0,0,2,0.34,0.3333,0.76,0.194,14,50,64,50
6476,10/2/2011,4,0,10,9,0,0,0,1,0.36,0.3333,0.76,0.3582,19,96,115,96
6477,10/2/2011,4,0,10,10,0,0,0,2,0.36,0.3333,0.71,0.2836,60,188,248,188
6478,10/2/2011,4,0,10,11,0,0,0,2,0.38,0.3939,0.66,0.2537,74,218,292,218
6479,10/2/2011,4,0,10,12,0,0,0,2,0.4,0.4091,0.62,0.194,78,243,321,243
6480,10/2/2011,4,0,10,13,0,0,0,3,0.4,0.4091,0.62,0.2239,84,224,308,224
6481,10/2/2011,4,0,10,14,0,0,0,3,0.36,0.3485,0.81,0.1642,61,195,256,195
6482,10/2/2011,4,0,10,15,0,0,0,3,0.36,0.3333,0.81,0.2537,29,144,173,144
6483,10/2/2011,4,0,10,16,0,0,0,3,0.36,0.3485,0.87,0.194,44,162,206,162
6484,10/2/2011,4,0,10,17,0,0,0,3,0.36,0.3485,0.87,0.1642,32,135,167,135
6485,10/2/2011,4,0,10,18,0,0,0,2,0.36,0.3485,0.81,0.194,16,158,174,158
6486,10/2/2011,4,0,10,19,0,0,0,2,0.38,0.3939,0.76,0.1642,34,128,162,128
6487,10/2/2011,4,0,10,20,0,0,0,2,0.36,0.3333,0.76,0.2537,16,71,87,71
6488,10/2/2011,4,0,10,21,0,0,0,1,0.36,0.3485,0.71,0.2239,17,71,88,71
6489,10/2/2011,4,0,10,22,0,0,0,3,0.36,0.3636,0.81,0.0896,9,55,64,55
6490,10/2/2011,4,0,10,23,0,0,0,1,0.36,0.3636,0.81,0.0896,6,19,25,19
6491,10/3/2011,4,0,10,0,0,1,1,1,0.34,0.3485,0.87,0.1045,3,13,16,13
6492,10/3/2011,4,0,10,1,0,1,1,1,0.36,0.3636,0.81,0.0896,1,5,6,5
6493,10/3/2011,4,0,10,2,0,1,1,1,0.36,0.3636,0.76,0.1045,0,4,4,4
6494,10/3/2011,4,0,10,3,0,1,1,1,0.36,0.3788,0.81,0,1,6,7,6
6495,10/3/2011,4,0,10,4,0,1,1,1,0.34,0.3485,0.87,0.1045,2,6,8,6
6496,10/3/2011,4,0,10,5,0,1,1,2,0.36,0.3636,0.76,0.1045,4,17,21,17
6497,10/3/2011,4,0,10,6,0,1,1,2,0.36,0.3788,0.71,0,3,91,94,91
6498,10/3/2011,4,0,10,7,0,1,1,2,0.36,0.3485,0.71,0.1343,8,241,249,241
6499,10/3/2011,4,0,10,8,0,1,1,2,0.36,0.3636,0.71,0.1045,13,359,372,359
6500,10/3/2011,4,0,10,9,0,1,1,2,0.4,0.4091,0.66,0.0896,12,141,153,141
6501,10/3/2011,4,0,10,10,0,1,1,2,0.4,0.4091,0.66,0.1045,19,82,101,82
6502,10/3/2011,4,0,10,11,0,1,1,2,0.4,0.4091,0.71,0.2239,26,100,126,100
6503,10/3/2011,4,0,10,12,0,1,1,2,0.4,0.4091,0.71,0.1343,29,118,147,118
6504,10/3/2011,4,0,10,13,0,1,1,3,0.42,0.4242,0.67,0.1642,16,102,118,102
6505,10/3/2011,4,0,10,14,0,1,1,3,0.4,0.4091,0.76,0,26,94,120,94
6506,10/3/2011,4,0,10,15,0,1,1,3,0.4,0.4091,0.76,0,22,79,101,79
6507,10/3/2011,4,0,10,16,0,1,1,2,0.4,0.4091,0.76,0.1045,16,202,218,202
6508,10/3/2011,4,0,10,17,0,1,1,2,0.4,0.4091,0.76,0.1642,40,455,495,455
6509,10/3/2011,4,0,10,18,0,1,1,2,0.4,0.4091,0.76,0.1642,28,384,412,384
6510,10/3/2011,4,0,10,19,0,1,1,1,0.4,0.4091,0.76,0,15,300,315,300
6511,10/3/2011,4,0,10,20,0,1,1,3,0.4,0.4091,0.82,0,13,191,204,191
6512,10/3/2011,4,0,10,21,0,1,1,2,0.4,0.4091,0.82,0,10,128,138,128
6513,10/3/2011,4,0,10,22,0,1,1,2,0.4,0.4091,0.82,0,12,79,91,79
6514,10/3/2011,4,0,10,23,0,1,1,2,0.4,0.4091,0.82,0.1045,11,43,54,43
6515,10/4/2011,4,0,10,0,0,2,1,2,0.4,0.4091,0.87,0.0896,5,22,27,22
6516,10/4/2011,4,0,10,1,0,2,1,2,0.4,0.4091,0.87,0.1045,1,8,9,8
6517,10/4/2011,4,0,10,2,0,2,1,2,0.4,0.4091,0.87,0,1,2,3,2
6518,10/4/2011,4,0,10,3,0,2,1,1,0.4,0.4091,0.82,0.1045,3,3,6,3
6519,10/4/2011,4,0,10,4,0,2,1,1,0.4,0.4091,0.82,0.0896,3,4,7,4
6520,10/4/2011,4,0,10,5,0,2,1,1,0.4,0.4091,0.82,0.1343,2,25,27,25
6521,10/4/2011,4,0,10,6,0,2,1,1,0.4,0.4091,0.82,0.1045,3,109,112,109
6522,10/4/2011,4,0,10,7,0,2,1,1,0.42,0.4242,0.82,0.2836,11,298,309,298
6523,10/4/2011,4,0,10,8,0,2,1,1,0.44,0.4394,0.77,0.2239,28,372,400,372
6524,10/4/2011,4,0,10,9,0,2,1,1,0.46,0.4545,0.67,0.2537,19,168,187,168
6525,10/4/2011,4,0,10,10,0,2,1,1,0.48,0.4697,0.67,0.2836,19,107,126,107
6526,10/4/2011,4,0,10,11,0,2,1,1,0.54,0.5152,0.64,0.2836,22,102,124,102
6527,10/4/2011,4,0,10,12,0,2,1,1,0.56,0.5303,0.56,0.2985,39,160,199,160
6528,10/4/2011,4,0,10,13,0,2,1,1,0.56,0.5303,0.56,0.2985,20,153,173,153
6529,10/4/2011,4,0,10,14,0,2,1,1,0.58,0.5455,0.53,0.2537,27,156,183,156
6530,10/4/2011,4,0,10,15,0,2,1,1,0.58,0.5455,0.56,0.2836,28,166,194,166
6531,10/4/2011,4,0,10,16,0,2,1,1,0.58,0.5455,0.56,0.3284,36,273,309,273
6532,10/4/2011,4,0,10,17,0,2,1,1,0.56,0.5303,0.6,0.3881,55,530,585,530
6533,10/4/2011,4,0,10,18,0,2,1,1,0.54,0.5152,0.64,0.2836,68,456,524,456
6534,10/4/2011,4,0,10,19,0,2,1,1,0.52,0.5,0.68,0.2239,35,310,345,310
6535,10/4/2011,4,0,10,20,0,2,1,1,0.52,0.5,0.68,0.2239,25,236,261,236
6536,10/4/2011,4,0,10,21,0,2,1,1,0.5,0.4848,0.72,0.1343,22,144,166,144
6537,10/4/2011,4,0,10,22,0,2,1,1,0.5,0.4848,0.72,0.1343,8,106,114,106
6538,10/4/2011,4,0,10,23,0,2,1,1,0.48,0.4697,0.77,0.1343,6,60,66,60
6539,10/5/2011,4,0,10,0,0,3,1,1,0.48,0.4697,0.77,0.1343,7,36,43,36
6540,10/5/2011,4,0,10,1,0,3,1,1,0.48,0.4697,0.77,0.1642,4,7,11,7
6541,10/5/2011,4,0,10,2,0,3,1,1,0.46,0.4545,0.82,0.1642,1,2,3,2
6542,10/5/2011,4,0,10,3,0,3,1,1,0.46,0.4545,0.82,0.1045,1,5,6,5
6543,10/5/2011,4,0,10,4,0,3,1,1,0.44,0.4394,0.88,0,1,4,5,4
6544,10/5/2011,4,0,10,5,0,3,1,1,0.44,0.4394,0.82,0.1343,3,29,32,29
6545,10/5/2011,4,0,10,6,0,3,1,1,0.44,0.4394,0.82,0.1045,5,112,117,112
6546,10/5/2011,4,0,10,7,0,3,1,1,0.46,0.4545,0.77,0.1045,9,292,301,292
6547,10/5/2011,4,0,10,8,0,3,1,1,0.52,0.5,0.63,0,26,441,467,441
6548,10/5/2011,4,0,10,9,0,3,1,1,0.54,0.5152,0.6,0.2985,32,187,219,187
6549,10/5/2011,4,0,10,10,0,3,1,1,0.56,0.5303,0.56,0.3881,30,103,133,103
6550,10/5/2011,4,0,10,11,0,3,1,1,0.6,0.6212,0.46,0.2836,32,138,170,138
6551,10/5/2011,4,0,10,12,0,3,1,1,0.62,0.6212,0.43,0.3284,34,180,214,180
6552,10/5/2011,4,0,10,13,0,3,1,1,0.64,0.6212,0.41,0.2239,30,189,219,189
6553,10/5/2011,4,0,10,14,0,3,1,1,0.64,0.6212,0.41,0.2836,34,156,190,156
6554,10/5/2011,4,0,10,15,0,3,1,1,0.64,0.6212,0.47,0.2836,35,147,182,147
6555,10/5/2011,4,0,10,16,0,3,1,1,0.64,0.6212,0.47,0.3284,37,245,282,245
6556,10/5/2011,4,0,10,17,0,3,1,1,0.64,0.6212,0.47,0.2537,66,525,591,525
6557,10/5/2011,4,0,10,18,0,3,1,1,0.6,0.6212,0.53,0.1642,57,536,593,536
6558,10/5/2011,4,0,10,19,0,3,1,1,0.58,0.5455,0.56,0.1343,40,334,374,334
6559,10/5/2011,4,0,10,20,0,3,1,1,0.52,0.5,0.77,0.1642,18,228,246,228
6560,10/5/2011,4,0,10,21,0,3,1,1,0.5,0.4848,0.82,0.1045,28,173,201,173
6561,10/5/2011,4,0,10,22,0,3,1,1,0.52,0.5,0.72,0,20,134,154,134
6562,10/5/2011,4,0,10,23,0,3,1,1,0.5,0.4848,0.77,0.1045,9,64,73,64
6563,10/6/2011,4,0,10,0,0,4,1,1,0.5,0.4848,0.72,0.194,6,34,40,34
6564,10/6/2011,4,0,10,1,0,4,1,1,0.48,0.4697,0.63,0.194,5,17,22,17
6565,10/6/2011,4,0,10,2,0,4,1,1,0.46,0.4545,0.67,0.194,2,8,10,8
6566,10/6/2011,4,0,10,3,0,4,1,1,0.44,0.4394,0.67,0.2239,1,4,5,4
6567,10/6/2011,4,0,10,4,0,4,1,1,0.44,0.4394,0.62,0.2836,0,5,5,5
6568,10/6/2011,4,0,10,5,0,4,1,1,0.42,0.4242,0.62,0.194,0,24,24,24
6569,10/6/2011,4,0,10,6,0,4,1,1,0.4,0.4091,0.66,0.194,4,110,114,110
6570,10/6/2011,4,0,10,7,0,4,1,1,0.42,0.4242,0.62,0.194,15,287,302,287
6571,10/6/2011,4,0,10,8,0,4,1,1,0.44,0.4394,0.62,0.1642,20,437,457,437
6572,10/6/2011,4,0,10,9,0,4,1,1,0.46,0.4545,0.63,0.194,20,188,208,188
6573,10/6/2011,4,0,10,10,0,4,1,1,0.52,0.5,0.52,0,24,105,129,105
6574,10/6/2011,4,0,10,11,0,4,1,1,0.54,0.5152,0.49,0,29,115,144,115
6575,10/6/2011,4,0,10,12,0,4,1,1,0.56,0.5303,0.49,0.0896,46,180,226,180
6576,10/6/2011,4,0,10,13,0,4,1,1,0.56,0.5303,0.46,0.0896,33,158,191,158
6577,10/6/2011,4,0,10,14,0,4,1,1,0.58,0.5455,0.43,0.0896,56,139,195,139
6578,10/6/2011,4,0,10,15,0,4,1,1,0.58,0.5455,0.46,0.1343,62,157,219,157
6579,10/6/2011,4,0,10,16,0,4,1,1,0.58,0.5455,0.49,0.194,51,272,323,272
6580,10/6/2011,4,0,10,17,0,4,1,1,0.56,0.5303,0.52,0.1343,63,505,568,505
6581,10/6/2011,4,0,10,18,0,4,1,1,0.54,0.5152,0.64,0.0896,59,479,538,479
6582,10/6/2011,4,0,10,19,0,4,1,1,0.52,0.5,0.59,0.1045,38,305,343,305
6583,10/6/2011,4,0,10,20,0,4,1,1,0.5,0.4848,0.77,0.1045,29,231,260,231
6584,10/6/2011,4,0,10,21,0,4,1,1,0.46,0.4545,0.88,0.0896,34,161,195,161
6585,10/6/2011,4,0,10,22,0,4,1,1,0.46,0.4545,0.82,0,24,124,148,124
6586,10/6/2011,4,0,10,23,0,4,1,1,0.44,0.4394,0.88,0.0896,18,81,99,81
6587,10/7/2011,4,0,10,0,0,5,1,1,0.44,0.4394,0.88,0,19,48,67,48
6588,10/7/2011,4,0,10,1,0,5,1,1,0.44,0.4394,0.88,0,3,25,28,25
6589,10/7/2011,4,0,10,2,0,5,1,1,0.42,0.4242,0.88,0,0,5,5,5
6590,10/7/2011,4,0,10,3,0,5,1,1,0.4,0.4091,0.87,0,1,9,10,9
6591,10/7/2011,4,0,10,4,0,5,1,1,0.4,0.4091,0.87,0.1045,0,5,5,5
6592,10/7/2011,4,0,10,5,0,5,1,1,0.42,0.4242,0.82,0,3,24,27,24
6593,10/7/2011,4,0,10,6,0,5,1,1,0.42,0.4242,0.88,0,3,84,87,84
6594,10/7/2011,4,0,10,7,0,5,1,1,0.42,0.4242,0.94,0,5,237,242,237
6595,10/7/2011,4,0,10,8,0,5,1,1,0.46,0.4545,0.82,0,31,386,417,386
6596,10/7/2011,4,0,10,9,0,5,1,1,0.48,0.4697,0.77,0,34,207,241,207
6597,10/7/2011,4,0,10,10,0,5,1,1,0.52,0.5,0.68,0.0896,48,126,174,126
6598,10/7/2011,4,0,10,11,0,5,1,1,0.56,0.5303,0.63,0,80,150,230,150
6599,10/7/2011,4,0,10,12,0,5,1,1,0.6,0.6212,0.53,0,61,174,235,174
6600,10/7/2011,4,0,10,13,0,5,1,1,0.6,0.6212,0.46,0,95,210,305,210
6601,10/7/2011,4,0,10,14,0,5,1,1,0.62,0.6212,0.5,0,77,179,256,179
6602,10/7/2011,4,0,10,15,0,5,1,1,0.66,0.6212,0.41,0,68,202,270,202
6603,10/7/2011,4,0,10,16,0,5,1,1,0.64,0.6212,0.44,0,73,346,419,346
6604,10/7/2011,4,0,10,17,0,5,1,1,0.6,0.6212,0.56,0.2537,101,462,563,462
6605,10/7/2011,4,0,10,18,0,5,1,1,0.56,0.5303,0.6,0.0896,94,371,465,371
6606,10/7/2011,4,0,10,19,0,5,1,1,0.56,0.5303,0.52,0,51,243,294,243
6607,10/7/2011,4,0,10,20,0,5,1,1,0.54,0.5152,0.49,0,30,167,197,167
6608,10/7/2011,4,0,10,21,0,5,1,1,0.5,0.4848,0.68,0,22,144,166,144
6609,10/7/2011,4,0,10,22,0,5,1,1,0.5,0.4848,0.68,0,27,119,146,119
6610,10/7/2011,4,0,10,23,0,5,1,1,0.5,0.4848,0.63,0,23,113,136,113
6611,10/8/2011,4,0,10,0,0,6,0,1,0.48,0.4697,0.72,0,17,72,89,72
6612,10/8/2011,4,0,10,1,0,6,0,1,0.46,0.4545,0.82,0,14,51,65,51
6613,10/8/2011,4,0,10,2,0,6,0,1,0.46,0.4545,0.82,0,4,41,45,41
6614,10/8/2011,4,0,10,3,0,6,0,1,0.44,0.4394,0.88,0,4,16,20,16
6615,10/8/2011,4,0,10,4,0,6,0,1,0.42,0.4242,0.94,0.1343,3,7,10,7
6616,10/8/2011,4,0,10,5,0,6,0,1,0.42,0.4242,0.88,0.1045,1,7,8,7
6617,10/8/2011,4,0,10,6,0,6,0,1,0.42,0.4242,0.94,0,6,16,22,16
6618,10/8/2011,4,0,10,7,0,6,0,1,0.42,0.4242,0.94,0.0896,27,46,73,46
6619,10/8/2011,4,0,10,8,0,6,0,1,0.46,0.4545,0.82,0,14,89,103,89
6620,10/8/2011,4,0,10,9,0,6,0,1,0.5,0.4848,0.77,0,54,163,217,163
6621,10/8/2011,4,0,10,10,0,6,0,1,0.52,0.5,0.77,0,120,217,337,217
6622,10/8/2011,4,0,10,11,0,6,0,1,0.58,0.5455,0.56,0,176,221,397,221
6623,10/8/2011,4,0,10,12,0,6,0,1,0.62,0.6212,0.35,0,191,255,446,255
6624,10/8/2011,4,0,10,13,0,6,0,1,0.62,0.6212,0.46,0.1045,256,229,485,229
6625,10/8/2011,4,0,10,14,0,6,0,1,0.62,0.6212,0.5,0.0896,251,214,465,214
6626,10/8/2011,4,0,10,15,0,6,0,1,0.66,0.6212,0.39,0,262,234,496,234
6627,10/8/2011,4,0,10,16,0,6,0,1,0.64,0.6212,0.44,0.0896,221,230,451,230
6628,10/8/2011,4,0,10,17,0,6,0,1,0.62,0.6212,0.5,0.1343,174,219,393,219
6629,10/8/2011,4,0,10,18,0,6,0,1,0.6,0.6212,0.46,0.1045,135,224,359,224
6630,10/8/2011,4,0,10,19,0,6,0,1,0.54,0.5152,0.68,0.1343,76,172,248,172
6631,10/8/2011,4,0,10,20,0,6,0,1,0.52,0.5,0.77,0.1045,78,124,202,124
6632,10/8/2011,4,0,10,21,0,6,0,1,0.52,0.5,0.77,0,54,133,187,133
6633,10/8/2011,4,0,10,22,0,6,0,1,0.5,0.4848,0.77,0,45,104,149,104
6634,10/8/2011,4,0,10,23,0,6,0,1,0.48,0.4697,0.88,0,52,90,142,90
6635,10/9/2011,4,0,10,0,0,0,0,1,0.46,0.4545,0.88,0.0896,46,83,129,83
6636,10/9/2011,4,0,10,1,0,0,0,1,0.46,0.4545,0.88,0,15,63,78,63
6637,10/9/2011,4,0,10,2,0,0,0,1,0.46,0.4545,0.88,0,20,35,55,35
6638,10/9/2011,4,0,10,3,0,0,0,1,0.44,0.4394,0.88,0,10,20,30,20
6639,10/9/2011,4,0,10,4,0,0,0,1,0.44,0.4394,0.88,0,7,7,14,7
6640,10/9/2011,4,0,10,5,0,0,0,1,0.44,0.4394,0.88,0,1,14,15,14
6641,10/9/2011,4,0,10,6,0,0,0,1,0.44,0.4394,0.88,0,7,14,21,14
6642,10/9/2011,4,0,10,7,0,0,0,1,0.44,0.4394,0.86,0,18,26,44,26
6643,10/9/2011,4,0,10,8,0,0,0,1,0.46,0.4545,0.88,0,25,82,107,82
6644,10/9/2011,4,0,10,9,0,0,0,1,0.5,0.4848,0.77,0,66,119,185,119
6645,10/9/2011,4,0,10,10,0,0,0,1,0.56,0.5303,0.68,0.0896,155,210,365,210
6646,10/9/2011,4,0,10,11,0,0,0,1,0.62,0.6212,0.53,0.0896,189,234,423,234
6647,10/9/2011,4,0,10,12,0,0,0,1,0.64,0.6212,0.44,0.0896,212,243,455,243
6648,10/9/2011,4,0,10,13,0,0,0,1,0.66,0.6212,0.44,0.0896,225,193,418,193
6649,10/9/2011,4,0,10,14,0,0,0,1,0.68,0.6364,0.47,0.1642,272,228,500,228
6650,10/9/2011,4,0,10,15,0,0,0,1,0.68,0.6364,0.51,0.1642,198,209,407,209
6651,10/9/2011,4,0,10,16,0,0,0,1,0.66,0.6212,0.5,0.1343,223,247,470,247
6652,10/9/2011,4,0,10,17,0,0,0,1,0.62,0.6061,0.61,0.1045,208,230,438,230
6653,10/9/2011,4,0,10,18,0,0,0,1,0.64,0.6212,0.5,0.1045,186,228,414,228
6654,10/9/2011,4,0,10,19,0,0,0,1,0.56,0.5303,0.73,0.0896,116,186,302,186
6655,10/9/2011,4,0,10,20,0,0,0,1,0.56,0.5303,0.73,0.1045,59,134,193,134
6656,10/9/2011,4,0,10,21,0,0,0,1,0.54,0.5152,0.83,0.1045,53,120,173,120
6657,10/9/2011,4,0,10,22,0,0,0,2,0.52,0.5,0.94,0,48,104,152,104
6658,10/9/2011,4,0,10,23,0,0,0,1,0.5,0.4848,0.88,0.1045,38,85,123,85
6659,10/10/2011,4,0,10,0,1,1,0,1,0.5,0.4848,0.94,0,11,42,53,42
6660,10/10/2011,4,0,10,1,1,1,0,1,0.48,0.4697,0.88,0,4,30,34,30
6661,10/10/2011,4,0,10,2,1,1,0,1,0.48,0.4697,0.88,0,4,15,19,15
6662,10/10/2011,4,0,10,3,1,1,0,1,0.46,0.4545,0.88,0,2,9,11,9
6663,10/10/2011,4,0,10,4,1,1,0,1,0.46,0.4545,0.94,0,2,4,6,4
6664,10/10/2011,4,0,10,5,1,1,0,1,0.46,0.4545,0.94,0,2,19,21,19
6665,10/10/2011,4,0,10,6,1,1,0,1,0.44,0.4394,0.94,0,5,39,44,39
6666,10/10/2011,4,0,10,7,1,1,0,1,0.46,0.4545,0.88,0,12,102,114,102
6667,10/10/2011,4,0,10,8,1,1,0,1,0.52,0.5,0.83,0,27,227,254,227
6668,10/10/2011,4,0,10,9,1,1,0,1,0.54,0.5152,0.77,0,58,161,219,161
6669,10/10/2011,4,0,10,10,1,1,0,1,0.56,0.5303,0.73,0.1642,107,158,265,158
6670,10/10/2011,4,0,10,11,1,1,0,1,0.62,0.6061,0.69,0.0896,139,183,322,183
6671,10/10/2011,4,0,10,12,1,1,0,2,0.7,0.6515,0.48,0.0896,164,201,365,201
6672,10/10/2011,4,0,10,13,1,1,0,1,0.72,0.6515,0.37,0,146,219,365,219
6673,10/10/2011,4,0,10,14,1,1,0,1,0.74,0.6515,0.37,0,147,223,370,223
6674,10/10/2011,4,0,10,15,1,1,0,2,0.72,0.6515,0.42,0.1045,130,254,384,254
6675,10/10/2011,4,0,10,16,1,1,0,2,0.7,0.6364,0.45,0.0896,154,248,402,248
6676,10/10/2011,4,0,10,17,1,1,0,2,0.66,0.6212,0.54,0.1045,125,334,459,334
6677,10/10/2011,4,0,10,18,1,1,0,2,0.64,0.6212,0.53,0,108,365,473,365
6678,10/10/2011,4,0,10,19,1,1,0,2,0.58,0.5455,0.78,0.0896,69,267,336,267
6679,10/10/2011,4,0,10,20,1,1,0,1,0.6,0.5909,0.73,0,37,188,225,188
6680,10/10/2011,4,0,10,21,1,1,0,1,0.56,0.5303,0.88,0.0896,27,148,175,148
6681,10/10/2011,4,0,10,22,1,1,0,1,0.56,0.5303,0.88,0.0896,22,104,126,104
6682,10/10/2011,4,0,10,23,1,1,0,2,0.54,0.5152,0.88,0.1045,12,63,75,63
6683,10/11/2011,4,0,10,0,0,2,1,2,0.54,0.5152,0.88,0,14,16,30,16
6684,10/11/2011,4,0,10,1,0,2,1,2,0.52,0.5,0.94,0.0896,2,9,11,9
6685,10/11/2011,4,0,10,2,0,2,1,2,0.52,0.5,0.94,0.1343,1,4,5,4
6686,10/11/2011,4,0,10,3,0,2,1,2,0.52,0.5,0.88,0.1045,2,1,3,1
6687,10/11/2011,4,0,10,4,0,2,1,2,0.52,0.5,0.88,0.1343,0,5,5,5
6688,10/11/2011,4,0,10,5,0,2,1,2,0.52,0.5,0.88,0,0,20,20,20
6689,10/11/2011,4,0,10,6,0,2,1,1,0.52,0.5,0.83,0.0896,9,114,123,114
6690,10/11/2011,4,0,10,7,0,2,1,2,0.52,0.5,0.88,0.0896,19,333,352,333
6691,10/11/2011,4,0,10,8,0,2,1,2,0.56,0.5303,0.83,0.1045,31,375,406,375
6692,10/11/2011,4,0,10,9,0,2,1,2,0.6,0.5909,0.69,0,40,195,235,195
6693,10/11/2011,4,0,10,10,0,2,1,2,0.6,0.5909,0.69,0.1343,38,111,149,111
6694,10/11/2011,4,0,10,11,0,2,1,2,0.6,0.5909,0.73,0.1642,31,92,123,92
6695,10/11/2011,4,0,10,12,0,2,1,2,0.6,0.5909,0.73,0.1642,51,130,181,130
6696,10/11/2011,4,0,10,13,0,2,1,2,0.6,0.5909,0.73,0.194,42,138,180,138
6697,10/11/2011,4,0,10,14,0,2,1,3,0.6,0.5909,0.73,0.1045,54,117,171,117
6698,10/11/2011,4,0,10,15,0,2,1,2,0.6,0.5758,0.78,0.1642,36,139,175,139
6699,10/11/2011,4,0,10,16,0,2,1,2,0.6,0.5909,0.73,0.1642,63,257,320,257
6700,10/11/2011,4,0,10,17,0,2,1,2,0.6,0.5758,0.78,0.2537,70,534,604,534
6701,10/11/2011,4,0,10,18,0,2,1,2,0.6,0.5758,0.78,0.2239,46,493,539,493
6702,10/11/2011,4,0,10,19,0,2,1,2,0.58,0.5455,0.83,0.2239,33,285,318,285
6703,10/11/2011,4,0,10,20,0,2,1,2,0.58,0.5455,0.83,0.2239,31,203,234,203
6704,10/11/2011,4,0,10,21,0,2,1,2,0.58,0.5455,0.78,0.194,17,158,175,158
6705,10/11/2011,4,0,10,22,0,2,1,2,0.56,0.5303,0.83,0.194,27,120,147,120
6706,10/11/2011,4,0,10,23,0,2,1,2,0.56,0.5303,0.83,0.2836,10,47,57,47
6707,10/12/2011,4,0,10,0,0,3,1,2,0.56,0.5303,0.83,0.1343,2,23,25,23
6708,10/12/2011,4,0,10,1,0,3,1,3,0.56,0.5303,0.83,0.1343,2,8,10,8
6709,10/12/2011,4,0,10,2,0,3,1,2,0.56,0.5303,0.83,0.2836,0,2,2,2
6710,10/12/2011,4,0,10,3,0,3,1,3,0.54,0.5152,0.94,0.2985,0,2,2,2
6711,10/12/2011,4,0,10,4,0,3,1,3,0.54,0.5152,0.94,0.3881,1,6,7,6
6712,10/12/2011,4,0,10,5,0,3,1,2,0.54,0.5152,0.88,0.3284,0,22,22,22
6713,10/12/2011,4,0,10,6,0,3,1,2,0.54,0.5152,0.88,0.2537,5,107,112,107
6714,10/12/2011,4,0,10,7,0,3,1,2,0.54,0.5152,0.88,0.3881,15,244,259,244
6715,10/12/2011,4,0,10,8,0,3,1,2,0.54,0.5152,0.88,0.3881,27,377,404,377
6716,10/12/2011,4,0,10,9,0,3,1,2,0.54,0.5152,0.88,0.4478,14,183,197,183
6717,10/12/2011,4,0,10,10,0,3,1,2,0.54,0.5152,0.88,0.3881,15,98,113,98
6718,10/12/2011,4,0,10,11,0,3,1,3,0.54,0.5152,0.94,0.3284,18,102,120,102
6719,10/12/2011,4,0,10,12,0,3,1,3,0.54,0.5152,0.88,0.3284,9,53,62,53
6720,10/12/2011,4,0,10,13,0,3,1,3,0.54,0.5152,0.88,0.2239,25,76,101,76
6721,10/12/2011,4,0,10,14,0,3,1,3,0.54,0.5152,0.94,0.2836,8,70,78,70
6722,10/12/2011,4,0,10,15,0,3,1,3,0.54,0.5152,0.94,0.2537,3,42,45,42
6723,10/12/2011,4,0,10,16,0,3,1,2,0.56,0.5303,0.88,0.2239,5,50,55,50
6724,10/12/2011,4,0,10,17,0,3,1,3,0.54,0.5152,0.94,0.2239,16,235,251,235
6725,10/12/2011,4,0,10,18,0,3,1,3,0.54,0.5152,0.94,0.1343,11,161,172,161
6726,10/12/2011,4,0,10,19,0,3,1,3,0.54,0.5152,0.94,0.1343,7,102,109,102
6727,10/12/2011,4,0,10,20,0,3,1,3,0.54,0.5152,0.94,0.1045,9,81,90,81
6728,10/12/2011,4,0,10,21,0,3,1,3,0.54,0.5152,1,0.1045,9,74,83,74
6729,10/12/2011,4,0,10,22,0,3,1,3,0.54,0.5152,0.94,0.0896,3,40,43,40
6730,10/12/2011,4,0,10,23,0,3,1,3,0.54,0.5152,0.94,0.0896,13,41,54,41
6731,10/13/2011,4,0,10,0,0,4,1,2,0.54,0.5152,0.94,0.1343,1,14,15,14
6732,10/13/2011,4,0,10,1,0,4,1,2,0.54,0.5152,0.94,0,3,9,12,9
6733,10/13/2011,4,0,10,2,0,4,1,2,0.54,0.5152,0.94,0,0,4,4,4
6734,10/13/2011,4,0,10,3,0,4,1,2,0.54,0.5152,1,0.194,2,4,6,4
6735,10/13/2011,4,0,10,4,0,4,1,2,0.54,0.5152,1,0.1045,2,5,7,5
6736,10/13/2011,4,0,10,5,0,4,1,2,0.54,0.5152,1,0.1045,1,16,17,16
6737,10/13/2011,4,0,10,6,0,4,1,3,0.54,0.5152,1,0.0896,1,51,52,51
6738,10/13/2011,4,0,10,7,0,4,1,3,0.54,0.5152,1,0.1343,5,76,81,76
6739,10/13/2011,4,0,10,8,0,4,1,3,0.54,0.5152,1,0.0896,10,199,209,199
6740,10/13/2011,4,0,10,9,0,4,1,3,0.56,0.5303,1,0.1045,3,106,109,106
6741,10/13/2011,4,0,10,10,0,4,1,3,0.56,0.5303,1,0.1343,16,53,69,53
6742,10/13/2011,4,0,10,11,0,4,1,2,0.62,0.5758,0.83,0,8,76,84,76
6743,10/13/2011,4,0,10,12,0,4,1,2,0.62,0.5606,0.88,0,10,95,105,95
6744,10/13/2011,4,0,10,13,0,4,1,2,0.64,0.5758,0.83,0.1642,20,142,162,142
6745,10/13/2011,4,0,10,14,0,4,1,1,0.66,0.6061,0.78,0.194,22,111,133,111
6746,10/13/2011,4,0,10,15,0,4,1,1,0.66,0.6061,0.78,0.194,27,128,155,128
6747,10/13/2011,4,0,10,16,0,4,1,1,0.66,0.6212,0.74,0.2239,36,240,276,240
6748,10/13/2011,4,0,10,17,0,4,1,3,0.62,0.5758,0.83,0.2537,47,432,479,432
6749,10/13/2011,4,0,10,18,0,4,1,3,0.62,0.5758,0.83,0.2537,20,248,268,248
6750,10/13/2011,4,0,10,19,0,4,1,2,0.62,0.5758,0.83,0.1642,18,187,205,187
6751,10/13/2011,4,0,10,20,0,4,1,1,0.62,0.5758,0.83,0.2836,15,166,181,166
6752,10/13/2011,4,0,10,21,0,4,1,1,0.62,0.5758,0.83,0.194,8,115,123,115
6753,10/13/2011,4,0,10,22,0,4,1,1,0.62,0.5758,0.83,0.194,13,101,114,101
6754,10/13/2011,4,0,10,23,0,4,1,2,0.58,0.5455,0.88,0.194,2,45,47,45
6755,10/14/2011,4,0,10,0,0,5,1,1,0.58,0.5455,0.94,0.0896,10,29,39,29
6756,10/14/2011,4,0,10,1,0,5,1,1,0.58,0.5455,0.94,0.1343,8,16,24,16
6757,10/14/2011,4,0,10,2,0,5,1,1,0.56,0.5303,0.94,0.1642,0,6,6,6
6758,10/14/2011,4,0,10,3,0,5,1,1,0.56,0.5303,0.94,0.1343,1,6,7,6
6759,10/14/2011,4,0,10,4,0,5,1,1,0.56,0.5303,0.94,0.194,0,8,8,8
6760,10/14/2011,4,0,10,5,0,5,1,2,0.56,0.5303,0.94,0.1642,0,17,17,17
6761,10/14/2011,4,0,10,6,0,5,1,3,0.56,0.5303,0.88,0.194,4,90,94,90
6762,10/14/2011,4,0,10,7,0,5,1,3,0.56,0.5303,0.88,0.194,10,137,147,137
6763,10/14/2011,4,0,10,8,0,5,1,2,0.56,0.5303,0.9,0.1642,23,186,209,186
6764,10/14/2011,4,0,10,9,0,5,1,2,0.56,0.5303,0.94,0.2239,16,164,180,164
6765,10/14/2011,4,0,10,10,0,5,1,3,0.54,0.5152,0.88,0.3582,17,108,125,108
6766,10/14/2011,4,0,10,11,0,5,1,3,0.52,0.5,0.88,0.1642,11,76,87,76
6767,10/14/2011,4,0,10,12,0,5,1,3,0.52,0.5,0.88,0.1642,13,62,75,62
6768,10/14/2011,4,0,10,13,0,5,1,1,0.56,0.5303,0.73,0.3582,18,114,132,114
6769,10/14/2011,4,0,10,14,0,5,1,1,0.62,0.6212,0.43,0.3582,37,119,156,119
6770,10/14/2011,4,0,10,15,0,5,1,1,0.62,0.6212,0.43,0.2836,61,169,230,169
6771,10/14/2011,4,0,10,16,0,5,1,1,0.6,0.6212,0.43,0.2239,80,264,344,264
6772,10/14/2011,4,0,10,17,0,5,1,1,0.58,0.5455,0.46,0.4179,55,426,481,426
6773,10/14/2011,4,0,10,18,0,5,1,1,0.54,0.5152,0.39,0.2836,62,361,423,361
6774,10/14/2011,4,0,10,19,0,5,1,1,0.54,0.5152,0.39,0.3284,27,221,248,221
6775,10/14/2011,4,0,10,20,0,5,1,1,0.52,0.5,0.42,0.194,19,177,196,177
6776,10/14/2011,4,0,10,21,0,5,1,1,0.5,0.4848,0.45,0.194,22,156,178,156
6777,10/14/2011,4,0,10,22,0,5,1,1,0.46,0.4545,0.59,0.2239,20,123,143,123
6778,10/14/2011,4,0,10,23,0,5,1,1,0.46,0.4545,0.59,0.1642,15,80,95,80
6779,10/15/2011,4,0,10,0,0,6,0,1,0.46,0.4545,0.55,0.1045,18,88,106,88
6780,10/15/2011,4,0,10,1,0,6,0,1,0.46,0.4545,0.55,0.2537,9,64,73,64
6781,10/15/2011,4,0,10,2,0,6,0,1,0.46,0.4545,0.59,0.194,17,39,56,39
6782,10/15/2011,4,0,10,3,0,6,0,1,0.44,0.4394,0.62,0.194,5,18,23,18
6783,10/15/2011,4,0,10,4,0,6,0,1,0.42,0.4242,0.67,0.1343,0,6,6,6
6784,10/15/2011,4,0,10,5,0,6,0,1,0.42,0.4242,0.71,0.1642,1,6,7,6
6785,10/15/2011,4,0,10,6,0,6,0,1,0.4,0.4091,0.71,0,5,15,20,15
6786,10/15/2011,4,0,10,7,0,6,0,1,0.4,0.4091,0.76,0.1045,17,40,57,40
6787,10/15/2011,4,0,10,8,0,6,0,1,0.46,0.4545,0.59,0.2836,24,101,125,101
6788,10/15/2011,4,0,10,9,0,6,0,1,0.52,0.5,0.48,0.2985,50,157,207,157
6789,10/15/2011,4,0,10,10,0,6,0,1,0.54,0.5152,0.45,0.4478,115,207,322,207
6790,10/15/2011,4,0,10,11,0,6,0,1,0.56,0.5303,0.4,0.3881,153,221,374,221
6791,10/15/2011,4,0,10,12,0,6,0,1,0.58,0.5455,0.35,0.5522,195,261,456,261
6792,10/15/2011,4,0,10,13,0,6,0,1,0.6,0.6212,0.35,0.4627,171,223,394,223
6793,10/15/2011,4,0,10,14,0,6,0,1,0.6,0.6212,0.33,0.4627,242,230,472,230
6794,10/15/2011,4,0,10,15,0,6,0,1,0.62,0.6212,0.31,0.4925,166,211,377,211
6795,10/15/2011,4,0,10,16,0,6,0,1,0.62,0.6212,0.29,0.3881,179,264,443,264
6796,10/15/2011,4,0,10,17,0,6,0,1,0.58,0.5455,0.32,0.2836,177,264,441,264
6797,10/15/2011,4,0,10,18,0,6,0,1,0.54,0.5152,0.39,0.194,121,251,372,251
6798,10/15/2011,4,0,10,19,0,6,0,1,0.5,0.4848,0.51,0.1343,61,177,238,177
6799,10/15/2011,4,0,10,20,0,6,0,1,0.5,0.4848,0.48,0.1343,42,137,179,137
6800,10/15/2011,4,0,10,21,0,6,0,1,0.5,0.4848,0.42,0.2239,53,115,168,115
6801,10/15/2011,4,0,10,22,0,6,0,1,0.5,0.4848,0.36,0.1343,45,121,166,121
6802,10/15/2011,4,0,10,23,0,6,0,1,0.48,0.4697,0.41,0.1642,33,102,135,102
6803,10/16/2011,4,0,10,0,0,0,0,1,0.46,0.4545,0.44,0.1343,22,85,107,85
6804,10/16/2011,4,0,10,1,0,0,0,1,0.44,0.4394,0.47,0.1343,13,64,77,64
6805,10/16/2011,4,0,10,2,0,0,0,1,0.42,0.4242,0.54,0.1343,13,52,65,52
6806,10/16/2011,4,0,10,3,0,0,0,1,0.42,0.4242,0.54,0.1343,11,31,42,31
6807,10/16/2011,4,0,10,4,0,0,0,1,0.42,0.4242,0.54,0.194,5,7,12,7
6808,10/16/2011,4,0,10,5,0,0,0,1,0.42,0.4242,0.54,0.1642,1,6,7,6
6809,10/16/2011,4,0,10,6,0,0,0,1,0.38,0.3939,0.66,0.1642,3,7,10,7
6810,10/16/2011,4,0,10,7,0,0,0,1,0.4,0.4091,0.62,0.1343,9,39,48,39
6811,10/16/2011,4,0,10,8,0,0,0,1,0.44,0.4394,0.62,0.194,28,71,99,71
6812,10/16/2011,4,0,10,9,0,0,0,1,0.5,0.4848,0.45,0.2239,39,151,190,151
6813,10/16/2011,4,0,10,10,0,0,0,1,0.54,0.5152,0.45,0.2537,121,226,347,226
6814,10/16/2011,4,0,10,11,0,0,0,1,0.56,0.5303,0.35,0.2836,159,218,377,218
6815,10/16/2011,4,0,10,12,0,0,0,1,0.58,0.5455,0.35,0.2537,167,277,444,277
6816,10/16/2011,4,0,10,13,0,0,0,1,0.6,0.6212,0.35,0.2985,169,269,438,269
6817,10/16/2011,4,0,10,14,0,0,0,1,0.6,0.6212,0.4,0.2985,204,258,462,258
6818,10/16/2011,4,0,10,15,0,0,0,1,0.62,0.6212,0.35,0.3881,182,230,412,230
6819,10/16/2011,4,0,10,16,0,0,0,1,0.6,0.6212,0.46,0.3881,177,289,466,289
6820,10/16/2011,4,0,10,17,0,0,0,1,0.58,0.5455,0.49,0.4627,152,253,405,253
6821,10/16/2011,4,0,10,18,0,0,0,1,0.56,0.5303,0.49,0.4478,102,226,328,226
6822,10/16/2011,4,0,10,19,0,0,0,1,0.54,0.5152,0.52,0.3881,52,181,233,181
6823,10/16/2011,4,0,10,20,0,0,0,1,0.54,0.5152,0.52,0.4627,49,129,178,129
6824,10/16/2011,4,0,10,21,0,0,0,1,0.54,0.5152,0.52,0.3881,14,88,102,88
6825,10/16/2011,4,0,10,22,0,0,0,1,0.56,0.5303,0.49,0.4179,42,88,130,88
6826,10/16/2011,4,0,10,23,0,0,0,1,0.56,0.5303,0.52,0.4179,14,48,62,48
6827,10/17/2011,4,0,10,0,0,1,1,1,0.54,0.5152,0.56,0.3284,12,25,37,25
6828,10/17/2011,4,0,10,1,0,1,1,1,0.56,0.5303,0.54,0.3881,2,15,17,15
6829,10/17/2011,4,0,10,2,0,1,1,1,0.56,0.5303,0.54,0.3881,4,3,7,3
6830,10/17/2011,4,0,10,3,0,1,1,1,0.56,0.5303,0.49,0.194,0,2,2,2
6831,10/17/2011,4,0,10,4,0,1,1,1,0.52,0.5,0.59,0.1642,2,3,5,3
6832,10/17/2011,4,0,10,5,0,1,1,1,0.5,0.4848,0.63,0.2985,1,28,29,28
6833,10/17/2011,4,0,10,6,0,1,1,1,0.5,0.4848,0.55,0.2537,7,107,114,107
6834,10/17/2011,4,0,10,7,0,1,1,2,0.5,0.4848,0.55,0.1642,10,299,309,299
6835,10/17/2011,4,0,10,8,0,1,1,2,0.5,0.4848,0.51,0.2537,33,381,414,381
6836,10/17/2011,4,0,10,9,0,1,1,2,0.5,0.4848,0.45,0.2836,26,180,206,180
6837,10/17/2011,4,0,10,10,0,1,1,1,0.52,0.5,0.45,0.1642,43,92,135,92
6838,10/17/2011,4,0,10,11,0,1,1,1,0.56,0.5303,0.43,0,35,131,166,131
6839,10/17/2011,4,0,10,12,0,1,1,1,0.56,0.5303,0.4,0.0896,39,166,205,166
6840,10/17/2011,4,0,10,13,0,1,1,1,0.56,0.5303,0.46,0.0896,49,156,205,156
6841,10/17/2011,4,0,10,14,0,1,1,1,0.58,0.5455,0.49,0.194,44,122,166,122
6842,10/17/2011,4,0,10,15,0,1,1,1,0.56,0.5303,0.6,0.2537,66,142,208,142
6843,10/17/2011,4,0,10,16,0,1,1,1,0.58,0.5455,0.56,0.2537,64,238,302,238
6844,10/17/2011,4,0,10,17,0,1,1,1,0.56,0.5303,0.64,0.1343,80,540,620,540
6845,10/17/2011,4,0,10,18,0,1,1,1,0.56,0.5303,0.6,0,49,469,518,469
6846,10/17/2011,4,0,10,19,0,1,1,1,0.54,0.5152,0.68,0.1045,45,288,333,288
6847,10/17/2011,4,0,10,20,0,1,1,1,0.52,0.5,0.77,0.1045,40,189,229,189
6848,10/17/2011,4,0,10,21,0,1,1,1,0.5,0.4848,0.77,0.1045,36,141,177,141
6849,10/17/2011,4,0,10,22,0,1,1,1,0.5,0.4848,0.77,0,16,88,104,88
6850,10/17/2011,4,0,10,23,0,1,1,2,0.48,0.4697,0.88,0,10,52,62,52
6851,10/18/2011,4,0,10,0,0,2,1,1,0.48,0.4697,0.82,0,8,23,31,23
6852,10/18/2011,4,0,10,1,0,2,1,2,0.46,0.4545,0.88,0,4,7,11,7
6853,10/18/2011,4,0,10,2,0,2,1,1,0.44,0.4394,0.94,0.0896,1,4,5,4
6854,10/18/2011,4,0,10,3,0,2,1,1,0.44,0.4394,0.94,0.0896,0,1,1,1
6855,10/18/2011,4,0,10,4,0,2,1,2,0.44,0.4394,0.94,0.1045,0,4,4,4
6856,10/18/2011,4,0,10,5,0,2,1,2,0.46,0.4545,0.88,0,2,19,21,19
6857,10/18/2011,4,0,10,6,0,2,1,1,0.46,0.4545,0.82,0.0896,4,105,109,105
6858,10/18/2011,4,0,10,7,0,2,1,1,0.46,0.4545,0.88,0.0896,15,326,341,326
6859,10/18/2011,4,0,10,8,0,2,1,1,0.5,0.4848,0.77,0.0896,25,474,499,474
6860,10/18/2011,4,0,10,9,0,2,1,2,0.52,0.5,0.77,0.0896,29,198,227,198
6861,10/18/2011,4,0,10,10,0,2,1,2,0.56,0.5303,0.68,0,27,75,102,75
6862,10/18/2011,4,0,10,11,0,2,1,2,0.6,0.6212,0.49,0.1045,35,112,147,112
6863,10/18/2011,4,0,10,12,0,2,1,2,0.62,0.6212,0.43,0.0896,42,159,201,159
6864,10/18/2011,4,0,10,13,0,2,1,2,0.64,0.6212,0.38,0.194,48,171,219,171
6865,10/18/2011,4,0,10,14,0,2,1,2,0.62,0.6212,0.41,0.1642,32,137,169,137
6866,10/18/2011,4,0,10,15,0,2,1,1,0.62,0.6212,0.5,0.194,66,139,205,139
6867,10/18/2011,4,0,10,16,0,2,1,1,0.62,0.6212,0.57,0.2537,58,246,304,246
6868,10/18/2011,4,0,10,17,0,2,1,1,0.6,0.6061,0.6,0.1343,72,553,625,553
6869,10/18/2011,4,0,10,18,0,2,1,1,0.56,0.5303,0.68,0.1045,58,512,570,512
6870,10/18/2011,4,0,10,19,0,2,1,1,0.56,0.5303,0.6,0.1045,31,286,317,286
6871,10/18/2011,4,0,10,20,0,2,1,1,0.54,0.5152,0.64,0.1642,23,204,227,204
6872,10/18/2011,4,0,10,21,0,2,1,2,0.54,0.5152,0.68,0.1343,28,178,206,178
6873,10/18/2011,4,0,10,22,0,2,1,2,0.52,0.5,0.77,0.1642,22,115,137,115
6874,10/18/2011,4,0,10,23,0,2,1,2,0.52,0.5,0.77,0.194,7,63,70,63
6875,10/19/2011,4,0,10,0,0,3,1,2,0.52,0.5,0.77,0.194,11,23,34,23
6876,10/19/2011,4,0,10,1,0,3,1,2,0.52,0.5,0.77,0.194,7,9,16,9
6877,10/19/2011,4,0,10,2,0,3,1,2,0.52,0.5,0.77,0.194,1,6,7,6
6878,10/19/2011,4,0,10,4,0,3,1,3,0.5,0.4848,0.94,0.194,0,3,3,3
6879,10/19/2011,4,0,10,5,0,3,1,3,0.5,0.4848,1,0.1045,0,3,3,3
6880,10/19/2011,4,0,10,6,0,3,1,3,0.52,0.5,0.83,0.2537,3,28,31,28
6881,10/19/2011,4,0,10,7,0,3,1,3,0.52,0.5,0.77,0.2537,1,67,68,67
6882,10/19/2011,4,0,10,8,0,3,1,3,0.54,0.5152,0.7,0.4925,10,200,210,200
6883,10/19/2011,4,0,10,9,0,3,1,3,0.52,0.5,0.88,0.4925,17,185,202,185
6884,10/19/2011,4,0,10,10,0,3,1,3,0.52,0.5,0.88,0.4925,14,109,123,109
6885,10/19/2011,4,0,10,11,0,3,1,3,0.52,0.5,0.94,0.2537,33,116,149,116
6886,10/19/2011,4,0,10,12,0,3,1,3,0.52,0.5,0.94,0.3284,13,117,130,117
6887,10/19/2011,4,0,10,13,0,3,1,2,0.54,0.5152,0.94,0.2836,20,86,106,86
6888,10/19/2011,4,0,10,14,0,3,1,3,0.54,0.5152,0.94,0.1642,17,80,97,80
6889,10/19/2011,4,0,10,15,0,3,1,3,0.54,0.5152,1,0.1343,21,99,120,99
6890,10/19/2011,4,0,10,16,0,3,1,3,0.56,0.5303,0.94,0.1642,21,180,201,180
6891,10/19/2011,4,0,10,17,0,3,1,3,0.56,0.5303,0.94,0.1642,11,170,181,170
6892,10/19/2011,4,0,10,18,0,3,1,3,0.56,0.5303,1,0.1642,8,132,140,132
6893,10/19/2011,4,0,10,19,0,3,1,2,0.6,0.5455,0.88,0.1343,8,189,197,189
6894,10/19/2011,4,0,10,20,0,3,1,3,0.6,0.5152,0.94,0.0896,5,140,145,140
6895,10/19/2011,4,0,10,21,0,3,1,2,0.58,0.5455,0.94,0.1343,6,79,85,79
6896,10/19/2011,4,0,10,22,0,3,1,2,0.58,0.5455,0.94,0.3582,13,94,107,94
6897,10/19/2011,4,0,10,23,0,3,1,2,0.58,0.5455,0.94,0.3582,14,55,69,55
6898,10/20/2011,4,0,10,0,0,4,1,1,0.56,0.5303,0.94,0.2985,4,22,26,22
6899,10/20/2011,4,0,10,1,0,4,1,1,0.56,0.5303,0.88,0.3582,4,11,15,11
6900,10/20/2011,4,0,10,2,0,4,1,1,0.56,0.5303,0.88,0.4478,0,4,4,4
6901,10/20/2011,4,0,10,3,0,4,1,1,0.5,0.4848,0.82,0.4627,0,1,1,1
6902,10/20/2011,4,0,10,4,0,4,1,1,0.5,0.4848,0.82,0.4627,2,6,8,6
6903,10/20/2011,4,0,10,5,0,4,1,1,0.48,0.4697,0.82,0.3582,2,24,26,24
6904,10/20/2011,4,0,10,6,0,4,1,1,0.44,0.4394,0.82,0.4179,5,87,92,87
6905,10/20/2011,4,0,10,7,0,4,1,1,0.42,0.4242,0.77,0.4478,15,303,318,303
6906,10/20/2011,4,0,10,8,0,4,1,1,0.44,0.4394,0.67,0.5224,17,409,426,409
6907,10/20/2011,4,0,10,9,0,4,1,1,0.44,0.4394,0.67,0.5821,26,197,223,197
6908,10/20/2011,4,0,10,10,0,4,1,1,0.46,0.4545,0.59,0.4478,25,105,130,105
6909,10/20/2011,4,0,10,11,0,4,1,1,0.48,0.4697,0.55,0.5224,30,99,129,99
6910,10/20/2011,4,0,10,12,0,4,1,1,0.48,0.4697,0.48,0.5224,28,171,199,171
6911,10/20/2011,4,0,10,13,0,4,1,1,0.5,0.4848,0.45,0.5821,28,136,164,136
6912,10/20/2011,4,0,10,14,0,4,1,2,0.48,0.4697,0.48,0.5522,38,117,155,117
6913,10/20/2011,4,0,10,15,0,4,1,2,0.48,0.4697,0.51,0.4478,22,138,160,138
6914,10/20/2011,4,0,10,16,0,4,1,2,0.48,0.4697,0.51,0.4478,31,203,234,203
6915,10/20/2011,4,0,10,17,0,4,1,2,0.48,0.4697,0.48,0.3881,56,438,494,438
6916,10/20/2011,4,0,10,18,0,4,1,2,0.46,0.4545,0.51,0.2985,39,430,469,430
6917,10/20/2011,4,0,10,19,0,4,1,1,0.46,0.4545,0.51,0.3582,20,278,298,278
6918,10/20/2011,4,0,10,20,0,4,1,2,0.46,0.4545,0.51,0.3284,34,207,241,207
6919,10/20/2011,4,0,10,21,0,4,1,1,0.44,0.4394,0.51,0.2985,16,149,165,149
6920,10/20/2011,4,0,10,22,0,4,1,1,0.44,0.4394,0.51,0.3284,22,106,128,106
6921,10/20/2011,4,0,10,23,0,4,1,1,0.42,0.4242,0.58,0.2537,7,83,90,83
6922,10/21/2011,4,0,10,0,0,5,1,1,0.4,0.4091,0.62,0.2537,8,42,50,42
6923,10/21/2011,4,0,10,1,0,5,1,1,0.4,0.4091,0.62,0.2239,7,19,26,19
6924,10/21/2011,4,0,10,2,0,5,1,1,0.38,0.3939,0.66,0.1642,6,12,18,12
6925,10/21/2011,4,0,10,3,0,5,1,1,0.36,0.3485,0.71,0.1343,0,7,7,7
6926,10/21/2011,4,0,10,4,0,5,1,1,0.36,0.3485,0.71,0.1642,0,6,6,6
6927,10/21/2011,4,0,10,5,0,5,1,1,0.34,0.3333,0.76,0.194,0,31,31,31
6928,10/21/2011,4,0,10,6,0,5,1,1,0.36,0.3485,0.71,0.1642,7,78,85,78
6929,10/21/2011,4,0,10,7,0,5,1,1,0.36,0.3485,0.71,0.1642,5,228,233,228
6930,10/21/2011,4,0,10,8,0,5,1,1,0.4,0.4091,0.62,0.194,16,386,402,386
6931,10/21/2011,4,0,10,9,0,5,1,2,0.42,0.4242,0.58,0.1343,33,189,222,189
6932,10/21/2011,4,0,10,10,0,5,1,1,0.46,0.4545,0.51,0.1642,32,106,138,106
6933,10/21/2011,4,0,10,11,0,5,1,1,0.5,0.4848,0.45,0.2239,39,135,174,135
6934,10/21/2011,4,0,10,12,0,5,1,1,0.5,0.4848,0.45,0.2985,47,193,240,193
6935,10/21/2011,4,0,10,13,0,5,1,1,0.48,0.4697,0.48,0.3284,43,163,206,163
6936,10/21/2011,4,0,10,14,0,5,1,1,0.52,0.5,0.42,0.2985,67,131,198,131
6937,10/21/2011,4,0,10,15,0,5,1,1,0.5,0.4848,0.45,0.2836,57,178,235,178
6938,10/21/2011,4,0,10,16,0,5,1,1,0.5,0.4848,0.45,0.2537,60,242,302,242
6939,10/21/2011,4,0,10,17,0,5,1,2,0.46,0.4545,0.51,0.2537,79,445,524,445
6940,10/21/2011,4,0,10,18,0,5,1,2,0.44,0.4394,0.54,0.2537,43,354,397,354
6941,10/21/2011,4,0,10,19,0,5,1,2,0.44,0.4394,0.54,0.3881,25,228,253,228
6942,10/21/2011,4,0,10,20,0,5,1,2,0.44,0.4394,0.54,0.2239,29,155,184,155
6943,10/21/2011,4,0,10,21,0,5,1,1,0.42,0.4242,0.58,0.1642,31,112,143,112
6944,10/21/2011,4,0,10,22,0,5,1,1,0.42,0.4242,0.54,0.1642,24,89,113,89
6945,10/21/2011,4,0,10,23,0,5,1,1,0.4,0.4091,0.62,0.2239,18,99,117,99
6946,10/22/2011,4,0,10,0,0,6,0,1,0.4,0.4091,0.62,0.194,16,80,96,80
6947,10/22/2011,4,0,10,1,0,6,0,1,0.4,0.4091,0.62,0.194,20,50,70,50
6948,10/22/2011,4,0,10,2,0,6,0,1,0.4,0.4091,0.62,0.2537,6,25,31,25
6949,10/22/2011,4,0,10,3,0,6,0,1,0.4,0.4091,0.62,0.1343,1,19,20,19
6950,10/22/2011,4,0,10,4,0,6,0,1,0.38,0.3939,0.66,0.0896,4,4,8,4
6951,10/22/2011,4,0,10,5,0,6,0,1,0.38,0.3939,0.66,0,1,7,8,7
6952,10/22/2011,4,0,10,6,0,6,0,1,0.36,0.3788,0.71,0,1,17,18,17
6953,10/22/2011,4,0,10,7,0,6,0,1,0.36,0.3636,0.76,0.1045,8,49,57,49
6954,10/22/2011,4,0,10,8,0,6,0,1,0.4,0.4091,0.71,0,26,88,114,88
6955,10/22/2011,4,0,10,9,0,6,0,1,0.42,0.4242,0.67,0.0896,47,122,169,122
6956,10/22/2011,4,0,10,10,0,6,0,2,0.44,0.4394,0.62,0.1045,87,149,236,149
6957,10/22/2011,4,0,10,11,0,6,0,2,0.44,0.4394,0.62,0.1045,110,172,282,172
6958,10/22/2011,4,0,10,12,0,6,0,1,0.46,0.4545,0.55,0.0896,132,211,343,211
6959,10/22/2011,4,0,10,13,0,6,0,1,0.5,0.4848,0.45,0,136,186,322,186
6960,10/22/2011,4,0,10,14,0,6,0,2,0.48,0.4697,0.48,0.2239,133,177,310,177
6961,10/22/2011,4,0,10,15,0,6,0,1,0.48,0.4697,0.51,0.2239,159,223,382,223
6962,10/22/2011,4,0,10,16,0,6,0,1,0.5,0.4848,0.45,0.194,169,190,359,190
6963,10/22/2011,4,0,10,17,0,6,0,1,0.46,0.4545,0.55,0.1343,143,217,360,217
6964,10/22/2011,4,0,10,18,0,6,0,1,0.44,0.4394,0.54,0.0896,111,224,335,224
6965,10/22/2011,4,0,10,19,0,6,0,1,0.44,0.4394,0.67,0,47,173,220,173
6966,10/22/2011,4,0,10,20,0,6,0,1,0.42,0.4242,0.67,0,48,111,159,111
6967,10/22/2011,4,0,10,21,0,6,0,1,0.4,0.4091,0.76,0,37,120,157,120
6968,10/22/2011,4,0,10,22,0,6,0,1,0.4,0.4091,0.76,0,30,114,144,114
6969,10/22/2011,4,0,10,23,0,6,0,1,0.38,0.3939,0.82,0,27,81,108,81
6970,10/23/2011,4,0,10,0,0,0,0,1,0.36,0.3788,0.87,0,24,64,88,64
6971,10/23/2011,4,0,10,1,0,0,0,1,0.36,0.3788,0.87,0,11,60,71,60
6972,10/23/2011,4,0,10,2,0,0,0,1,0.34,0.3485,0.87,0.0896,10,40,50,40
6973,10/23/2011,4,0,10,3,0,0,0,1,0.34,0.3636,0.87,0,15,31,46,31
6974,10/23/2011,4,0,10,4,0,0,0,1,0.34,0.3636,0.87,0,5,1,6,1
6975,10/23/2011,4,0,10,5,0,0,0,1,0.32,0.3485,0.87,0,1,2,3,2
6976,10/23/2011,4,0,10,6,0,0,0,1,0.32,0.3333,0.87,0.1045,0,12,12,12
6977,10/23/2011,4,0,10,7,0,0,0,1,0.34,0.3485,0.87,0.0896,3,18,21,18
6978,10/23/2011,4,0,10,8,0,0,0,1,0.36,0.3485,0.87,0.1343,32,56,88,56
6979,10/23/2011,4,0,10,9,0,0,0,1,0.4,0.4091,0.76,0,48,95,143,95
6980,10/23/2011,4,0,10,10,0,0,0,1,0.42,0.4242,0.71,0.0896,104,185,289,185
6981,10/23/2011,4,0,10,11,0,0,0,1,0.46,0.4545,0.72,0.1642,131,202,333,202
6982,10/23/2011,4,0,10,12,0,0,0,1,0.5,0.4848,0.59,0.2537,164,249,413,249
6983,10/23/2011,4,0,10,13,0,0,0,1,0.52,0.5,0.55,0.194,160,255,415,255
6984,10/23/2011,4,0,10,14,0,0,0,1,0.52,0.5,0.55,0.2239,192,216,408,216
6985,10/23/2011,4,0,10,15,0,0,0,1,0.52,0.5,0.52,0.1642,171,216,387,216
6986,10/23/2011,4,0,10,16,0,0,0,1,0.52,0.5,0.55,0.194,188,217,405,217
6987,10/23/2011,4,0,10,17,0,0,0,1,0.5,0.4848,0.63,0.1343,120,220,340,220
6988,10/23/2011,4,0,10,18,0,0,0,1,0.5,0.4848,0.63,0.1045,88,196,284,196
6989,10/23/2011,4,0,10,19,0,0,0,1,0.46,0.4545,0.77,0,53,140,193,140
6990,10/23/2011,4,0,10,20,0,0,0,1,0.44,0.4394,0.72,0.0896,32,112,144,112
6991,10/23/2011,4,0,10,21,0,0,0,1,0.44,0.4394,0.72,0.0896,24,75,99,75
6992,10/23/2011,4,0,10,22,0,0,0,1,0.42,0.4242,0.77,0.1045,25,69,94,69
6993,10/23/2011,4,0,10,23,0,0,0,1,0.42,0.4242,0.77,0.1642,18,31,49,31
6994,10/24/2011,4,0,10,0,0,1,1,1,0.42,0.4242,0.77,0,6,26,32,26
6995,10/24/2011,4,0,10,1,0,1,1,1,0.4,0.4091,0.82,0.1343,7,8,15,8
6996,10/24/2011,4,0,10,2,0,1,1,1,0.4,0.4091,0.87,0.1045,1,6,7,6
6997,10/24/2011,4,0,10,3,0,1,1,1,0.4,0.4091,0.82,0.0896,1,3,4,3
6998,10/24/2011,4,0,10,4,0,1,1,1,0.4,0.4091,0.82,0,1,5,6,5
6999,10/24/2011,4,0,10,5,0,1,1,1,0.38,0.3939,0.87,0,2,19,21,19
7000,10/24/2011,4,0,10,6,0,1,1,1,0.4,0.4091,0.87,0.1045,3,83,86,83
7001,10/24/2011,4,0,10,7,0,1,1,2,0.38,0.3939,0.94,0.1045,11,274,285,274
7002,10/24/2011,4,0,10,8,0,1,1,2,0.42,0.4242,0.88,0.1642,20,378,398,378
7003,10/24/2011,4,0,10,9,0,1,1,2,0.44,0.4394,0.82,0.1642,29,166,195,166
7004,10/24/2011,4,0,10,10,0,1,1,2,0.46,0.4545,0.82,0.2537,47,82,129,82
7005,10/24/2011,4,0,10,11,0,1,1,2,0.5,0.4848,0.72,0.1642,59,109,168,109
7006,10/24/2011,4,0,10,12,0,1,1,2,0.52,0.5,0.68,0.1045,64,156,220,156
7007,10/24/2011,4,0,10,13,0,1,1,2,0.54,0.5152,0.64,0.2239,60,138,198,138
7008,10/24/2011,4,0,10,14,0,1,1,2,0.54,0.5152,0.64,0.194,63,143,206,143
7009,10/24/2011,4,0,10,15,0,1,1,1,0.56,0.5303,0.6,0.1642,52,125,177,125
7010,10/24/2011,4,0,10,16,0,1,1,1,0.54,0.5152,0.64,0.194,68,242,310,242
7011,10/24/2011,4,0,10,17,0,1,1,1,0.52,0.5,0.68,0.1343,87,527,614,527
7012,10/24/2011,4,0,10,18,0,1,1,1,0.54,0.5152,0.6,0.0896,58,428,486,428
7013,10/24/2011,4,0,10,19,0,1,1,3,0.48,0.4697,0.82,0,25,212,237,212
7014,10/24/2011,4,0,10,20,0,1,1,1,0.48,0.4697,0.82,0.1045,11,118,129,118
7015,10/24/2011,4,0,10,21,0,1,1,1,0.46,0.4545,0.87,0.1045,12,114,126,114
7016,10/24/2011,4,0,10,22,0,1,1,1,0.48,0.4697,0.75,0.1642,3,76,79,76
7017,10/24/2011,4,0,10,23,0,1,1,1,0.46,0.4545,0.77,0.0896,9,50,59,50
7018,10/25/2011,4,0,10,0,0,2,1,1,0.44,0.4394,0.77,0.1343,4,26,30,26
7019,10/25/2011,4,0,10,1,0,2,1,1,0.44,0.4394,0.77,0.1343,5,6,11,6
7020,10/25/2011,4,0,10,2,0,2,1,1,0.42,0.4242,0.82,0.1343,2,3,5,3
7021,10/25/2011,4,0,10,3,0,2,1,1,0.4,0.4091,0.87,0,1,3,4,3
7022,10/25/2011,4,0,10,4,0,2,1,1,0.38,0.3939,0.87,0.1343,0,5,5,5
7023,10/25/2011,4,0,10,5,0,2,1,1,0.38,0.3939,0.87,0.1343,0,24,24,24
7024,10/25/2011,4,0,10,6,0,2,1,1,0.38,0.3939,0.82,0.1045,3,95,98,95
7025,10/25/2011,4,0,10,7,0,2,1,1,0.4,0.4091,0.76,0.194,15,299,314,299
7026,10/25/2011,4,0,10,8,0,2,1,1,0.44,0.4394,0.72,0,25,383,408,383
7027,10/25/2011,4,0,10,9,0,2,1,1,0.48,0.4697,0.55,0.2239,29,194,223,194
7028,10/25/2011,4,0,10,10,0,2,1,1,0.5,0.4848,0.51,0.2537,26,102,128,102
7029,10/25/2011,4,0,10,11,0,2,1,1,0.52,0.5,0.48,0.2836,46,120,166,120
7030,10/25/2011,4,0,10,12,0,2,1,1,0.54,0.5152,0.39,0.3582,35,165,200,165
7031,10/25/2011,4,0,10,13,0,2,1,1,0.56,0.5303,0.37,0.3881,37,161,198,161
7032,10/25/2011,4,0,10,14,0,2,1,1,0.56,0.5303,0.4,0.2537,66,134,200,134
7033,10/25/2011,4,0,10,15,0,2,1,1,0.56,0.5303,0.37,0.1045,63,171,234,171
7034,10/25/2011,4,0,10,16,0,2,1,1,0.56,0.5303,0.37,0.194,52,233,285,233
7035,10/25/2011,4,0,10,17,0,2,1,1,0.56,0.5303,0.37,0.1045,68,517,585,517
7036,10/25/2011,4,0,10,18,0,2,1,1,0.52,0.5,0.42,0.1045,65,453,518,453
7037,10/25/2011,4,0,10,19,0,2,1,1,0.48,0.4697,0.67,0.194,44,294,338,294
7038,10/25/2011,4,0,10,20,0,2,1,1,0.46,0.4545,0.67,0.1045,40,208,248,208
7039,10/25/2011,4,0,10,21,0,2,1,1,0.44,0.4394,0.72,0.1343,32,169,201,169
7040,10/25/2011,4,0,10,22,0,2,1,1,0.46,0.4545,0.67,0.194,22,148,170,148
7041,10/25/2011,4,0,10,23,0,2,1,1,0.44,0.4394,0.72,0.1343,15,79,94,79
7042,10/26/2011,4,0,10,0,0,3,1,1,0.44,0.4394,0.72,0.194,4,28,32,28
7043,10/26/2011,4,0,10,1,0,3,1,1,0.44,0.4394,0.67,0.2537,3,9,12,9
7044,10/26/2011,4,0,10,2,0,3,1,1,0.44,0.4394,0.67,0.1642,2,1,3,1
7045,10/26/2011,4,0,10,3,0,3,1,1,0.44,0.4394,0.67,0.2239,0,3,3,3
7046,10/26/2011,4,0,10,4,0,3,1,1,0.42,0.4242,0.71,0.2537,0,5,5,5
7047,10/26/2011,4,0,10,5,0,3,1,1,0.42,0.4242,0.71,0.2239,0,21,21,21
7048,10/26/2011,4,0,10,6,0,3,1,1,0.42,0.4242,0.71,0.2239,0,92,92,92
7049,10/26/2011,4,0,10,7,0,3,1,1,0.42,0.4242,0.71,0.1642,15,284,299,284
7050,10/26/2011,4,0,10,8,0,3,1,2,0.44,0.4394,0.67,0.194,26,438,464,438
7051,10/26/2011,4,0,10,9,0,3,1,2,0.48,0.4697,0.63,0.2239,14,226,240,226
7052,10/26/2011,4,0,10,10,0,3,1,2,0.52,0.5,0.62,0.2537,26,105,131,105
7053,10/26/2011,4,0,10,11,0,3,1,1,0.52,0.5,0.59,0.3284,23,132,155,132
7054,10/26/2011,4,0,10,12,0,3,1,3,0.58,0.5455,0.53,0.2239,39,155,194,155
7055,10/26/2011,4,0,10,13,0,3,1,3,0.56,0.5303,0.6,0.1045,20,62,82,62
7056,10/26/2011,4,0,10,14,0,3,1,2,0.52,0.5,0.77,0,14,52,66,52
7057,10/26/2011,4,0,10,15,0,3,1,2,0.52,0.5,0.77,0,11,59,70,59
7058,10/26/2011,4,0,10,16,0,3,1,2,0.52,0.5,0.77,0.0896,17,196,213,196
7059,10/26/2011,4,0,10,17,0,3,1,2,0.52,0.5,0.77,0.1045,40,414,454,414
7060,10/26/2011,4,0,10,18,0,3,1,1,0.52,0.5,0.77,0.1642,55,398,453,398
7061,10/26/2011,4,0,10,19,0,3,1,1,0.5,0.4848,0.82,0,25,306,331,306
7062,10/26/2011,4,0,10,20,0,3,1,1,0.5,0.4848,0.88,0,27,180,207,180
7063,10/26/2011,4,0,10,21,0,3,1,2,0.52,0.5,0.77,0,17,140,157,140
7064,10/26/2011,4,0,10,22,0,3,1,2,0.48,0.4697,0.88,0.0896,23,112,135,112
7065,10/26/2011,4,0,10,23,0,3,1,2,0.48,0.4697,0.88,0.0896,3,72,75,72
7066,10/27/2011,4,0,10,0,0,4,1,1,0.46,0.4545,0.94,0,3,23,26,23
7067,10/27/2011,4,0,10,1,0,4,1,1,0.46,0.4545,0.94,0,2,9,11,9
7068,10/27/2011,4,0,10,2,0,4,1,3,0.46,0.4545,0.94,0,3,5,8,5
7069,10/27/2011,4,0,10,3,0,4,1,3,0.46,0.4545,0.94,0,1,3,4,3
7070,10/27/2011,4,0,10,4,0,4,1,3,0.48,0.4697,0.88,0,1,3,4,3
7071,10/27/2011,4,0,10,5,0,4,1,3,0.48,0.4697,0.88,0.0896,1,14,15,14
7072,10/27/2011,4,0,10,6,0,4,1,3,0.5,0.4848,0.82,0,4,42,46,42
7073,10/27/2011,4,0,10,7,0,4,1,2,0.46,0.4545,0.94,0.0896,9,128,137,128
7074,10/27/2011,4,0,10,8,0,4,1,3,0.48,0.4697,0.88,0.194,12,304,316,304
7075,10/27/2011,4,0,10,9,0,4,1,2,0.5,0.4848,0.82,0.1642,16,155,171,155
7076,10/27/2011,4,0,10,10,0,4,1,3,0.5,0.4848,0.88,0.194,10,52,62,52
7077,10/27/2011,4,0,10,11,0,4,1,3,0.5,0.4848,0.88,0.1343,8,44,52,44
7078,10/27/2011,4,0,10,12,0,4,1,3,0.5,0.4848,0.88,0.1343,8,45,53,45
7079,10/27/2011,4,0,10,13,0,4,1,2,0.5,0.4848,0.88,0.1642,10,64,74,64
7080,10/27/2011,4,0,10,14,0,4,1,2,0.52,0.5,0.83,0,16,76,92,76
7081,10/27/2011,4,0,10,15,0,4,1,2,0.52,0.5,0.83,0.1045,12,95,107,95
7082,10/27/2011,4,0,10,16,0,4,1,2,0.56,0.5303,0.73,0.1642,14,193,207,193
7083,10/27/2011,4,0,10,17,0,4,1,2,0.5,0.4848,0.72,0.4627,31,291,322,291
7084,10/27/2011,4,0,10,18,0,4,1,2,0.48,0.4697,0.67,0.4627,14,226,240,226
7085,10/27/2011,4,0,10,19,0,4,1,2,0.44,0.4394,0.67,0.4627,19,200,219,200
7086,10/27/2011,4,0,10,20,0,4,1,1,0.42,0.4242,0.67,0.4925,11,171,182,171
7087,10/27/2011,4,0,10,21,0,4,1,1,0.4,0.4091,0.62,0.5224,13,119,132,119
7088,10/27/2011,4,0,10,22,0,4,1,1,0.36,0.3182,0.66,0.4925,14,97,111,97
7089,10/27/2011,4,0,10,23,0,4,1,1,0.34,0.303,0.61,0.4179,8,60,68,60
7090,10/28/2011,4,0,10,0,0,5,1,1,0.34,0.3182,0.66,0.2537,4,40,44,40
7091,10/28/2011,4,0,10,1,0,5,1,1,0.32,0.303,0.66,0.2537,7,9,16,9
7092,10/28/2011,4,0,10,2,0,5,1,1,0.32,0.303,0.66,0.2836,1,3,4,3
7093,10/28/2011,4,0,10,3,0,5,1,1,0.3,0.2879,0.7,0.2836,4,4,8,4
7094,10/28/2011,4,0,10,4,0,5,1,1,0.3,0.2879,0.65,0.2836,5,5,10,5
7095,10/28/2011,4,0,10,5,0,5,1,2,0.3,0.2879,0.61,0.2537,0,25,25,25
7096,10/28/2011,4,0,10,6,0,5,1,1,0.28,0.2727,0.65,0.2537,1,74,75,74
7097,10/28/2011,4,0,10,7,0,5,1,1,0.28,0.2727,0.65,0.2537,6,199,205,199
7098,10/28/2011,4,0,10,8,0,5,1,1,0.3,0.2879,0.61,0.2836,13,361,374,361
7099,10/28/2011,4,0,10,9,0,5,1,1,0.32,0.303,0.57,0.2239,19,210,229,210
7100,10/28/2011,4,0,10,10,0,5,1,1,0.34,0.3182,0.57,0.2239,28,102,130,102
7101,10/28/2011,4,0,10,11,0,5,1,1,0.36,0.3485,0.5,0.2239,40,128,168,128
7102,10/28/2011,4,0,10,12,0,5,1,2,0.38,0.3939,0.4,0.1642,46,167,213,167
7103,10/28/2011,4,0,10,13,0,5,1,2,0.38,0.3939,0.42,0.2239,43,185,228,185
7104,10/28/2011,4,0,10,14,0,5,1,2,0.36,0.3485,0.46,0.194,33,152,185,152
7105,10/28/2011,4,0,10,15,0,5,1,2,0.36,0.3333,0.43,0.2537,44,171,215,171
7106,10/28/2011,4,0,10,16,0,5,1,2,0.36,0.3485,0.46,0.1642,46,262,308,262
7107,10/28/2011,4,0,10,17,0,5,1,2,0.36,0.3485,0.5,0.1343,35,411,446,411
7108,10/28/2011,4,0,10,18,0,5,1,2,0.36,0.3485,0.53,0.1642,36,332,368,332
7109,10/28/2011,4,0,10,19,0,5,1,2,0.36,0.3485,0.5,0.1343,16,188,204,188
7110,10/28/2011,4,0,10,20,0,5,1,3,0.34,0.3182,0.61,0.2239,12,131,143,131
7111,10/28/2011,4,0,10,21,0,5,1,3,0.32,0.3182,0.7,0.1642,5,69,74,69
7112,10/28/2011,4,0,10,22,0,5,1,3,0.3,0.2879,0.75,0.2836,4,32,36,32
7113,10/28/2011,4,0,10,23,0,5,1,3,0.3,0.2727,0.81,0.3284,8,31,39,31
7114,10/29/2011,4,0,10,0,0,6,0,3,0.28,0.2576,0.87,0.2985,0,19,19,19
7115,10/29/2011,4,0,10,1,0,6,0,3,0.3,0.2727,0.87,0.2985,0,18,18,18
7116,10/29/2011,4,0,10,2,0,6,0,3,0.3,0.2727,0.87,0.2985,1,16,17,16
7117,10/29/2011,4,0,10,3,0,6,0,3,0.3,0.2727,0.81,0.4179,0,8,8,8
7118,10/29/2011,4,0,10,4,0,6,0,3,0.3,0.2727,0.81,0.4179,0,1,1,1
7119,10/29/2011,4,0,10,5,0,6,0,3,0.26,0.2273,0.93,0.3582,0,1,1,1
7120,10/29/2011,4,0,10,6,0,6,0,3,0.26,0.2273,0.87,0.3582,4,1,5,1
7121,10/29/2011,4,0,10,7,0,6,0,3,0.26,0.2273,0.87,0.3582,1,6,7,6
7122,10/29/2011,4,0,10,8,0,6,0,3,0.28,0.2576,0.87,0.3582,4,16,20,16
7123,10/29/2011,4,0,10,9,0,6,0,3,0.28,0.2576,0.87,0.3582,1,19,20,19
7124,10/29/2011,4,0,10,10,0,6,0,3,0.26,0.2273,0.93,0.3284,0,12,12,12
7125,10/29/2011,4,0,10,11,0,6,0,3,0.26,0.2273,0.93,0.3881,1,26,27,26
7126,10/29/2011,4,0,10,12,0,6,0,3,0.24,0.197,0.87,0.4925,6,44,50,44
7127,10/29/2011,4,0,10,13,0,6,0,3,0.24,0.197,0.87,0.5224,0,30,30,30
7128,10/29/2011,4,0,10,14,0,6,0,3,0.24,0.197,0.87,0.4478,0,29,29,29
7129,10/29/2011,4,0,10,15,0,6,0,3,0.22,0.2121,0.93,0.2537,3,38,41,38
7130,10/29/2011,4,0,10,16,0,6,0,3,0.22,0.197,0.93,0.3284,3,19,22,19
7131,10/29/2011,4,0,10,17,0,6,0,3,0.22,0.197,0.93,0.3284,3,28,31,28
7132,10/29/2011,4,0,10,18,0,6,0,3,0.22,0.197,0.93,0.3284,6,37,43,37
7133,10/29/2011,4,0,10,19,0,6,0,1,0.24,0.2121,0.87,0.3582,3,36,39,36
7134,10/29/2011,4,0,10,20,0,6,0,1,0.24,0.2121,0.87,0.3582,7,40,47,40
7135,10/29/2011,4,0,10,21,0,6,0,1,0.24,0.2121,0.87,0.3582,1,49,50,49
7136,10/29/2011,4,0,10,22,0,6,0,1,0.22,0.2121,0.87,0.2239,10,44,54,44
7137,10/29/2011,4,0,10,23,0,6,0,1,0.22,0.2273,0.87,0.194,3,33,36,33
7138,10/30/2011,4,0,10,0,0,0,0,1,0.22,0.2121,0.87,0.2239,7,47,54,47
7139,10/30/2011,4,0,10,1,0,0,0,1,0.22,0.2121,0.87,0.2537,9,34,43,34
7140,10/30/2011,4,0,10,2,0,0,0,1,0.22,0.2121,0.87,0.2836,7,43,50,43
7141,10/30/2011,4,0,10,3,0,0,0,1,0.24,0.2121,0.75,0.3582,7,26,33,26
7142,10/30/2011,4,0,10,4,0,0,0,1,0.22,0.197,0.8,0.3284,1,10,11,10
7143,10/30/2011,4,0,10,5,0,0,0,1,0.24,0.2121,0.75,0.2985,0,4,4,4
7144,10/30/2011,4,0,10,6,0,0,0,1,0.24,0.2273,0.75,0.2537,2,8,10,8
7145,10/30/2011,4,0,10,7,0,0,0,1,0.24,0.2879,0.75,0,7,15,22,15
7146,10/30/2011,4,0,10,8,0,0,0,1,0.26,0.2576,0.7,0.2239,20,60,80,60
7147,10/30/2011,4,0,10,9,0,0,0,1,0.3,0.2879,0.65,0.2537,55,92,147,92
7148,10/30/2011,4,0,10,10,0,0,0,1,0.32,0.3333,0.61,0.0896,53,125,178,125
7149,10/30/2011,4,0,10,11,0,0,0,1,0.36,0.3485,0.53,0.2239,58,182,240,182
7150,10/30/2011,4,0,10,12,0,0,0,1,0.38,0.3939,0.5,0.194,85,229,314,229
7151,10/30/2011,4,0,10,13,0,0,0,1,0.4,0.4091,0.43,0.2239,113,232,345,232
7152,10/30/2011,4,0,10,14,0,0,0,1,0.42,0.4242,0.38,0.194,91,209,300,209
7153,10/30/2011,4,0,10,15,0,0,0,1,0.42,0.4242,0.35,0.1642,88,202,290,202
7154,10/30/2011,4,0,10,16,0,0,0,1,0.42,0.4242,0.32,0.1343,107,213,320,213
7155,10/30/2011,4,0,10,17,0,0,0,1,0.4,0.4091,0.35,0.1045,54,191,245,191
7156,10/30/2011,4,0,10,18,0,0,0,1,0.36,0.3485,0.4,0.1343,51,162,213,162
7157,10/30/2011,4,0,10,19,0,0,0,1,0.56,0.5303,0.49,0.2985,28,125,153,125
7158,10/30/2011,4,0,10,20,0,0,0,1,0.34,0.3636,0.57,0,18,74,92,74
7159,10/30/2011,4,0,10,21,0,0,0,1,0.32,0.3485,0.66,0,4,75,79,75
7160,10/30/2011,4,0,10,22,0,0,0,1,0.3,0.3333,0.75,0,13,58,71,58
7161,10/30/2011,4,0,10,23,0,0,0,1,0.26,0.303,0.87,0,7,30,37,30
7162,10/31/2011,4,0,10,0,0,1,1,1,0.26,0.303,0.87,0,3,20,23,20
7163,10/31/2011,4,0,10,1,0,1,1,1,0.26,0.303,0.81,0,5,8,13,8
7164,10/31/2011,4,0,10,2,0,1,1,1,0.24,0.2879,0.87,0,0,3,3,3
7165,10/31/2011,4,0,10,3,0,1,1,1,0.24,0.2576,0.87,0.1045,0,3,3,3
7166,10/31/2011,4,0,10,4,0,1,1,1,0.24,0.2879,0.87,0,1,5,6,5
7167,10/31/2011,4,0,10,5,0,1,1,1,0.22,0.2727,0.93,0,0,18,18,18
7168,10/31/2011,4,0,10,6,0,1,1,1,0.24,0.2879,0.87,0,4,82,86,82
7169,10/31/2011,4,0,10,7,0,1,1,1,0.24,0.2879,0.93,0,11,216,227,216
7170,10/31/2011,4,0,10,8,0,1,1,2,0.28,0.3182,0.87,0,17,355,372,355
7171,10/31/2011,4,0,10,9,0,1,1,2,0.32,0.3182,0.76,0.1642,14,197,211,197
7172,10/31/2011,4,0,10,10,0,1,1,2,0.36,0.3485,0.57,0.1642,18,87,105,87
7173,10/31/2011,4,0,10,11,0,1,1,1,0.4,0.4091,0.5,0.1343,31,97,128,97
7174,10/31/2011,4,0,10,12,0,1,1,1,0.42,0.4242,0.44,0.2239,30,140,170,140
7175,10/31/2011,4,0,10,13,0,1,1,2,0.44,0.4394,0.44,0.2239,24,128,152,128
7176,10/31/2011,4,0,10,14,0,1,1,2,0.44,0.4394,0.47,0.2239,22,119,141,119
7177,10/31/2011,4,0,10,15,0,1,1,1,0.44,0.4394,0.47,0.1642,27,141,168,141
7178,10/31/2011,4,0,10,16,0,1,1,1,0.42,0.4242,0.54,0.1642,30,242,272,242
7179,10/31/2011,4,0,10,17,0,1,1,1,0.42,0.4242,0.54,0.1343,44,442,486,442
7180,10/31/2011,4,0,10,18,0,1,1,1,0.4,0.4091,0.66,0.0896,30,392,422,392
7181,10/31/2011,4,0,10,19,0,1,1,1,0.4,0.4091,0.66,0.0896,12,226,238,226
7182,10/31/2011,4,0,10,20,0,1,1,1,0.4,0.4091,0.66,0.0896,18,154,172,154
7183,10/31/2011,4,0,10,21,0,1,1,2,0.36,0.3485,0.76,0.194,7,109,116,109
7184,10/31/2011,4,0,10,22,0,1,1,2,0.36,0.3485,0.76,0.194,8,77,85,77
7185,10/31/2011,4,0,10,23,0,1,1,2,0.36,0.3485,0.76,0.194,6,46,52,46
7186,11/1/2011,4,0,11,0,0,2,1,2,0.36,0.3485,0.87,0.1642,3,18,21,18
7187,11/1/2011,4,0,11,1,0,2,1,1,0.36,0.3485,0.81,0.1343,3,8,11,8
7188,11/1/2011,4,0,11,2,0,2,1,2,0.36,0.3485,0.81,0.1642,1,3,4,3
7189,11/1/2011,4,0,11,3,0,2,1,2,0.36,0.3485,0.81,0.1343,1,5,6,5
7190,11/1/2011,4,0,11,4,0,2,1,1,0.34,0.3182,0.81,0.2239,1,7,8,7
7191,11/1/2011,4,0,11,5,0,2,1,1,0.32,0.3182,0.81,0.194,0,18,18,18
7192,11/1/2011,4,0,11,6,0,2,1,1,0.32,0.3182,0.81,0.194,3,90,93,90
7193,11/1/2011,4,0,11,7,0,2,1,1,0.34,0.3333,0.76,0.194,8,246,254,246
7194,11/1/2011,4,0,11,8,0,2,1,1,0.36,0.3333,0.71,0.2537,17,402,419,402
7195,11/1/2011,4,0,11,9,0,2,1,1,0.4,0.4091,0.66,0.1642,16,206,222,206
7196,11/1/2011,4,0,11,10,0,2,1,1,0.44,0.4394,0.62,0.1343,21,114,135,114
7197,11/1/2011,4,0,11,11,0,2,1,1,0.46,0.4545,0.63,0.1045,16,101,117,101
7198,11/1/2011,4,0,11,12,0,2,1,1,0.5,0.4848,0.48,0.0896,23,153,176,153
7199,11/1/2011,4,0,11,13,0,2,1,1,0.48,0.4697,0.55,0.194,20,147,167,147
7200,11/1/2011,4,0,11,14,0,2,1,1,0.5,0.4848,0.48,0.2537,32,118,150,118
7201,11/1/2011,4,0,11,15,0,2,1,1,0.5,0.4848,0.45,0.1343,38,148,186,148
7202,11/1/2011,4,0,11,16,0,2,1,1,0.48,0.4697,0.44,0.1642,46,252,298,252
7203,11/1/2011,4,0,11,17,0,2,1,1,0.44,0.4394,0.54,0.1642,36,470,506,470
7204,11/1/2011,4,0,11,18,0,2,1,1,0.42,0.4242,0.58,0.1045,39,421,460,421
7205,11/1/2011,4,0,11,19,0,2,1,1,0.42,0.4242,0.58,0.0896,39,274,313,274
7206,11/1/2011,4,0,11,20,0,2,1,1,0.4,0.4091,0.71,0,18,191,209,191
7207,11/1/2011,4,0,11,21,0,2,1,1,0.36,0.3788,0.81,0,13,114,127,114
7208,11/1/2011,4,0,11,22,0,2,1,1,0.36,0.3788,0.81,0,5,91,96,91
7209,11/1/2011,4,0,11,23,0,2,1,1,0.34,0.3636,0.87,0,11,61,72,61
7210,11/2/2011,4,0,11,0,0,3,1,1,0.32,0.3485,0.87,0,0,19,19,19
7211,11/2/2011,4,0,11,1,0,3,1,1,0.3,0.3333,0.87,0,2,8,10,8
7212,11/2/2011,4,0,11,2,0,3,1,1,0.3,0.3333,0.87,0,0,2,2,2
7213,11/2/2011,4,0,11,3,0,3,1,1,0.3,0.3333,0.75,0,0,2,2,2
7214,11/2/2011,4,0,11,4,0,3,1,1,0.3,0.3333,0.87,0,0,4,4,4
7215,11/2/2011,4,0,11,5,0,3,1,1,0.3,0.3333,0.81,0,0,27,27,27
7216,11/2/2011,4,0,11,6,0,3,1,1,0.3,0.3333,0.81,0,1,91,92,91
7217,11/2/2011,4,0,11,7,0,3,1,1,0.3,0.3333,0.81,0,11,240,251,240
7218,11/2/2011,4,0,11,8,0,3,1,1,0.32,0.3485,0.87,0,20,452,472,452
7219,11/2/2011,4,0,11,9,0,3,1,1,0.34,0.3636,0.87,0,15,213,228,213
7220,11/2/2011,4,0,11,10,0,3,1,1,0.4,0.4091,0.71,0.0896,25,108,133,108
7221,11/2/2011,4,0,11,11,0,3,1,1,0.42,0.4242,0.71,0.1343,27,117,144,117
7222,11/2/2011,4,0,11,12,0,3,1,1,0.46,0.4545,0.55,0.1642,32,157,189,157
7223,11/2/2011,4,0,11,13,0,3,1,1,0.48,0.4697,0.48,0.1642,22,139,161,139
7224,11/2/2011,4,0,11,14,0,3,1,1,0.5,0.4848,0.45,0.1642,40,132,172,132
7225,11/2/2011,4,0,11,15,0,3,1,1,0.48,0.4697,0.51,0.1642,26,161,187,161
7226,11/2/2011,4,0,11,16,0,3,1,1,0.48,0.4697,0.51,0.1045,35,231,266,231
7227,11/2/2011,4,0,11,17,0,3,1,1,0.44,0.4394,0.62,0.194,30,523,553,523
7228,11/2/2011,4,0,11,18,0,3,1,1,0.42,0.4242,0.71,0.1642,31,448,479,448
7229,11/2/2011,4,0,11,19,0,3,1,1,0.4,0.4091,0.76,0.1343,25,257,282,257
7230,11/2/2011,4,0,11,20,0,3,1,1,0.4,0.4091,0.66,0.1343,5,177,182,177
7231,11/2/2011,4,0,11,21,0,3,1,1,0.38,0.3939,0.71,0.1343,13,155,168,155
7232,11/2/2011,4,0,11,22,0,3,1,1,0.36,0.3485,0.71,0.1343,7,99,106,99
7233,11/2/2011,4,0,11,23,0,3,1,1,0.36,0.3636,0.76,0.0896,3,54,57,54
7234,11/3/2011,4,0,11,0,0,4,1,1,0.36,0.3636,0.76,0.0896,3,28,31,28
7235,11/3/2011,4,0,11,1,0,4,1,1,0.34,0.3333,0.81,0.1343,3,12,15,12
7236,11/3/2011,4,0,11,2,0,4,1,1,0.34,0.3333,0.76,0.1343,2,5,7,5
7237,11/3/2011,4,0,11,3,0,4,1,1,0.34,0.3333,0.81,0.1343,1,4,5,4
7238,11/3/2011,4,0,11,4,0,4,1,1,0.32,0.3333,0.81,0.0896,1,3,4,3
7239,11/3/2011,4,0,11,5,0,4,1,1,0.32,0.3333,0.81,0.1343,1,27,28,27
7240,11/3/2011,4,0,11,6,0,4,1,1,0.34,0.3333,0.76,0.194,3,96,99,96
7241,11/3/2011,4,0,11,7,0,4,1,2,0.32,0.3333,0.81,0.0896,12,280,292,280
7242,11/3/2011,4,0,11,8,0,4,1,2,0.34,0.3485,0.81,0.0896,8,394,402,394
7243,11/3/2011,4,0,11,9,0,4,1,2,0.36,0.3485,0.81,0.194,9,155,164,155
7244,11/3/2011,4,0,11,10,0,4,1,2,0.4,0.4091,0.76,0.194,12,98,110,98
7245,11/3/2011,4,0,11,11,0,4,1,1,0.44,0.4394,0.67,0.194,12,108,120,108
7246,11/3/2011,4,0,11,12,0,4,1,1,0.5,0.4848,0.51,0.194,17,162,179,162
7247,11/3/2011,4,0,11,13,0,4,1,2,0.52,0.5,0.48,0.2537,19,150,169,150
7248,11/3/2011,4,0,11,14,0,4,1,1,0.52,0.5,0.52,0.1642,32,120,152,120
7249,11/3/2011,4,0,11,15,0,4,1,1,0.52,0.5,0.52,0.1642,24,138,162,138
7250,11/3/2011,4,0,11,16,0,4,1,1,0.52,0.5,0.48,0.194,33,234,267,234
7251,11/3/2011,4,0,11,17,0,4,1,1,0.48,0.4697,0.55,0.0896,33,465,498,465
7252,11/3/2011,4,0,11,18,0,4,1,1,0.46,0.4545,0.63,0.1343,24,409,433,409
7253,11/3/2011,4,0,11,19,0,4,1,1,0.44,0.4394,0.67,0.0896,18,234,252,234
7254,11/3/2011,4,0,11,20,0,4,1,1,0.42,0.4242,0.71,0.1045,11,198,209,198
7255,11/3/2011,4,0,11,21,0,4,1,1,0.4,0.4091,0.76,0.1343,4,140,144,140
7256,11/3/2011,4,0,11,22,0,4,1,1,0.4,0.4091,0.82,0,21,116,137,116
7257,11/3/2011,4,0,11,23,0,4,1,1,0.4,0.4091,0.82,0.0896,15,80,95,80
7258,11/4/2011,4,0,11,0,0,5,1,2,0.4,0.4091,0.82,0,11,32,43,32
7259,11/4/2011,4,0,11,1,0,5,1,2,0.4,0.4091,0.82,0,1,16,17,16
7260,11/4/2011,4,0,11,2,0,5,1,2,0.4,0.4091,0.76,0,2,8,10,8
7261,11/4/2011,4,0,11,3,0,5,1,2,0.38,0.3939,0.87,0.1642,1,7,8,7
7262,11/4/2011,4,0,11,4,0,5,1,2,0.38,0.3939,0.87,0.0896,1,6,7,6
7263,11/4/2011,4,0,11,5,0,5,1,2,0.38,0.3939,0.87,0,0,23,23,23
7264,11/4/2011,4,0,11,6,0,5,1,2,0.38,0.3939,0.87,0.0896,2,64,66,64
7265,11/4/2011,4,0,11,7,0,5,1,2,0.4,0.4091,0.86,0.2239,10,235,245,235
7266,11/4/2011,4,0,11,8,0,5,1,2,0.4,0.4091,0.87,0.3582,8,387,395,387
7267,11/4/2011,4,0,11,9,0,5,1,2,0.42,0.4242,0.71,0.4627,15,239,254,239
7268,11/4/2011,4,0,11,10,0,5,1,2,0.42,0.4242,0.71,0.3284,19,115,134,115
7269,11/4/2011,4,0,11,11,0,5,1,2,0.44,0.4394,0.67,0.4478,34,128,162,128
7270,11/4/2011,4,0,11,12,0,5,1,2,0.48,0.4697,0.55,0.4925,44,153,197,153
7271,11/4/2011,4,0,11,13,0,5,1,1,0.44,0.4394,0.51,0.4179,33,161,194,161
7272,11/4/2011,4,0,11,14,0,5,1,1,0.44,0.4394,0.47,0.2985,54,147,201,147
7273,11/4/2011,4,0,11,15,0,5,1,1,0.46,0.4545,0.44,0.3881,45,192,237,192
7274,11/4/2011,4,0,11,16,0,5,1,1,0.46,0.4545,0.36,0.3881,53,237,290,237
7275,11/4/2011,4,0,11,17,0,5,1,1,0.42,0.4242,0.38,0.3582,42,438,480,438
7276,11/4/2011,4,0,11,18,0,5,1,1,0.42,0.4242,0.32,0.4627,35,339,374,339
7277,11/4/2011,4,0,11,19,0,5,1,1,0.4,0.4091,0.37,0.3582,14,182,196,182
7278,11/4/2011,4,0,11,20,0,5,1,1,0.36,0.3333,0.43,0.2836,15,171,186,171
7279,11/4/2011,4,0,11,21,0,5,1,1,0.34,0.3182,0.46,0.2537,8,115,123,115
7280,11/4/2011,4,0,11,22,0,5,1,1,0.34,0.303,0.46,0.3284,6,109,115,109
7281,11/4/2011,4,0,11,23,0,5,1,1,0.32,0.303,0.49,0.3284,17,72,89,72
7282,11/5/2011,4,0,11,0,0,6,0,1,0.32,0.2879,0.45,0.3582,4,48,52,48
7283,11/5/2011,4,0,11,1,0,6,0,1,0.32,0.303,0.45,0.2985,5,57,62,57
7284,11/5/2011,4,0,11,2,0,6,0,1,0.3,0.2727,0.52,0.3284,7,24,31,24
7285,11/5/2011,4,0,11,3,0,6,0,1,0.3,0.2727,0.52,0.2985,0,8,8,8
7286,11/5/2011,4,0,11,4,0,6,0,1,0.28,0.2576,0.56,0.3284,3,5,8,5
7287,11/5/2011,4,0,11,5,0,6,0,1,0.26,0.2273,0.6,0.3284,0,2,2,2
7288,11/5/2011,4,0,11,6,0,6,0,1,0.26,0.2424,0.6,0.2537,3,20,23,20
7289,11/5/2011,4,0,11,7,0,6,0,1,0.26,0.2424,0.6,0.2836,3,31,34,31
7290,11/5/2011,4,0,11,8,0,6,0,1,0.28,0.2576,0.56,0.3284,4,80,84,80
7291,11/5/2011,4,0,11,9,0,6,0,1,0.3,0.2727,0.56,0.2985,30,111,141,111
7292,11/5/2011,4,0,11,10,0,6,0,1,0.32,0.303,0.53,0.2537,56,171,227,171
7293,11/5/2011,4,0,11,11,0,6,0,1,0.36,0.3636,0.46,0.1045,69,169,238,169
7294,11/5/2011,4,0,11,12,0,6,0,1,0.36,0.3485,0.46,0.1642,137,235,372,235
7295,11/5/2011,4,0,11,13,0,6,0,1,0.4,0.4091,0.37,0.1045,148,207,355,207
7296,11/5/2011,4,0,11,14,0,6,0,1,0.42,0.4242,0.35,0.1343,159,227,386,227
7297,11/5/2011,4,0,11,15,0,6,0,1,0.4,0.4091,0.37,0.194,141,202,343,202
7298,11/5/2011,4,0,11,16,0,6,0,1,0.4,0.4091,0.4,0.2239,128,207,335,207
7299,11/5/2011,4,0,11,17,0,6,0,1,0.38,0.3939,0.4,0.1642,100,234,334,234
7300,11/5/2011,4,0,11,18,0,6,0,1,0.36,0.3636,0.5,0.0896,52,185,237,185
7301,11/5/2011,4,0,11,19,0,6,0,1,0.34,0.3636,0.53,0,45,159,204,159
7302,11/5/2011,4,0,11,20,0,6,0,1,0.32,0.3485,0.66,0,29,136,165,136
7303,11/5/2011,4,0,11,21,0,6,0,1,0.32,0.3485,0.66,0,19,99,118,99
7304,11/5/2011,4,0,11,22,0,6,0,1,0.3,0.3333,0.65,0,10,72,82,72
7305,11/5/2011,4,0,11,23,0,6,0,1,0.28,0.3182,0.7,0,4,81,85,81
7306,11/6/2011,4,0,11,0,0,0,0,1,0.28,0.3182,0.75,0,10,65,75,65
7307,11/6/2011,4,0,11,1,0,0,0,1,0.26,0.303,0.81,0,11,104,115,104
7308,11/6/2011,4,0,11,2,0,0,0,1,0.26,0.303,0.81,0,6,23,29,23
7309,11/6/2011,4,0,11,3,0,0,0,1,0.24,0.2879,0.87,0,5,4,9,4
7310,11/6/2011,4,0,11,4,0,0,0,1,0.24,0.2879,0.87,0,0,6,6,6
7311,11/6/2011,4,0,11,5,0,0,0,1,0.24,0.2424,0.87,0.1343,0,5,5,5
7312,11/6/2011,4,0,11,6,0,0,0,1,0.26,0.2879,0.81,0.0896,5,11,16,11
7313,11/6/2011,4,0,11,7,0,0,0,1,0.26,0.2727,0.87,0.1045,4,24,28,24
7314,11/6/2011,4,0,11,8,0,0,0,2,0.28,0.303,0.87,0.0896,19,71,90,71
7315,11/6/2011,4,0,11,9,0,0,0,2,0.3,0.3182,0.75,0.0896,36,134,170,134
7316,11/6/2011,4,0,11,10,0,0,0,1,0.36,0.3636,0.66,0.0896,76,186,262,186
7317,11/6/2011,4,0,11,11,0,0,0,1,0.42,0.4242,0.58,0.0896,104,216,320,216
7318,11/6/2011,4,0,11,12,0,0,0,1,0.44,0.4394,0.54,0,120,226,346,226
7319,11/6/2011,4,0,11,13,0,0,0,1,0.46,0.4545,0.51,0.1642,105,209,314,209
7320,11/6/2011,4,0,11,14,0,0,0,1,0.46,0.4545,0.55,0.194,101,219,320,219
7321,11/6/2011,4,0,11,15,0,0,0,1,0.48,0.4697,0.51,0.194,96,210,306,210
7322,11/6/2011,4,0,11,16,0,0,0,1,0.46,0.4545,0.55,0.2239,84,263,347,263
7323,11/6/2011,4,0,11,17,0,0,0,1,0.44,0.4394,0.62,0.1642,71,185,256,185
7324,11/6/2011,4,0,11,18,0,0,0,1,0.42,0.4242,0.71,0.1045,39,146,185,146
7325,11/6/2011,4,0,11,19,0,0,0,1,0.38,0.3939,0.76,0.194,21,130,151,130
7326,11/6/2011,4,0,11,20,0,0,0,1,0.36,0.3636,0.81,0.1045,16,100,116,100
7327,11/6/2011,4,0,11,21,0,0,0,1,0.36,0.3636,0.81,0.0896,11,77,88,77
7328,11/6/2011,4,0,11,22,0,0,0,1,0.36,0.3788,0.87,0,5,40,45,40
7329,11/6/2011,4,0,11,23,0,0,0,1,0.34,0.3485,0.87,0.0896,7,43,50,43
7330,11/7/2011,4,0,11,0,0,1,1,1,0.34,0.3636,0.87,0,1,14,15,14
7331,11/7/2011,4,0,11,1,0,1,1,1,0.34,0.3636,0.87,0,2,6,8,6
7332,11/7/2011,4,0,11,2,0,1,1,1,0.32,0.3485,0.93,0,0,2,2,2
7333,11/7/2011,4,0,11,3,0,1,1,1,0.32,0.3485,0.93,0,0,3,3,3
7334,11/7/2011,4,0,11,4,0,1,1,1,0.32,0.3485,0.93,0,2,4,6,4
7335,11/7/2011,4,0,11,5,0,1,1,1,0.3,0.3333,0.93,0,1,25,26,25
7336,11/7/2011,4,0,11,6,0,1,1,2,0.28,0.3182,0.93,0,2,97,99,97
7337,11/7/2011,4,0,11,7,0,1,1,2,0.28,0.3182,0.93,0,6,305,311,305
7338,11/7/2011,4,0,11,8,0,1,1,2,0.3,0.3182,1,0.0896,13,397,410,397
7339,11/7/2011,4,0,11,9,0,1,1,2,0.34,0.3333,1,0.1343,18,156,174,156
7340,11/7/2011,4,0,11,10,0,1,1,1,0.36,0.3485,0.93,0.1343,28,95,123,95
7341,11/7/2011,4,0,11,11,0,1,1,1,0.42,0.4242,0.77,0.1045,28,100,128,100
7342,11/7/2011,4,0,11,12,0,1,1,1,0.46,0.4545,0.67,0,21,158,179,158
7343,11/7/2011,4,0,11,13,0,1,1,1,0.54,0.5152,0.49,0.0896,32,157,189,157
7344,11/7/2011,4,0,11,14,0,1,1,1,0.56,0.5303,0.37,0.1642,30,115,145,115
7345,11/7/2011,4,0,11,15,0,1,1,1,0.56,0.5303,0.37,0.1045,38,132,170,132
7346,11/7/2011,4,0,11,16,0,1,1,1,0.52,0.5,0.45,0,40,255,295,255
7347,11/7/2011,4,0,11,17,0,1,1,1,0.5,0.4848,0.45,0.1642,39,489,528,489
7348,11/7/2011,4,0,11,18,0,1,1,1,0.46,0.4545,0.59,0.1045,18,407,425,407
7349,11/7/2011,4,0,11,19,0,1,1,1,0.46,0.4545,0.59,0,20,280,300,280
7350,11/7/2011,4,0,11,20,0,1,1,1,0.4,0.4091,0.71,0,17,187,204,187
7351,11/7/2011,4,0,11,21,0,1,1,1,0.38,0.3939,0.82,0.1045,10,129,139,129
7352,11/7/2011,4,0,11,22,0,1,1,1,0.36,0.3636,0.81,0.0896,6,102,108,102
7353,11/7/2011,4,0,11,23,0,1,1,1,0.36,0.3636,0.87,0.0896,1,47,48,47
7354,11/8/2011,4,0,11,0,0,2,1,1,0.34,0.3485,0.87,0.0896,0,18,18,18
7355,11/8/2011,4,0,11,1,0,2,1,1,0.32,0.3333,0.93,0.1045,3,8,11,8
7356,11/8/2011,4,0,11,2,0,2,1,1,0.32,0.3485,0.87,0,0,1,1,1
7357,11/8/2011,4,0,11,3,0,2,1,1,0.32,0.3485,0.87,0,0,3,3,3
7358,11/8/2011,4,0,11,4,0,2,1,1,0.3,0.3333,0.87,0,0,4,4,4
7359,11/8/2011,4,0,11,5,0,2,1,1,0.3,0.3182,0.87,0.0896,1,17,18,17
7360,11/8/2011,4,0,11,6,0,2,1,1,0.3,0.3333,0.87,0,3,96,99,96
7361,11/8/2011,4,0,11,7,0,2,1,1,0.3,0.3182,0.87,0.1045,7,316,323,316
7362,11/8/2011,4,0,11,8,0,2,1,1,0.32,0.3333,0.93,0.1045,11,455,466,455
7363,11/8/2011,4,0,11,9,0,2,1,1,0.36,0.3788,0.87,0,14,177,191,177
7364,11/8/2011,4,0,11,10,0,2,1,1,0.42,0.4242,0.71,0.0896,25,104,129,104
7365,11/8/2011,4,0,11,11,0,2,1,1,0.46,0.4545,0.63,0.1343,21,126,147,126
7366,11/8/2011,4,0,11,12,0,2,1,1,0.52,0.5,0.52,0.1343,28,175,203,175
7367,11/8/2011,4,0,11,13,0,2,1,1,0.54,0.5152,0.49,0.1642,31,165,196,165
7368,11/8/2011,4,0,11,14,0,2,1,1,0.56,0.5303,0.46,0.1045,32,129,161,129
7369,11/8/2011,4,0,11,15,0,2,1,1,0.58,0.5455,0.46,0.1045,33,155,188,155
7370,11/8/2011,4,0,11,16,0,2,1,1,0.56,0.5303,0.46,0.1343,39,250,289,250
7371,11/8/2011,4,0,11,17,0,2,1,1,0.52,0.5,0.43,0.1642,40,459,499,459
7372,11/8/2011,4,0,11,18,0,2,1,1,0.48,0.4697,0.55,0.1343,30,432,462,432
7373,11/8/2011,4,0,11,19,0,2,1,1,0.46,0.4545,0.59,0,14,264,278,264
7374,11/8/2011,4,0,11,20,0,2,1,1,0.4,0.4091,0.76,0,12,169,181,169
7375,11/8/2011,4,0,11,21,0,2,1,1,0.4,0.4091,0.76,0,16,166,182,166
7376,11/8/2011,4,0,11,22,0,2,1,1,0.36,0.3788,0.87,0,13,95,108,95
7377,11/8/2011,4,0,11,23,0,2,1,1,0.36,0.3788,0.81,0,3,45,48,45
7378,11/9/2011,4,0,11,0,0,3,1,1,0.36,0.3788,0.87,0,0,13,13,13
7379,11/9/2011,4,0,11,1,0,3,1,1,0.34,0.3636,0.87,0,0,10,10,10
7380,11/9/2011,4,0,11,2,0,3,1,1,0.32,0.3485,0.93,0,0,5,5,5
7381,11/9/2011,4,0,11,3,0,3,1,1,0.32,0.3485,0.93,0,0,4,4,4
7382,11/9/2011,4,0,11,4,0,3,1,1,0.32,0.3485,0.87,0,0,4,4,4
7383,11/9/2011,4,0,11,5,0,3,1,1,0.3,0.3333,0.87,0,0,28,28,28
7384,11/9/2011,4,0,11,6,0,3,1,1,0.3,0.3333,0.87,0,0,98,98,98
7385,11/9/2011,4,0,11,7,0,3,1,1,0.3,0.3333,0.87,0,0,300,300,300
7386,11/9/2011,4,0,11,8,0,3,1,1,0.32,0.3485,0.93,0,19,437,456,437
7387,11/9/2011,4,0,11,9,0,3,1,1,0.34,0.3636,0.93,0,22,197,219,197
7388,11/9/2011,4,0,11,10,0,3,1,1,0.4,0.4091,0.76,0.1045,16,89,105,89
7389,11/9/2011,4,0,11,11,0,3,1,1,0.46,0.4545,0.67,0.1642,21,131,152,131
7390,11/9/2011,4,0,11,12,0,3,1,1,0.5,0.4848,0.51,0.1642,24,156,180,156
7391,11/9/2011,4,0,11,13,0,3,1,1,0.5,0.4848,0.51,0.1642,31,136,167,136
7392,11/9/2011,4,0,11,14,0,3,1,1,0.52,0.5,0.48,0.1642,26,153,179,153
7393,11/9/2011,4,0,11,15,0,3,1,1,0.52,0.5,0.45,0.2239,21,130,151,130
7394,11/9/2011,4,0,11,16,0,3,1,1,0.52,0.5,0.48,0.194,24,257,281,257
7395,11/9/2011,4,0,11,17,0,3,1,1,0.46,0.4545,0.63,0.1045,27,458,485,458
7396,11/9/2011,4,0,11,18,0,3,1,1,0.44,0.4394,0.67,0.1045,21,387,408,387
7397,11/9/2011,4,0,11,19,0,3,1,1,0.44,0.4394,0.72,0.1045,12,292,304,292
7398,11/9/2011,4,0,11,20,0,3,1,1,0.44,0.4394,0.77,0,18,201,219,201
7399,11/9/2011,4,0,11,21,0,3,1,1,0.4,0.4091,0.87,0,9,152,161,152
7400,11/9/2011,4,0,11,22,0,3,1,1,0.4,0.4091,0.87,0,9,105,114,105
7401,11/9/2011,4,0,11,23,0,3,1,1,0.38,0.3939,0.87,0,5,61,66,61
7402,11/10/2011,4,0,11,0,0,4,1,1,0.4,0.4091,0.87,0,0,24,24,24
7403,11/10/2011,4,0,11,1,0,4,1,2,0.4,0.4091,0.87,0,1,10,11,10
7404,11/10/2011,4,0,11,2,0,4,1,2,0.38,0.3939,0.94,0,0,5,5,5
7405,11/10/2011,4,0,11,3,0,4,1,1,0.38,0.3939,0.94,0.0896,0,11,11,11
7406,11/10/2011,4,0,11,4,0,4,1,1,0.38,0.3939,0.94,0.0896,1,2,3,2
7407,11/10/2011,4,0,11,5,0,4,1,2,0.36,0.3485,1,0.1343,1,22,23,22
7408,11/10/2011,4,0,11,6,0,4,1,2,0.36,0.3485,1,0.1343,4,110,114,110
7409,11/10/2011,4,0,11,7,0,4,1,2,0.38,0.3939,0.94,0.1642,6,266,272,266
7410,11/10/2011,4,0,11,8,0,4,1,2,0.4,0.4091,0.94,0.0896,18,418,436,418
7411,11/10/2011,4,0,11,9,0,4,1,2,0.42,0.4242,0.94,0.1045,23,188,211,188
7412,11/10/2011,4,0,11,10,0,4,1,2,0.44,0.4394,0.88,0.2239,17,100,117,100
7413,11/10/2011,4,0,11,11,0,4,1,2,0.46,0.4545,0.67,0.3881,9,99,108,99
7414,11/10/2011,4,0,11,12,0,4,1,2,0.42,0.4242,0.67,0.3582,18,149,167,149
7415,11/10/2011,4,0,11,13,0,4,1,3,0.36,0.3333,0.81,0.3582,9,87,96,87
7416,11/10/2011,4,0,11,14,0,4,1,3,0.36,0.3333,0.87,0.2836,6,58,64,58
7417,11/10/2011,4,0,11,15,0,4,1,3,0.36,0.3333,0.81,0.2985,5,57,62,57
7418,11/10/2011,4,0,11,16,0,4,1,3,0.36,0.3485,0.81,0.2239,6,67,73,67
7419,11/10/2011,4,0,11,17,0,4,1,3,0.36,0.3485,0.81,0.2239,9,168,177,168
7420,11/10/2011,4,0,11,18,0,4,1,2,0.36,0.3485,0.81,0.1642,10,263,273,263
7421,11/10/2011,4,0,11,19,0,4,1,2,0.36,0.3485,0.71,0.2239,19,192,211,192
7422,11/10/2011,4,0,11,20,0,4,1,2,0.36,0.3333,0.62,0.2836,8,160,168,160
7423,11/10/2011,4,0,11,21,0,4,1,1,0.36,0.3333,0.57,0.2537,6,130,136,130
7424,11/10/2011,4,0,11,22,0,4,1,1,0.36,0.3333,0.53,0.2836,5,84,89,84
7425,11/10/2011,4,0,11,23,0,4,1,2,0.34,0.3333,0.57,0.1642,9,73,82,73
7426,11/11/2011,4,0,11,0,1,5,0,1,0.34,0.3182,0.53,0.2537,10,56,66,56
7427,11/11/2011,4,0,11,1,1,5,0,1,0.32,0.303,0.57,0.3284,3,16,19,16
7428,11/11/2011,4,0,11,2,1,5,0,1,0.32,0.2879,0.57,0.2836,1,10,11,10
7429,11/11/2011,4,0,11,3,1,5,0,1,0.3,0.2879,0.61,0.194,0,6,6,6
7430,11/11/2011,4,0,11,4,1,5,0,1,0.3,0.2879,0.61,0.194,0,8,8,8
7431,11/11/2011,4,0,11,5,1,5,0,1,0.3,0.2879,0.49,0.2537,0,13,13,13
7432,11/11/2011,4,0,11,6,1,5,0,1,0.28,0.2576,0.45,0.3284,0,46,46,46
7433,11/11/2011,4,0,11,7,1,5,0,1,0.28,0.2727,0.45,0.2537,5,116,121,116
7434,11/11/2011,4,0,11,8,1,5,0,1,0.3,0.2727,0.42,0.3582,9,249,258,249
7435,11/11/2011,4,0,11,9,1,5,0,1,0.32,0.2879,0.45,0.4478,15,186,201,186
7436,11/11/2011,4,0,11,10,1,5,0,1,0.32,0.2727,0.42,0.5522,38,162,200,162
7437,11/11/2011,4,0,11,11,1,5,0,1,0.34,0.2879,0.42,0.4925,20,150,170,150
7438,11/11/2011,4,0,11,12,1,5,0,1,0.34,0.2879,0.42,0.4627,41,198,239,198
7439,11/11/2011,4,0,11,13,1,5,0,1,0.38,0.3939,0.37,0.5522,57,179,236,179
7440,11/11/2011,4,0,11,14,1,5,0,1,0.38,0.3939,0.37,0.4627,64,183,247,183
7441,11/11/2011,4,0,11,15,1,5,0,1,0.36,0.3333,0.37,0.4179,29,187,216,187
7442,11/11/2011,4,0,11,16,1,5,0,1,0.36,0.3333,0.34,0.3284,49,189,238,189
7443,11/11/2011,4,0,11,17,1,5,0,1,0.34,0.303,0.39,0.3284,24,286,310,286
7444,11/11/2011,4,0,11,18,1,5,0,1,0.34,0.3182,0.39,0.2537,23,185,208,185
7445,11/11/2011,4,0,11,19,1,5,0,1,0.32,0.3182,0.39,0.1642,17,182,199,182
7446,11/11/2011,4,0,11,20,1,5,0,1,0.32,0.3182,0.39,0.194,12,97,109,97
7447,11/11/2011,4,0,11,21,1,5,0,1,0.3,0.303,0.45,0.1642,4,79,83,79
7448,11/11/2011,4,0,11,22,1,5,0,1,0.32,0.3182,0.39,0.194,13,78,91,78
7449,11/11/2011,4,0,11,23,1,5,0,1,0.3,0.3182,0.45,0.0896,6,67,73,67
7450,11/12/2011,4,0,11,0,0,6,0,1,0.24,0.2424,0.6,0.1343,12,52,64,52
7451,11/12/2011,4,0,11,1,0,6,0,1,0.24,0.2424,0.6,0.1343,9,45,54,45
7452,11/12/2011,4,0,11,2,0,6,0,1,0.24,0.2576,0.65,0.0896,7,39,46,39
7453,11/12/2011,4,0,11,3,0,6,0,1,0.24,0.2424,0.7,0.1343,4,13,17,13
7454,11/12/2011,4,0,11,4,0,6,0,1,0.2,0.2121,0.8,0.1343,0,7,7,7
7455,11/12/2011,4,0,11,5,0,6,0,1,0.22,0.2576,0.75,0.0896,1,3,4,3
7456,11/12/2011,4,0,11,6,0,6,0,1,0.22,0.2273,0.75,0.1642,0,7,7,7
7457,11/12/2011,4,0,11,7,0,6,0,1,0.22,0.2273,0.75,0.194,3,24,27,24
7458,11/12/2011,4,0,11,8,0,6,0,1,0.26,0.2576,0.7,0.194,14,87,101,87
7459,11/12/2011,4,0,11,9,0,6,0,1,0.3,0.303,0.61,0.1642,18,142,160,142
7460,11/12/2011,4,0,11,10,0,6,0,1,0.34,0.3182,0.61,0.2836,62,170,232,170
7461,11/12/2011,4,0,11,11,0,6,0,1,0.38,0.3939,0.54,0.2836,102,213,315,213
7462,11/12/2011,4,0,11,12,0,6,0,1,0.44,0.4394,0.44,0.2836,142,224,366,224
7463,11/12/2011,4,0,11,13,0,6,0,1,0.48,0.4697,0.36,0.2836,128,225,353,225
7464,11/12/2011,4,0,11,14,0,6,0,1,0.5,0.4848,0.36,0.2985,191,244,435,244
7465,11/12/2011,4,0,11,15,0,6,0,1,0.52,0.5,0.29,0.2836,165,221,386,221
7466,11/12/2011,4,0,11,16,0,6,0,1,0.52,0.5,0.32,0.2537,137,224,361,224
7467,11/12/2011,4,0,11,17,0,6,0,1,0.5,0.4848,0.34,0.2537,92,193,285,193
7468,11/12/2011,4,0,11,18,0,6,0,1,0.42,0.4242,0.58,0.194,53,150,203,150
7469,11/12/2011,4,0,11,19,0,6,0,1,0.42,0.4242,0.5,0.2537,32,139,171,139
7470,11/12/2011,4,0,11,20,0,6,0,1,0.42,0.4242,0.5,0.2836,31,101,132,101
7471,11/12/2011,4,0,11,21,0,6,0,1,0.42,0.4242,0.47,0.2836,19,103,122,103
7472,11/12/2011,4,0,11,22,0,6,0,1,0.42,0.4242,0.47,0.2537,30,88,118,88
7473,11/12/2011,4,0,11,23,0,6,0,1,0.4,0.4091,0.58,0.1642,23,78,101,78
7474,11/13/2011,4,0,11,0,0,0,0,2,0.4,0.4091,0.58,0.194,12,61,73,61
7475,11/13/2011,4,0,11,1,0,0,0,2,0.36,0.3485,0.66,0.194,13,58,71,58
7476,11/13/2011,4,0,11,2,0,0,0,1,0.36,0.3636,0.57,0.1045,9,48,57,48
7477,11/13/2011,4,0,11,3,0,0,0,2,0.36,0.3485,0.62,0.1343,8,20,28,20
7478,11/13/2011,4,0,11,4,0,0,0,2,0.36,0.3485,0.62,0.1343,1,5,6,5
7479,11/13/2011,4,0,11,5,0,0,0,1,0.34,0.3333,0.61,0.1642,2,3,5,3
7480,11/13/2011,4,0,11,6,0,0,0,1,0.34,0.3333,0.66,0.1343,5,18,23,18
7481,11/13/2011,4,0,11,7,0,0,0,1,0.34,0.3182,0.66,0.2239,13,30,43,30
7482,11/13/2011,4,0,11,8,0,0,0,1,0.34,0.3485,0.66,0.0896,24,55,79,55
7483,11/13/2011,4,0,11,9,0,0,0,1,0.4,0.4091,0.54,0.2836,38,97,135,97
7484,11/13/2011,4,0,11,10,0,0,0,1,0.44,0.4394,0.44,0.3284,63,178,241,178
7485,11/13/2011,4,0,11,11,0,0,0,1,0.46,0.4545,0.4,0.4179,108,187,295,187
7486,11/13/2011,4,0,11,12,0,0,0,2,0.52,0.5,0.29,0.4179,112,242,354,242
7487,11/13/2011,4,0,11,13,0,0,0,2,0.52,0.5,0.29,0.4179,105,234,339,234
7488,11/13/2011,4,0,11,14,0,0,0,2,0.54,0.5152,0.28,0.4925,108,263,371,263
7489,11/13/2011,4,0,11,15,0,0,0,2,0.5,0.4848,0.42,0.3284,89,221,310,221
7490,11/13/2011,4,0,11,16,0,0,0,2,0.54,0.5152,0.28,0.3881,93,226,319,226
7491,11/13/2011,4,0,11,17,0,0,0,1,0.52,0.5,0.27,0.3284,44,187,231,187
7492,11/13/2011,4,0,11,18,0,0,0,1,0.52,0.5,0.27,0.3284,35,155,190,155
7493,11/13/2011,4,0,11,19,0,0,0,1,0.5,0.4848,0.29,0.3582,36,121,157,121
7494,11/13/2011,4,0,11,20,0,0,0,1,0.5,0.4848,0.31,0.3582,24,115,139,115
7495,11/13/2011,4,0,11,21,0,0,0,1,0.48,0.4697,0.36,0.2537,19,76,95,76
7496,11/13/2011,4,0,11,22,0,0,0,1,0.48,0.4697,0.41,0.3881,25,64,89,64
7497,11/13/2011,4,0,11,23,0,0,0,1,0.46,0.4545,0.51,0.2985,18,49,67,49
7498,11/14/2011,4,0,11,0,0,1,1,1,0.46,0.4545,0.59,0.2836,8,22,30,22
7499,11/14/2011,4,0,11,1,0,1,1,1,0.46,0.4545,0.63,0.2985,5,6,11,6
7500,11/14/2011,4,0,11,2,0,1,1,1,0.46,0.4545,0.63,0.3582,7,10,17,10
7501,11/14/2011,4,0,11,3,0,1,1,1,0.44,0.4394,0.67,0.2836,4,3,7,3
7502,11/14/2011,4,0,11,4,0,1,1,1,0.44,0.4394,0.67,0.2239,0,5,5,5
7503,11/14/2011,4,0,11,5,0,1,1,2,0.44,0.4394,0.67,0.2537,0,19,19,19
7504,11/14/2011,4,0,11,6,0,1,1,2,0.44,0.4394,0.72,0.2239,10,104,114,104
7505,11/14/2011,4,0,11,7,0,1,1,1,0.44,0.4394,0.72,0.2537,11,311,322,311
7506,11/14/2011,4,0,11,8,0,1,1,2,0.46,0.4545,0.67,0.194,27,425,452,425
7507,11/14/2011,4,0,11,9,0,1,1,2,0.48,0.4697,0.67,0.3284,29,204,233,204
7508,11/14/2011,4,0,11,10,0,1,1,2,0.5,0.4848,0.63,0.2836,26,85,111,85
7509,11/14/2011,4,0,11,11,0,1,1,2,0.54,0.5152,0.6,0.2836,22,106,128,106
7510,11/14/2011,4,0,11,12,0,1,1,1,0.56,0.5303,0.56,0.2985,36,166,202,166
7511,11/14/2011,4,0,11,13,0,1,1,1,0.6,0.6212,0.49,0.3881,50,153,203,153
7512,11/14/2011,4,0,11,14,0,1,1,1,0.62,0.6212,0.46,0.4478,47,138,185,138
7513,11/14/2011,4,0,11,15,0,1,1,1,0.64,0.6212,0.44,0.3284,53,142,195,142
7514,11/14/2011,4,0,11,16,0,1,1,1,0.62,0.6212,0.46,0.4179,51,264,315,264
7515,11/14/2011,4,0,11,17,0,1,1,1,0.62,0.6212,0.46,0.2537,55,464,519,464
7516,11/14/2011,4,0,11,18,0,1,1,1,0.56,0.5303,0.56,0.2836,29,460,489,460
7517,11/14/2011,4,0,11,19,0,1,1,1,0.6,0.6212,0.53,0.2985,28,274,302,274
7518,11/14/2011,4,0,11,20,0,1,1,1,0.6,0.6212,0.53,0.3582,30,210,240,210
7519,11/14/2011,4,0,11,21,0,1,1,1,0.6,0.6212,0.53,0.3582,37,176,213,176
7520,11/14/2011,4,0,11,22,0,1,1,1,0.58,0.5455,0.56,0.3582,17,96,113,96
7521,11/14/2011,4,0,11,23,0,1,1,1,0.56,0.5303,0.64,0.2985,13,48,61,48
7522,11/15/2011,4,0,11,0,0,2,1,1,0.56,0.5303,0.64,0.3582,7,15,22,15
7523,11/15/2011,4,0,11,1,0,2,1,1,0.56,0.5303,0.6,0.2985,5,5,10,5
7524,11/15/2011,4,0,11,2,0,2,1,1,0.56,0.5303,0.64,0.2537,7,8,15,8
7525,11/15/2011,4,0,11,3,0,2,1,2,0.54,0.5152,0.68,0.3284,0,4,4,4
7526,11/15/2011,4,0,11,4,0,2,1,1,0.56,0.5303,0.64,0.2985,1,6,7,6
7527,11/15/2011,4,0,11,5,0,2,1,1,0.54,0.5152,0.68,0.2836,2,26,28,26
7528,11/15/2011,4,0,11,6,0,2,1,2,0.56,0.5303,0.64,0.0896,4,104,108,104
7529,11/15/2011,4,0,11,7,0,2,1,2,0.54,0.5152,0.68,0.1642,21,298,319,298
7530,11/15/2011,4,0,11,8,0,2,1,2,0.54,0.5152,0.68,0.1045,27,453,480,453
7531,11/15/2011,4,0,11,9,0,2,1,2,0.56,0.5303,0.64,0.0896,26,174,200,174
7532,11/15/2011,4,0,11,10,0,2,1,2,0.56,0.5303,0.64,0.2836,23,115,138,115
7533,11/15/2011,4,0,11,11,0,2,1,2,0.56,0.5303,0.64,0.194,18,116,134,116
7534,11/15/2011,4,0,11,12,0,2,1,2,0.54,0.5152,0.68,0,28,148,176,148
7535,11/15/2011,4,0,11,13,0,2,1,3,0.54,0.5152,0.6,0.2239,21,132,153,132
7536,11/15/2011,4,0,11,14,0,2,1,2,0.54,0.5152,0.6,0.2836,27,120,147,120
7537,11/15/2011,4,0,11,15,0,2,1,2,0.54,0.5152,0.6,0.1343,36,155,191,155
7538,11/15/2011,4,0,11,16,0,2,1,2,0.52,0.5,0.68,0.1343,31,240,271,240
7539,11/15/2011,4,0,11,17,0,2,1,2,0.5,0.4848,0.72,0.194,29,422,451,422
7540,11/15/2011,4,0,11,18,0,2,1,2,0.5,0.4848,0.72,0.2836,27,414,441,414
7541,11/15/2011,4,0,11,19,0,2,1,2,0.5,0.4848,0.72,0.3582,27,259,286,259
7542,11/15/2011,4,0,11,20,0,2,1,2,0.48,0.4697,0.82,0.1343,26,212,238,212
7543,11/15/2011,4,0,11,21,0,2,1,2,0.5,0.4848,0.77,0.0896,23,145,168,145
7544,11/15/2011,4,0,11,22,0,2,1,2,0.46,0.4545,0.88,0.1045,19,109,128,109
7545,11/15/2011,4,0,11,23,0,2,1,2,0.46,0.4545,0.94,0.1045,14,66,80,66
7546,11/16/2011,4,0,11,0,0,3,1,2,0.46,0.4545,0.94,0,5,26,31,26
7547,11/16/2011,4,0,11,1,0,3,1,3,0.46,0.4545,0.94,0.0896,0,5,5,5
7548,11/16/2011,4,0,11,2,0,3,1,2,0.46,0.4545,0.94,0.1045,4,6,10,6
7549,11/16/2011,4,0,11,3,0,3,1,2,0.46,0.4545,0.94,0.1045,2,3,5,3
7550,11/16/2011,4,0,11,4,0,3,1,2,0.44,0.4394,1,0.2239,1,3,4,3
7551,11/16/2011,4,0,11,5,0,3,1,3,0.46,0.4545,0.94,0.1045,0,13,13,13
7552,11/16/2011,4,0,11,6,0,3,1,2,0.46,0.4545,0.94,0.0896,4,52,56,52
7553,11/16/2011,4,0,11,7,0,3,1,3,0.46,0.4545,0.94,0,7,130,137,130
7554,11/16/2011,4,0,11,8,0,3,1,3,0.46,0.4545,0.94,0,9,223,232,223
7555,11/16/2011,4,0,11,9,0,3,1,3,0.46,0.4545,0.94,0,5,77,82,77
7556,11/16/2011,4,0,11,10,0,3,1,3,0.46,0.4545,0.94,0,4,32,36,32
7557,11/16/2011,4,0,11,11,0,3,1,3,0.46,0.4545,0.94,0.0896,7,53,60,53
7558,11/16/2011,4,0,11,12,0,3,1,3,0.46,0.4545,1,0,5,49,54,49
7559,11/16/2011,4,0,11,13,0,3,1,3,0.46,0.4545,0.94,0.1343,6,52,58,52
7560,11/16/2011,4,0,11,14,0,3,1,2,0.46,0.4545,1,0.1343,12,49,61,49
7561,11/16/2011,4,0,11,15,0,3,1,3,0.48,0.4697,0.94,0.1045,16,50,66,50
7562,11/16/2011,4,0,11,16,0,3,1,3,0.48,0.4697,0.94,0.1045,13,110,123,110
7563,11/16/2011,4,0,11,17,0,3,1,2,0.48,0.4697,0.88,0.194,17,216,233,216
7564,11/16/2011,4,0,11,18,0,3,1,3,0.46,0.4545,0.88,0.3881,13,176,189,176
7565,11/16/2011,4,0,11,19,0,3,1,3,0.46,0.4545,0.88,0.3881,3,108,111,108
7566,11/16/2011,4,0,11,20,0,3,1,3,0.44,0.4394,0.88,0.3881,5,94,99,94
7567,11/16/2011,4,0,11,21,0,3,1,3,0.44,0.4394,0.88,0.2836,3,72,75,72
7568,11/16/2011,4,0,11,22,0,3,1,3,0.42,0.4242,0.88,0.2239,1,45,46,45
7569,11/16/2011,4,0,11,23,0,3,1,3,0.42,0.4242,0.88,0.1343,3,28,31,28
7570,11/17/2011,4,0,11,0,0,4,1,2,0.42,0.4242,0.88,0.2537,2,22,24,22
7571,11/17/2011,4,0,11,1,0,4,1,2,0.42,0.4242,0.82,0.1642,0,5,5,5
7572,11/17/2011,4,0,11,2,0,4,1,2,0.42,0.4242,0.82,0.2239,0,5,5,5
7573,11/17/2011,4,0,11,3,0,4,1,2,0.42,0.4242,0.77,0.3284,0,3,3,3
7574,11/17/2011,4,0,11,4,0,4,1,2,0.4,0.4091,0.62,0.4179,1,3,4,3
7575,11/17/2011,4,0,11,5,0,4,1,3,0.34,0.303,0.71,0.3284,1,21,22,21
7576,11/17/2011,4,0,11,6,0,4,1,3,0.36,0.3485,0.57,0.2239,3,72,75,72
7577,11/17/2011,4,0,11,7,0,4,1,3,0.34,0.3182,0.61,0.2836,4,164,168,164
7578,11/17/2011,4,0,11,8,0,4,1,3,0.34,0.303,0.61,0.2985,12,343,355,343
7579,11/17/2011,4,0,11,9,0,4,1,2,0.34,0.303,0.61,0.3284,14,184,198,184
7580,11/17/2011,4,0,11,10,0,4,1,2,0.34,0.303,0.61,0.3284,7,74,81,74
7581,11/17/2011,4,0,11,11,0,4,1,3,0.32,0.303,0.66,0.3284,4,93,97,93
7582,11/17/2011,4,0,11,12,0,4,1,2,0.34,0.303,0.53,0.2985,6,115,121,115
7583,11/17/2011,4,0,11,13,0,4,1,2,0.34,0.303,0.49,0.4478,15,109,124,109
7584,11/17/2011,4,0,11,14,0,4,1,2,0.34,0.303,0.49,0.3881,5,105,110,105
7585,11/17/2011,4,0,11,15,0,4,1,2,0.34,0.303,0.49,0.4478,10,106,116,106
7586,11/17/2011,4,0,11,16,0,4,1,1,0.32,0.2879,0.39,0.4179,8,187,195,187
7587,11/17/2011,4,0,11,17,0,4,1,1,0.32,0.2879,0.42,0.3881,20,379,399,379
7588,11/17/2011,4,0,11,18,0,4,1,1,0.32,0.3182,0.39,0.194,9,298,307,298
7589,11/17/2011,4,0,11,19,0,4,1,1,0.3,0.2879,0.45,0.2239,7,210,217,210
7590,11/17/2011,4,0,11,20,0,4,1,1,0.3,0.2879,0.42,0.2836,7,162,169,162
7591,11/17/2011,4,0,11,21,0,4,1,1,0.3,0.2879,0.42,0.2537,3,113,116,113
7592,11/17/2011,4,0,11,22,0,4,1,1,0.26,0.2424,0.52,0.2537,1,83,84,83
7593,11/17/2011,4,0,11,23,0,4,1,1,0.26,0.2576,0.52,0.2239,0,58,58,58
7594,11/18/2011,4,0,11,0,0,5,1,1,0.26,0.2576,0.48,0.1642,2,28,30,28
7595,11/18/2011,4,0,11,1,0,5,1,1,0.26,0.2273,0.44,0.3284,0,10,10,10
7596,11/18/2011,4,0,11,2,0,5,1,1,0.24,0.2273,0.44,0.2239,2,8,10,8
7597,11/18/2011,4,0,11,3,0,5,1,1,0.24,0.2121,0.41,0.2836,0,2,2,2
7598,11/18/2011,4,0,11,4,0,5,1,1,0.22,0.2273,0.44,0.1642,0,5,5,5
7599,11/18/2011,4,0,11,5,0,5,1,1,0.22,0.2273,0.44,0.1343,0,22,22,22
7600,11/18/2011,4,0,11,6,0,5,1,1,0.22,0.2576,0.44,0.0896,1,70,71,70
7601,11/18/2011,4,0,11,7,0,5,1,1,0.22,0.2273,0.44,0.1642,5,211,216,211
7602,11/18/2011,4,0,11,8,0,5,1,1,0.22,0.2273,0.44,0.194,6,369,375,369
7603,11/18/2011,4,0,11,9,0,5,1,1,0.26,0.2576,0.41,0.194,6,207,213,207
7604,11/18/2011,4,0,11,10,0,5,1,1,0.26,0.2424,0.41,0.2836,10,105,115,105
7605,11/18/2011,4,0,11,11,0,5,1,1,0.3,0.303,0.36,0.1343,18,122,140,122
7606,11/18/2011,4,0,11,12,0,5,1,1,0.32,0.3333,0.33,0,22,143,165,143
7607,11/18/2011,4,0,11,13,0,5,1,1,0.34,0.3182,0.31,0.2239,31,146,177,146
7608,11/18/2011,4,0,11,14,0,5,1,1,0.34,0.3333,0.31,0.1343,31,123,154,123
7609,11/18/2011,4,0,11,15,0,5,1,1,0.34,0.3333,0.29,0.1343,27,151,178,151
7610,11/18/2011,4,0,11,16,0,5,1,1,0.34,0.3333,0.29,0.1343,19,190,209,190
7611,11/18/2011,4,0,11,17,0,5,1,1,0.32,0.3333,0.31,0.1343,17,361,378,361
7612,11/18/2011,4,0,11,18,0,5,1,1,0.3,0.303,0.36,0.1642,16,312,328,312
7613,11/18/2011,4,0,11,19,0,5,1,1,0.28,0.2727,0.41,0.1642,7,183,190,183
7614,11/18/2011,4,0,11,20,0,5,1,1,0.28,0.2727,0.48,0.194,8,129,137,129
7615,11/18/2011,4,0,11,21,0,5,1,1,0.28,0.2727,0.48,0.1642,3,108,111,108
7616,11/18/2011,4,0,11,22,0,5,1,1,0.26,0.2727,0.52,0.1045,9,88,97,88
7617,11/18/2011,4,0,11,23,0,5,1,1,0.26,0.2727,0.6,0.1343,5,54,59,54
7618,11/19/2011,4,0,11,0,0,6,0,1,0.26,0.2576,0.56,0.194,4,49,53,49
7619,11/19/2011,4,0,11,1,0,6,0,1,0.26,0.2273,0.52,0.2985,1,34,35,34
7620,11/19/2011,4,0,11,2,0,6,0,1,0.24,0.2424,0.56,0.1642,12,34,46,34
7621,11/19/2011,4,0,11,3,0,6,0,1,0.26,0.2424,0.48,0.2537,4,11,15,11
7622,11/19/2011,4,0,11,4,0,6,0,1,0.26,0.2273,0.48,0.3284,4,4,8,4
7623,11/19/2011,4,0,11,5,0,6,0,1,0.24,0.2273,0.56,0.2537,0,2,2,2
7624,11/19/2011,4,0,11,6,0,6,0,1,0.24,0.2121,0.6,0.3284,2,10,12,10
7625,11/19/2011,4,0,11,7,0,6,0,1,0.24,0.2273,0.6,0.2537,3,38,41,38
7626,11/19/2011,4,0,11,8,0,6,0,1,0.26,0.2424,0.56,0.2537,12,80,92,80
7627,11/19/2011,4,0,11,9,0,6,0,1,0.28,0.2576,0.52,0.2985,12,130,142,130
7628,11/19/2011,4,0,11,10,0,6,0,1,0.32,0.303,0.45,0.2537,35,165,200,165
7629,11/19/2011,4,0,11,11,0,6,0,1,0.36,0.3788,0.4,0,50,183,233,183
7630,11/19/2011,4,0,11,12,0,6,0,1,0.4,0.4091,0.35,0.2836,93,218,311,218
7631,11/19/2011,4,0,11,13,0,6,0,1,0.42,0.4242,0.3,0.2836,118,245,363,245
7632,11/19/2011,4,0,11,14,0,6,0,1,0.42,0.4242,0.32,0.2985,121,228,349,228
7633,11/19/2011,4,0,11,15,0,6,0,1,0.42,0.4242,0.41,0.194,120,262,382,262
7634,11/19/2011,4,0,11,16,0,6,0,1,0.42,0.4242,0.38,0.2985,99,188,287,188
7635,11/19/2011,4,0,11,17,0,6,0,1,0.4,0.4091,0.4,0.194,61,171,232,171
7636,11/19/2011,4,0,11,18,0,6,0,1,0.38,0.3939,0.46,0.1343,36,172,208,172
7637,11/19/2011,4,0,11,19,0,6,0,2,0.34,0.3333,0.71,0.1343,33,149,182,149
7638,11/19/2011,4,0,11,20,0,6,0,2,0.36,0.3636,0.57,0.1045,48,115,163,115
7639,11/19/2011,4,0,11,21,0,6,0,2,0.36,0.3485,0.62,0.194,29,79,108,79
7640,11/19/2011,4,0,11,22,0,6,0,2,0.38,0.3939,0.62,0.1642,26,80,106,80
7641,11/19/2011,4,0,11,23,0,6,0,1,0.38,0.3939,0.62,0.2239,20,73,93,73
7642,11/20/2011,4,0,11,0,0,0,0,1,0.38,0.3939,0.66,0.1642,14,79,93,79
7643,11/20/2011,4,0,11,1,0,0,0,1,0.4,0.4091,0.62,0.2537,11,73,84,73
7644,11/20/2011,4,0,11,2,0,0,0,1,0.4,0.4091,0.62,0.2836,12,44,56,44
7645,11/20/2011,4,0,11,3,0,0,0,2,0.4,0.4091,0.66,0.2836,6,31,37,31
7646,11/20/2011,4,0,11,4,0,0,0,2,0.4,0.4091,0.71,0.2836,2,10,12,10
7647,11/20/2011,4,0,11,5,0,0,0,2,0.42,0.4242,0.67,0.2836,0,4,4,4
7648,11/20/2011,4,0,11,6,0,0,0,2,0.42,0.4242,0.67,0.2537,3,6,9,6
7649,11/20/2011,4,0,11,7,0,0,0,1,0.42,0.4242,0.67,0.2239,4,19,23,19
7650,11/20/2011,4,0,11,8,0,0,0,2,0.42,0.4242,0.71,0.2836,13,52,65,52
7651,11/20/2011,4,0,11,9,0,0,0,1,0.44,0.4394,0.72,0.1642,29,109,138,109
7652,11/20/2011,4,0,11,10,0,0,0,2,0.44,0.4394,0.72,0.1045,46,183,229,183
7653,11/20/2011,4,0,11,11,0,0,0,2,0.5,0.4848,0.63,0.1045,74,212,286,212
7654,11/20/2011,4,0,11,12,0,0,0,2,0.5,0.4848,0.63,0.1343,70,234,304,234
7655,11/20/2011,4,0,11,13,0,0,0,2,0.54,0.5152,0.6,0.194,84,285,369,285
7656,11/20/2011,4,0,11,14,0,0,0,1,0.52,0.5,0.63,0.2537,113,250,363,250
7657,11/20/2011,4,0,11,15,0,0,0,2,0.52,0.5,0.68,0.194,109,242,351,242
7658,11/20/2011,4,0,11,16,0,0,0,2,0.52,0.5,0.63,0.1343,81,225,306,225
7659,11/20/2011,4,0,11,17,0,0,0,2,0.52,0.5,0.63,0.194,35,168,203,168
7660,11/20/2011,4,0,11,18,0,0,0,2,0.54,0.5152,0.64,0.194,22,123,145,123
7661,11/20/2011,4,0,11,19,0,0,0,2,0.5,0.4848,0.72,0.1045,17,140,157,140
7662,11/20/2011,4,0,11,20,0,0,0,2,0.52,0.5,0.68,0.1045,23,90,113,90
7663,11/20/2011,4,0,11,21,0,0,0,2,0.48,0.4697,0.77,0.0896,11,94,105,94
7664,11/20/2011,4,0,11,22,0,0,0,3,0.46,0.4545,0.88,0.0896,5,35,40,35
7665,11/20/2011,4,0,11,23,0,0,0,3,0.46,0.4545,0.88,0.0896,3,25,28,25
7666,11/21/2011,4,0,11,0,0,1,1,2,0.46,0.4545,0.94,0,4,13,17,13
7667,11/21/2011,4,0,11,1,0,1,1,3,0.46,0.4545,0.94,0.194,4,8,12,8
7668,11/21/2011,4,0,11,2,0,1,1,3,0.44,0.4394,1,0.194,1,2,3,2
7669,11/21/2011,4,0,11,3,0,1,1,3,0.44,0.4394,1,0.1343,0,4,4,4
7670,11/21/2011,4,0,11,4,0,1,1,3,0.44,0.4394,1,0.1343,0,5,5,5
7671,11/21/2011,4,0,11,5,0,1,1,2,0.44,0.4394,1,0,0,20,20,20
7672,11/21/2011,4,0,11,6,0,1,1,2,0.42,0.4242,1,0,0,76,76,76
7673,11/21/2011,4,0,11,7,0,1,1,2,0.46,0.4545,0.94,0.1642,17,229,246,229
7674,11/21/2011,4,0,11,8,0,1,1,2,0.46,0.4545,0.94,0,13,378,391,378
7675,11/21/2011,4,0,11,9,0,1,1,2,0.48,0.4697,0.94,0.1045,15,222,237,222
7676,11/21/2011,4,0,11,10,0,1,1,2,0.52,0.5,0.83,0,25,110,135,110
7677,11/21/2011,4,0,11,11,0,1,1,2,0.52,0.5,0.83,0.1045,16,112,128,112
7678,11/21/2011,4,0,11,12,0,1,1,2,0.5,0.4848,0.77,0.1343,24,138,162,138
7679,11/21/2011,4,0,11,13,0,1,1,2,0.5,0.4848,0.77,0.1343,13,121,134,121
7680,11/21/2011,4,0,11,14,0,1,1,2,0.48,0.4697,0.82,0.194,14,121,135,121
7681,11/21/2011,4,0,11,15,0,1,1,3,0.44,0.4394,0.94,0.2239,15,93,108,93
7682,11/21/2011,4,0,11,16,0,1,1,3,0.44,0.4394,0.94,0.2239,13,95,108,95
7683,11/21/2011,4,0,11,17,0,1,1,3,0.42,0.4242,0.94,0.2985,10,200,210,200
7684,11/21/2011,4,0,11,18,0,1,1,3,0.42,0.4242,0.88,0.194,8,184,192,184
7685,11/21/2011,4,0,11,19,0,1,1,3,0.4,0.4091,0.94,0.194,2,135,137,135
7686,11/21/2011,4,0,11,20,0,1,1,3,0.4,0.4091,0.87,0.2239,5,75,80,75
7687,11/21/2011,4,0,11,21,0,1,1,3,0.4,0.4091,0.87,0.1642,11,103,114,103
7688,11/21/2011,4,0,11,22,0,1,1,3,0.4,0.4091,0.87,0.1343,6,72,78,72
7689,11/21/2011,4,0,11,23,0,1,1,3,0.4,0.4091,0.87,0.1642,4,29,33,29
7690,11/22/2011,4,0,11,0,0,2,1,3,0.38,0.3939,0.94,0.1045,0,14,14,14
7691,11/22/2011,4,0,11,1,0,2,1,3,0.4,0.4091,0.94,0.1343,1,5,6,5
7692,11/22/2011,4,0,11,2,0,2,1,3,0.38,0.3939,1,0.1045,2,4,6,4
7693,11/22/2011,4,0,11,3,0,2,1,3,0.38,0.3939,1,0.1045,1,2,3,2
7694,11/22/2011,4,0,11,4,0,2,1,3,0.38,0.3939,0.94,0.1642,0,7,7,7
7695,11/22/2011,4,0,11,5,0,2,1,3,0.38,0.3939,0.94,0.1642,1,17,18,17
7696,11/22/2011,4,0,11,6,0,2,1,2,0.38,0.3939,0.94,0.1045,1,63,64,63
7697,11/22/2011,4,0,11,7,0,2,1,3,0.38,0.3939,0.94,0.2239,2,119,121,119
7698,11/22/2011,4,0,11,8,0,2,1,3,0.38,0.3939,0.94,0.2239,5,185,190,185
7699,11/22/2011,4,0,11,9,0,2,1,3,0.4,0.4091,0.94,0,2,147,149,147
7700,11/22/2011,4,0,11,10,0,2,1,3,0.4,0.4091,0.94,0,6,46,52,46
7701,11/22/2011,4,0,11,11,0,2,1,3,0.4,0.4091,0.94,0.1343,4,28,32,28
7702,11/22/2011,4,0,11,12,0,2,1,3,0.4,0.4091,1,0.0896,3,18,21,18
7703,11/22/2011,4,0,11,13,0,2,1,3,0.42,0.4242,1,0.0896,4,22,26,22
7704,11/22/2011,4,0,11,14,0,2,1,3,0.42,0.4242,1,0.0896,4,31,35,31
7705,11/22/2011,4,0,11,15,0,2,1,3,0.44,0.4394,0.94,0,2,32,34,32
7706,11/22/2011,4,0,11,16,0,2,1,3,0.44,0.4394,0.94,0,3,59,62,59
7707,11/22/2011,4,0,11,17,0,2,1,3,0.44,0.4394,1,0.0896,4,161,165,161
7708,11/22/2011,4,0,11,18,0,2,1,3,0.44,0.4394,1,0,0,148,148,148
7709,11/22/2011,4,0,11,19,0,2,1,3,0.46,0.4545,0.94,0.1045,5,106,111,106
7710,11/22/2011,4,0,11,20,0,2,1,2,0.46,0.4545,1,0.2239,6,121,127,121
7711,11/22/2011,4,0,11,21,0,2,1,2,0.46,0.4545,1,0.2537,4,86,90,86
7712,11/22/2011,4,0,11,22,0,2,1,2,0.5,0.4848,0.94,0.194,6,81,87,81
7713,11/22/2011,4,0,11,23,0,2,1,2,0.48,0.4697,0.94,0.2537,3,36,39,36
7714,11/23/2011,4,0,11,0,0,3,1,2,0.48,0.4697,0.94,0.2537,2,14,16,14
7715,11/23/2011,4,0,11,1,0,3,1,2,0.48,0.4697,0.94,0.2985,0,8,8,8
7716,11/23/2011,4,0,11,2,0,3,1,3,0.5,0.4848,0.94,0.3582,1,5,6,5
7717,11/23/2011,4,0,11,3,0,3,1,3,0.5,0.4848,0.94,0.3582,1,2,3,2
7718,11/23/2011,4,0,11,4,0,3,1,3,0.52,0.5,0.88,0.3582,0,5,5,5
7719,11/23/2011,4,0,11,5,0,3,1,2,0.46,0.4545,0.94,0.194,1,16,17,16
7720,11/23/2011,4,0,11,6,0,3,1,2,0.44,0.4394,1,0,1,68,69,68
7721,11/23/2011,4,0,11,7,0,3,1,2,0.46,0.4545,1,0.0896,2,154,156,154
7722,11/23/2011,4,0,11,8,0,3,1,2,0.48,0.4697,0.94,0.1045,7,316,323,316
7723,11/23/2011,4,0,11,9,0,3,1,2,0.52,0.5,0.94,0.194,3,164,167,164
7724,11/23/2011,4,0,11,10,0,3,1,2,0.52,0.5,0.94,0.194,6,70,76,70
7725,11/23/2011,4,0,11,11,0,3,1,2,0.5,0.4848,0.72,0.4179,9,107,116,107
7726,11/23/2011,4,0,11,12,0,3,1,1,0.48,0.4697,0.55,0.4179,9,151,160,151
7727,11/23/2011,4,0,11,13,0,3,1,2,0.44,0.4394,0.54,0.4925,12,162,174,162
7728,11/23/2011,4,0,11,14,0,3,1,1,0.42,0.4242,0.54,0.4627,13,200,213,200
7729,11/23/2011,4,0,11,15,0,3,1,2,0.42,0.4242,0.54,0.4478,13,194,207,194
7730,11/23/2011,4,0,11,16,0,3,1,2,0.4,0.4091,0.62,0.4627,4,169,173,169
7731,11/23/2011,4,0,11,17,0,3,1,3,0.38,0.3939,0.71,0.3881,7,156,163,156
7732,11/23/2011,4,0,11,18,0,3,1,2,0.4,0.4091,0.58,0.5224,7,138,145,138
7733,11/23/2011,4,0,11,19,0,3,1,1,0.38,0.3939,0.58,0.3881,6,116,122,116
7734,11/23/2011,4,0,11,20,0,3,1,1,0.36,0.3333,0.62,0.3881,1,67,68,67
7735,11/23/2011,4,0,11,21,0,3,1,1,0.36,0.3182,0.57,0.4627,0,66,66,66
7736,11/23/2011,4,0,11,22,0,3,1,1,0.34,0.303,0.61,0.4478,3,59,62,59
7737,11/23/2011,4,0,11,23,0,3,1,1,0.34,0.303,0.61,0.3582,4,47,51,47
7738,11/24/2011,4,0,11,0,1,4,0,1,0.32,0.303,0.57,0.2239,1,22,23,22
7739,11/24/2011,4,0,11,1,1,4,0,1,0.32,0.2879,0.57,0.4179,1,23,24,23
7740,11/24/2011,4,0,11,2,1,4,0,1,0.3,0.2879,0.61,0.2836,3,19,22,19
7741,11/24/2011,4,0,11,3,1,4,0,1,0.28,0.2879,0.65,0.1343,1,4,5,4
7742,11/24/2011,4,0,11,4,1,4,0,1,0.3,0.3182,0.61,0.0896,1,1,2,1
7743,11/24/2011,4,0,11,5,1,4,0,1,0.3,0.3182,0.61,0.1045,1,10,11,10
7744,11/24/2011,4,0,11,6,1,4,0,1,0.3,0.3182,0.61,0.0896,1,5,6,5
7745,11/24/2011,4,0,11,7,1,4,0,1,0.26,0.2727,0.75,0.1045,9,31,40,31
7746,11/24/2011,4,0,11,8,1,4,0,1,0.3,0.3182,0.65,0.0896,4,42,46,42
7747,11/24/2011,4,0,11,9,1,4,0,1,0.34,0.3485,0.61,0,13,68,81,68
7748,11/24/2011,4,0,11,10,1,4,0,1,0.36,0.3788,0.57,0,34,64,98,64
7749,11/24/2011,4,0,11,11,1,4,0,1,0.42,0.4242,0.41,0.2985,52,90,142,90
7750,11/24/2011,4,0,11,12,1,4,0,1,0.46,0.4545,0.36,0.2239,62,88,150,88
7751,11/24/2011,4,0,11,13,1,4,0,1,0.48,0.4697,0.33,0.2239,84,91,175,91
7752,11/24/2011,4,0,11,14,1,4,0,1,0.5,0.4848,0.31,0.2985,74,94,168,94
7753,11/24/2011,4,0,11,15,1,4,0,1,0.5,0.4848,0.31,0.2537,78,71,149,71
7754,11/24/2011,4,0,11,16,1,4,0,1,0.5,0.4848,0.34,0.2836,48,66,114,66
7755,11/24/2011,4,0,11,17,1,4,0,1,0.48,0.4697,0.33,0.1045,34,40,74,40
7756,11/24/2011,4,0,11,18,1,4,0,1,0.42,0.4242,0.5,0.0896,13,24,37,24
7757,11/24/2011,4,0,11,19,1,4,0,1,0.4,0.4091,0.54,0.1045,15,13,28,13
7758,11/24/2011,4,0,11,20,1,4,0,1,0.36,0.3485,0.76,0.1642,14,17,31,17
7759,11/24/2011,4,0,11,21,1,4,0,1,0.36,0.3485,0.71,0.1642,7,19,26,19
7760,11/24/2011,4,0,11,22,1,4,0,1,0.36,0.3485,0.71,0.1642,8,14,22,14
7761,11/24/2011,4,0,11,23,1,4,0,1,0.34,0.3485,0.76,0.1045,2,19,21,19
7762,11/25/2011,4,0,11,0,0,5,1,1,0.34,0.3333,0.76,0.1642,7,22,29,22
7763,11/25/2011,4,0,11,1,0,5,1,1,0.34,0.3636,0.76,0,2,12,14,12
7764,11/25/2011,4,0,11,2,0,5,1,1,0.28,0.2879,0.81,0.1045,4,6,10,6
7765,11/25/2011,4,0,11,3,0,5,1,1,0.28,0.2879,0.75,0.1045,0,2,2,2
7766,11/25/2011,4,0,11,4,0,5,1,1,0.3,0.3182,0.75,0.1045,4,3,7,3
7767,11/25/2011,4,0,11,5,0,5,1,1,0.28,0.3182,0.75,0,2,3,5,3
7768,11/25/2011,4,0,11,6,0,5,1,1,0.26,0.2727,0.81,0.1045,4,9,13,9
7769,11/25/2011,4,0,11,7,0,5,1,1,0.26,0.303,0.81,0,4,31,35,31
7770,11/25/2011,4,0,11,8,0,5,1,1,0.26,0.2727,0.81,0.1343,6,68,74,68
7771,11/25/2011,4,0,11,9,0,5,1,1,0.32,0.3485,0.76,0,25,70,95,70
7772,11/25/2011,4,0,11,10,0,5,1,1,0.36,0.3485,0.71,0.1642,60,82,142,82
7773,11/25/2011,4,0,11,11,0,5,1,1,0.4,0.4091,0.66,0.1045,99,127,226,127
7774,11/25/2011,4,0,11,12,0,5,1,1,0.46,0.4545,0.51,0.1045,126,146,272,146
7775,11/25/2011,4,0,11,13,0,5,1,1,0.5,0.4848,0.45,0.2239,143,140,283,140
7776,11/25/2011,4,0,11,14,0,5,1,1,0.52,0.5,0.39,0.2239,122,150,272,150
7777,11/25/2011,4,0,11,15,0,5,1,1,0.52,0.5,0.36,0.194,165,145,310,145
7778,11/25/2011,4,0,11,16,0,5,1,1,0.5,0.4848,0.39,0.1642,122,139,261,139
7779,11/25/2011,4,0,11,17,0,5,1,1,0.5,0.4848,0.34,0.1045,57,127,184,127
7780,11/25/2011,4,0,11,18,0,5,1,1,0.46,0.4545,0.44,0.0896,45,108,153,108
7781,11/25/2011,4,0,11,19,0,5,1,1,0.42,0.4242,0.67,0,38,96,134,96
7782,11/25/2011,4,0,11,20,0,5,1,1,0.4,0.4091,0.58,0.0896,19,76,95,76
7783,11/25/2011,4,0,11,21,0,5,1,1,0.36,0.3788,0.71,0,24,61,85,61
7784,11/25/2011,4,0,11,22,0,5,1,1,0.34,0.3485,0.71,0.0896,12,46,58,46
7785,11/25/2011,4,0,11,23,0,5,1,1,0.34,0.3485,0.76,0.1045,5,28,33,28
7786,11/26/2011,4,0,11,0,0,6,0,1,0.34,0.3485,0.76,0.1045,9,38,47,38
7787,11/26/2011,4,0,11,1,0,6,0,1,0.32,0.3333,0.76,0.0896,5,24,29,24
7788,11/26/2011,4,0,11,2,0,6,0,1,0.3,0.3182,0.81,0.1045,3,20,23,20
7789,11/26/2011,4,0,11,3,0,6,0,1,0.3,0.3333,0.81,0,8,9,17,9
7790,11/26/2011,4,0,11,4,0,6,0,1,0.3,0.3333,0.81,0,0,4,4,4
7791,11/26/2011,4,0,11,5,0,6,0,1,0.3,0.3182,0.75,0.1045,0,3,3,3
7792,11/26/2011,4,0,11,6,0,6,0,2,0.3,0.3182,0.75,0.0896,2,8,10,8
7793,11/26/2011,4,0,11,7,0,6,0,1,0.26,0.2727,0.87,0.1045,4,13,17,13
7794,11/26/2011,4,0,11,8,0,6,0,1,0.32,0.3333,0.76,0.0896,10,50,60,50
7795,11/26/2011,4,0,11,9,0,6,0,1,0.34,0.3485,0.76,0.0896,16,67,83,67
7796,11/26/2011,4,0,11,10,0,6,0,1,0.36,0.3788,0.81,0,57,84,141,84
7797,11/26/2011,4,0,11,11,0,6,0,1,0.4,0.4091,0.62,0.1045,107,123,230,123
7798,11/26/2011,4,0,11,12,0,6,0,1,0.44,0.4394,0.51,0,137,172,309,172
7799,11/26/2011,4,0,11,13,0,6,0,1,0.48,0.4697,0.44,0,177,148,325,148
7800,11/26/2011,4,0,11,14,0,6,0,2,0.48,0.4697,0.48,0.1343,141,158,299,158
7801,11/26/2011,4,0,11,15,0,6,0,2,0.5,0.4848,0.42,0.1045,154,160,314,160
7802,11/26/2011,4,0,11,16,0,6,0,2,0.46,0.4545,0.47,0.1343,137,138,275,138
7803,11/26/2011,4,0,11,17,0,6,0,2,0.46,0.4545,0.47,0.1343,62,122,184,122
7804,11/26/2011,4,0,11,18,0,6,0,2,0.42,0.4242,0.62,0.1642,67,118,185,118
7805,11/26/2011,4,0,11,19,0,6,0,2,0.4,0.4091,0.71,0.0896,46,100,146,100
7806,11/26/2011,4,0,11,20,0,6,0,2,0.42,0.4242,0.58,0,55,86,141,86
7807,11/26/2011,4,0,11,21,0,6,0,2,0.38,0.3939,0.82,0,20,72,92,72
7808,11/26/2011,4,0,11,22,0,6,0,2,0.38,0.3939,0.76,0,14,51,65,51
7809,11/26/2011,4,0,11,23,0,6,0,1,0.36,0.3788,0.81,0,18,51,69,51
7810,11/27/2011,4,0,11,0,0,0,0,1,0.36,0.3788,0.81,0,7,39,46,39
7811,11/27/2011,4,0,11,1,0,0,0,1,0.36,0.3788,0.81,0,9,35,44,35
7812,11/27/2011,4,0,11,2,0,0,0,1,0.34,0.3636,0.81,0,9,22,31,22
7813,11/27/2011,4,0,11,3,0,0,0,1,0.34,0.3636,0.87,0,9,8,17,8
7814,11/27/2011,4,0,11,4,0,0,0,1,0.34,0.3485,0.87,0.1045,0,4,4,4
7815,11/27/2011,4,0,11,5,0,0,0,1,0.36,0.3485,0.87,0.194,0,5,5,5
7816,11/27/2011,4,0,11,6,0,0,0,1,0.38,0.3939,0.82,0.1642,0,9,9,9
7817,11/27/2011,4,0,11,7,0,0,0,1,0.38,0.3939,0.87,0.2239,12,11,23,11
7818,11/27/2011,4,0,11,8,0,0,0,1,0.4,0.4091,0.82,0.2985,6,36,42,36
7819,11/27/2011,4,0,11,9,0,0,0,1,0.46,0.4545,0.72,0.2836,21,90,111,90
7820,11/27/2011,4,0,11,10,0,0,0,1,0.46,0.4545,0.72,0.2836,58,131,189,131
7821,11/27/2011,4,0,11,11,0,0,0,1,0.5,0.4848,0.63,0.3582,83,157,240,157
7822,11/27/2011,4,0,11,12,0,0,0,1,0.54,0.5152,0.56,0.2836,63,193,256,193
7823,11/27/2011,4,0,11,13,0,0,0,1,0.54,0.5152,0.6,0.194,97,216,313,216
7824,11/27/2011,4,0,11,14,0,0,0,1,0.62,0.6212,0.43,0.4627,113,200,313,200
7825,11/27/2011,4,0,11,15,0,0,0,1,0.62,0.6212,0.43,0.2836,96,221,317,221
7826,11/27/2011,4,0,11,16,0,0,0,1,0.56,0.5303,0.52,0.2537,94,229,323,229
7827,11/27/2011,4,0,11,17,0,0,0,1,0.54,0.5152,0.56,0.194,37,167,204,167
7828,11/27/2011,4,0,11,18,0,0,0,1,0.5,0.4848,0.63,0.1642,25,130,155,130
7829,11/27/2011,4,0,11,19,0,0,0,1,0.48,0.4697,0.67,0.2239,30,109,139,109
7830,11/27/2011,4,0,11,20,0,0,0,1,0.5,0.4848,0.63,0.2537,10,94,104,94
7831,11/27/2011,4,0,11,21,0,0,0,1,0.48,0.4697,0.67,0.2836,13,75,88,75
7832,11/27/2011,4,0,11,22,0,0,0,1,0.48,0.4697,0.72,0.2537,13,53,66,53
7833,11/27/2011,4,0,11,23,0,0,0,1,0.48,0.4697,0.72,0.2537,5,27,32,27
7834,11/28/2011,4,0,11,0,0,1,1,1,0.46,0.4545,0.77,0.2836,6,10,16,10
7835,11/28/2011,4,0,11,1,0,1,1,1,0.46,0.4545,0.77,0.2985,1,12,13,12
7836,11/28/2011,4,0,11,3,0,1,1,1,0.44,0.4394,0.88,0.2239,1,4,5,4
7837,11/28/2011,4,0,11,4,0,1,1,1,0.44,0.4394,0.82,0.0896,0,4,4,4
7838,11/28/2011,4,0,11,5,0,1,1,1,0.4,0.4091,0.87,0,0,34,34,34
7839,11/28/2011,4,0,11,6,0,1,1,1,0.42,0.4242,0.82,0.0896,6,98,104,98
7840,11/28/2011,4,0,11,7,0,1,1,1,0.42,0.4242,0.88,0,7,270,277,270
7841,11/28/2011,4,0,11,8,0,1,1,2,0.42,0.4242,0.94,0,13,394,407,394
7842,11/28/2011,4,0,11,9,0,1,1,2,0.44,0.4394,0.88,0.2239,17,191,208,191
7843,11/28/2011,4,0,11,10,0,1,1,2,0.48,0.4697,0.77,0.1343,21,86,107,86
7844,11/28/2011,4,0,11,11,0,1,1,2,0.52,0.5,0.68,0.1045,11,107,118,107
7845,11/28/2011,4,0,11,12,0,1,1,1,0.56,0.5303,0.6,0.1045,13,165,178,165
7846,11/28/2011,4,0,11,13,0,1,1,2,0.58,0.5455,0.56,0,25,137,162,137
7847,11/28/2011,4,0,11,14,0,1,1,1,0.6,0.6212,0.56,0,14,129,143,129
7848,11/28/2011,4,0,11,15,0,1,1,1,0.58,0.5455,0.6,0.1642,18,132,150,132
7849,11/28/2011,4,0,11,16,0,1,1,1,0.56,0.5303,0.6,0.194,24,240,264,240
7850,11/28/2011,4,0,11,17,0,1,1,1,0.58,0.5455,0.56,0.194,24,444,468,444
7851,11/28/2011,4,0,11,18,0,1,1,1,0.56,0.5303,0.64,0.2239,20,396,416,396
7852,11/28/2011,4,0,11,19,0,1,1,1,0.54,0.5152,0.73,0.2239,4,260,264,260
7853,11/28/2011,4,0,11,20,0,1,1,2,0.54,0.5152,0.73,0.2537,12,206,218,206
7854,11/28/2011,4,0,11,21,0,1,1,2,0.54,0.5152,0.77,0.2239,4,152,156,152
7855,11/28/2011,4,0,11,22,0,1,1,2,0.52,0.5,0.83,0.1045,7,102,109,102
7856,11/28/2011,4,0,11,23,0,1,1,2,0.52,0.5,0.83,0.1343,5,41,46,41
7857,11/29/2011,4,0,11,0,0,2,1,1,0.52,0.5,0.83,0,4,18,22,18
7858,11/29/2011,4,0,11,1,0,2,1,1,0.52,0.5,0.83,0.0896,1,16,17,16
7859,11/29/2011,4,0,11,2,0,2,1,2,0.5,0.4848,0.88,0,0,5,5,5
7860,11/29/2011,4,0,11,3,0,2,1,2,0.5,0.4848,0.88,0,0,2,2,2
7861,11/29/2011,4,0,11,4,0,2,1,2,0.52,0.5,0.83,0.3284,1,5,6,5
7862,11/29/2011,4,0,11,5,0,2,1,1,0.5,0.4848,0.88,0.2836,1,21,22,21
7863,11/29/2011,4,0,11,6,0,2,1,1,0.52,0.5,0.83,0.2836,1,88,89,88
7864,11/29/2011,4,0,11,7,0,2,1,1,0.52,0.5,0.77,0.2239,12,330,342,330
7865,11/29/2011,4,0,11,8,0,2,1,1,0.54,0.5152,0.77,0.2836,9,440,449,440
7866,11/29/2011,4,0,11,9,0,2,1,3,0.56,0.5303,0.73,0.4179,5,197,202,197
7867,11/29/2011,4,0,11,10,0,2,1,3,0.56,0.5303,0.73,0.4179,2,34,36,34
7868,11/29/2011,4,0,11,11,0,2,1,3,0.5,0.4848,0.88,0.2985,1,10,11,10
7869,11/29/2011,4,0,11,12,0,2,1,3,0.42,0.4242,0.82,0.4179,1,17,18,17
7870,11/29/2011,4,0,11,13,0,2,1,3,0.42,0.4242,0.77,0.2836,0,22,22,22
7871,11/29/2011,4,0,11,14,0,2,1,3,0.4,0.4091,0.94,0.194,1,35,36,35
7872,11/29/2011,4,0,11,15,0,2,1,3,0.4,0.4091,0.87,0.3284,5,60,65,60
7873,11/29/2011,4,0,11,16,0,2,1,3,0.4,0.4091,0.87,0.2239,5,146,151,146
7874,11/29/2011,4,0,11,17,0,2,1,2,0.4,0.4091,0.87,0.2985,8,346,354,346
7875,11/29/2011,4,0,11,18,0,2,1,2,0.4,0.4091,0.82,0.2985,11,347,358,347
7876,11/29/2011,4,0,11,19,0,2,1,2,0.4,0.4091,0.82,0.3284,6,244,250,244
7877,11/29/2011,4,0,11,20,0,2,1,2,0.38,0.3939,0.87,0.2537,8,176,184,176
7878,11/29/2011,4,0,11,21,0,2,1,2,0.38,0.3939,0.87,0.2537,9,116,125,116
7879,11/29/2011,4,0,11,22,0,2,1,1,0.38,0.3939,0.82,0.2985,5,90,95,90
7880,11/29/2011,4,0,11,23,0,2,1,1,0.36,0.3333,0.76,0.3881,0,53,53,53
7881,11/30/2011,4,0,11,0,0,3,1,1,0.36,0.3333,0.62,0.4179,1,23,24,23
7882,11/30/2011,4,0,11,1,0,3,1,1,0.34,0.303,0.66,0.3284,0,8,8,8
7883,11/30/2011,4,0,11,2,0,3,1,1,0.32,0.3182,0.7,0.1642,0,5,5,5
7884,11/30/2011,4,0,11,3,0,3,1,1,0.32,0.3182,0.7,0.1642,0,1,1,1
7885,11/30/2011,4,0,11,4,0,3,1,1,0.3,0.2879,0.75,0.2239,0,5,5,5
7886,11/30/2011,4,0,11,5,0,3,1,1,0.28,0.2727,0.81,0.194,1,21,22,21
7887,11/30/2011,4,0,11,6,0,3,1,1,0.26,0.2727,0.87,0.1045,3,100,103,100
7888,11/30/2011,4,0,11,7,0,3,1,1,0.26,0.2727,0.81,0.1045,9,276,285,276
7889,11/30/2011,4,0,11,8,0,3,1,1,0.28,0.2727,0.81,0.194,13,465,478,465
7890,11/30/2011,4,0,11,9,0,3,1,1,0.3,0.2879,0.75,0.2836,7,186,193,186
7891,11/30/2011,4,0,11,10,0,3,1,1,0.34,0.3182,0.66,0.2239,15,95,110,95
7892,11/30/2011,4,0,11,11,0,3,1,1,0.38,0.3939,0.54,0.2985,10,112,122,112
7893,11/30/2011,4,0,11,12,0,3,1,2,0.36,0.3333,0.53,0.2836,12,148,160,148
7894,11/30/2011,4,0,11,13,0,3,1,2,0.38,0.3939,0.43,0.3582,16,131,147,131
7895,11/30/2011,4,0,11,14,0,3,1,2,0.38,0.3939,0.43,0.3582,13,99,112,99
7896,11/30/2011,4,0,11,15,0,3,1,1,0.36,0.3333,0.46,0.3284,11,104,115,104
7897,11/30/2011,4,0,11,16,0,3,1,1,0.36,0.3333,0.46,0.2836,27,199,226,199
7898,11/30/2011,4,0,11,17,0,3,1,2,0.34,0.303,0.49,0.3284,15,365,380,365
7899,11/30/2011,4,0,11,18,0,3,1,1,0.34,0.303,0.49,0.3284,7,369,376,369
7900,11/30/2011,4,0,11,19,0,3,1,2,0.32,0.303,0.57,0.2836,6,273,279,273
7901,11/30/2011,4,0,11,20,0,3,1,2,0.32,0.303,0.57,0.2836,6,184,190,184
7902,11/30/2011,4,0,11,21,0,3,1,1,0.32,0.2879,0.53,0.3881,7,128,135,128
7903,11/30/2011,4,0,11,22,0,3,1,1,0.3,0.2727,0.56,0.2985,5,82,87,82
7904,11/30/2011,4,0,11,23,0,3,1,1,0.28,0.2576,0.52,0.2836,4,46,50,46
7905,12/1/2011,4,0,12,0,0,4,1,1,0.28,0.2576,0.52,0.3284,1,19,20,19
7906,12/1/2011,4,0,12,1,0,4,1,1,0.26,0.2424,0.6,0.2836,1,9,10,9
7907,12/1/2011,4,0,12,2,0,4,1,1,0.26,0.2273,0.56,0.2985,1,8,9,8
7908,12/1/2011,4,0,12,3,0,4,1,1,0.26,0.2424,0.56,0.2537,1,6,7,6
7909,12/1/2011,4,0,12,4,0,4,1,1,0.26,0.2424,0.56,0.2836,0,1,1,1
7910,12/1/2011,4,0,12,5,0,4,1,1,0.26,0.2424,0.56,0.2537,1,23,24,23
7911,12/1/2011,4,0,12,6,0,4,1,1,0.24,0.2121,0.65,0.2836,5,92,97,92
7912,12/1/2011,4,0,12,7,0,4,1,1,0.24,0.2121,0.65,0.3582,11,265,276,265
7913,12/1/2011,4,0,12,8,0,4,1,1,0.26,0.2273,0.6,0.3284,15,462,477,462
7914,12/1/2011,4,0,12,9,0,4,1,1,0.3,0.2727,0.52,0.3284,9,215,224,215
7915,12/1/2011,4,0,12,10,0,4,1,1,0.32,0.303,0.53,0.2985,7,86,93,86
7916,12/1/2011,4,0,12,11,0,4,1,1,0.34,0.3182,0.49,0.2537,7,95,102,95
7917,12/1/2011,4,0,12,12,0,4,1,1,0.36,0.3485,0.46,0.2239,9,139,148,139
7918,12/1/2011,4,0,12,13,0,4,1,1,0.4,0.4091,0.4,0.2239,17,137,154,137
7919,12/1/2011,4,0,12,14,0,4,1,1,0.4,0.4091,0.4,0.2239,20,130,150,130
7920,12/1/2011,4,0,12,15,0,4,1,1,0.4,0.4091,0.4,0.2239,10,144,154,144
7921,12/1/2011,4,0,12,16,0,4,1,1,0.4,0.4091,0.4,0.194,9,192,201,192
7922,12/1/2011,4,0,12,17,0,4,1,1,0.36,0.3485,0.46,0.1343,9,409,418,409
7923,12/1/2011,4,0,12,18,0,4,1,1,0.36,0.3636,0.43,0.1045,12,393,405,393
7924,12/1/2011,4,0,12,19,0,4,1,1,0.34,0.3485,0.46,0.1045,9,219,228,219
7925,12/1/2011,4,0,12,20,0,4,1,1,0.34,0.3485,0.46,0.1045,12,178,190,178
7926,12/1/2011,4,0,12,21,0,4,1,1,0.3,0.3182,0.61,0.1045,8,154,162,154
7927,12/1/2011,4,0,12,22,0,4,1,1,0.3,0.3333,0.61,0,5,99,104,99
7928,12/1/2011,4,0,12,23,0,4,1,1,0.26,0.2879,0.7,0.0896,3,70,73,70
7929,12/2/2011,4,0,12,0,0,5,1,1,0.26,0.2879,0.7,0.0896,6,32,38,32
7930,12/2/2011,4,0,12,1,0,5,1,1,0.24,0.2879,0.75,0,1,14,15,14
7931,12/2/2011,4,0,12,2,0,5,1,1,0.24,0.2879,0.75,0,0,10,10,10
7932,12/2/2011,4,0,12,3,0,5,1,1,0.22,0.2727,0.8,0,0,1,1,1
7933,12/2/2011,4,0,12,4,0,5,1,1,0.22,0.2727,0.8,0,0,3,3,3
7934,12/2/2011,4,0,12,5,0,5,1,1,0.22,0.2576,0.8,0.0896,0,23,23,23
7935,12/2/2011,4,0,12,6,0,5,1,1,0.22,0.2727,0.8,0,3,84,87,84
7936,12/2/2011,4,0,12,7,0,5,1,1,0.22,0.2576,0.87,0.0896,6,199,205,199
7937,12/2/2011,4,0,12,8,0,5,1,1,0.24,0.2879,0.87,0,13,432,445,432
7938,12/2/2011,4,0,12,9,0,5,1,1,0.28,0.3182,0.81,0,12,234,246,234
7939,12/2/2011,4,0,12,10,0,5,1,1,0.3,0.2879,0.75,0.2239,16,89,105,89
7940,12/2/2011,4,0,12,11,0,5,1,1,0.34,0.3333,0.66,0.1642,18,142,160,142
7941,12/2/2011,4,0,12,12,0,5,1,1,0.36,0.3485,0.57,0.1343,18,186,204,186
7942,12/2/2011,4,0,12,13,0,5,1,1,0.4,0.4091,0.47,0.1343,19,188,207,188
7943,12/2/2011,4,0,12,14,0,5,1,1,0.42,0.4242,0.44,0.1045,25,145,170,145
7944,12/2/2011,4,0,12,15,0,5,1,1,0.42,0.4242,0.41,0.0896,24,175,199,175
7945,12/2/2011,4,0,12,16,0,5,1,1,0.42,0.4242,0.41,0.0896,22,254,276,254
7946,12/2/2011,4,0,12,17,0,5,1,1,0.42,0.4242,0.38,0,20,391,411,391
7947,12/2/2011,4,0,12,18,0,5,1,1,0.4,0.4091,0.5,0,10,362,372,362
7948,12/2/2011,4,0,12,19,0,5,1,1,0.34,0.3182,0.53,0.2537,13,252,265,252
7949,12/2/2011,4,0,12,20,0,5,1,1,0.38,0.3939,0.4,0.2836,12,178,190,178
7950,12/2/2011,4,0,12,21,0,5,1,1,0.34,0.3333,0.49,0.194,9,102,111,102
7951,12/2/2011,4,0,12,22,0,5,1,1,0.32,0.3182,0.53,0.194,7,95,102,95
7952,12/2/2011,4,0,12,23,0,5,1,1,0.32,0.303,0.53,0.2836,14,81,95,81
7953,12/3/2011,4,0,12,0,0,6,0,1,0.3,0.2879,0.56,0.2537,10,65,75,65
7954,12/3/2011,4,0,12,1,0,6,0,1,0.26,0.2576,0.65,0.194,9,62,71,62
7955,12/3/2011,4,0,12,2,0,6,0,1,0.26,0.2576,0.65,0.1642,9,41,50,41
7956,12/3/2011,4,0,12,3,0,6,0,1,0.24,0.2424,0.7,0.1343,4,5,9,5
7957,12/3/2011,4,0,12,4,0,6,0,1,0.22,0.2273,0.75,0.1343,1,7,8,7
7958,12/3/2011,4,0,12,5,0,6,0,1,0.24,0.2576,0.7,0.0896,0,6,6,6
7959,12/3/2011,4,0,12,6,0,6,0,1,0.24,0.2576,0.65,0.1045,1,10,11,10
7960,12/3/2011,4,0,12,7,0,6,0,1,0.22,0.2576,0.75,0.0896,2,24,26,24
7961,12/3/2011,4,0,12,8,0,6,0,1,0.24,0.2576,0.75,0.0896,1,62,63,62
7962,12/3/2011,4,0,12,9,0,6,0,1,0.26,0.2727,0.7,0.1045,25,99,124,99
7963,12/3/2011,4,0,12,10,0,6,0,1,0.32,0.3333,0.61,0.1343,22,173,195,173
7964,12/3/2011,4,0,12,11,0,6,0,1,0.32,0.3333,0.57,0.0896,48,227,275,227
7965,12/3/2011,4,0,12,12,0,6,0,1,0.36,0.3788,0.5,0,78,280,358,280
7966,12/3/2011,4,0,12,13,0,6,0,1,0.36,0.3636,0.5,0.0896,70,222,292,222
7967,12/3/2011,4,0,12,14,0,6,0,1,0.36,0.3788,0.46,0,92,251,343,251
7968,12/3/2011,4,0,12,15,0,6,0,1,0.38,0.3939,0.46,0,100,237,337,237
7969,12/3/2011,4,0,12,16,0,6,0,1,0.38,0.3939,0.46,0,75,230,305,230
7970,12/3/2011,4,0,12,17,0,6,0,1,0.36,0.3788,0.62,0,46,186,232,186
7971,12/3/2011,4,0,12,18,0,6,0,1,0.34,0.3333,0.53,0.1343,31,193,224,193
7972,12/3/2011,4,0,12,19,0,6,0,1,0.3,0.3182,0.61,0.0896,31,144,175,144
7973,12/3/2011,4,0,12,20,0,6,0,1,0.3,0.3182,0.61,0.0896,17,110,127,110
7974,12/3/2011,4,0,12,21,0,6,0,2,0.3,0.3182,0.61,0.0896,5,104,109,104
7975,12/3/2011,4,0,12,22,0,6,0,2,0.32,0.3333,0.61,0.0896,17,97,114,97
7976,12/3/2011,4,0,12,23,0,6,0,1,0.3,0.303,0.7,0.1343,12,73,85,73
7977,12/4/2011,4,0,12,0,0,0,0,1,0.3,0.3182,0.7,0.1045,19,64,83,64
7978,12/4/2011,4,0,12,1,0,0,0,1,0.3,0.3182,0.75,0.0896,20,54,74,54
7979,12/4/2011,4,0,12,2,0,0,0,1,0.26,0.303,0.81,0,11,51,62,51
7980,12/4/2011,4,0,12,3,0,0,0,1,0.28,0.3182,0.75,0,7,34,41,34
7981,12/4/2011,4,0,12,4,0,0,0,1,0.26,0.303,0.87,0,2,9,11,9
7982,12/4/2011,4,0,12,5,0,0,0,1,0.26,0.303,0.81,0,2,2,4,2
7983,12/4/2011,4,0,12,6,0,0,0,1,0.24,0.2879,0.93,0,1,3,4,3
7984,12/4/2011,4,0,12,7,0,0,0,1,0.26,0.303,0.87,0,3,23,26,23
7985,12/4/2011,4,0,12,8,0,0,0,1,0.26,0.303,0.87,0,7,48,55,48
7986,12/4/2011,4,0,12,9,0,0,0,1,0.3,0.3333,0.81,0,12,114,126,114
7987,12/4/2011,4,0,12,10,0,0,0,1,0.32,0.3333,0.81,0.1343,36,180,216,180
7988,12/4/2011,4,0,12,11,0,0,0,1,0.34,0.3333,0.81,0.1642,48,206,254,206
7989,12/4/2011,4,0,12,12,0,0,0,1,0.36,0.3485,0.81,0.1642,82,247,329,247
7990,12/4/2011,4,0,12,13,0,0,0,1,0.4,0.4091,0.66,0.2239,88,269,357,269
7991,12/4/2011,4,0,12,14,0,0,0,1,0.42,0.4242,0.62,0.1343,77,246,323,246
7992,12/4/2011,4,0,12,15,0,0,0,1,0.42,0.4242,0.62,0.194,69,227,296,227
7993,12/4/2011,4,0,12,16,0,0,0,1,0.42,0.4242,0.58,0.2239,64,266,330,266
7994,12/4/2011,4,0,12,17,0,0,0,1,0.38,0.3939,0.76,0.1343,38,207,245,207
7995,12/4/2011,4,0,12,18,0,0,0,1,0.38,0.3939,0.71,0,10,161,171,161
7996,12/4/2011,4,0,12,19,0,0,0,1,0.38,0.3939,0.76,0,15,158,173,158
7997,12/4/2011,4,0,12,20,0,0,0,1,0.36,0.3485,0.76,0.1343,8,116,124,116
7998,12/4/2011,4,0,12,21,0,0,0,1,0.36,0.3636,0.81,0.1045,7,65,72,65
7999,12/4/2011,4,0,12,22,0,0,0,1,0.34,0.3485,0.87,0.1045,5,59,64,59
8000,12/4/2011,4,0,12,23,0,0,0,1,0.34,0.3485,0.87,0.1045,3,42,45,42
8001,12/5/2011,4,0,12,0,0,1,1,1,0.32,0.3333,0.87,0.0896,3,21,24,21
8002,12/5/2011,4,0,12,1,0,1,1,1,0.32,0.3485,0.87,0,2,10,12,10
8003,12/5/2011,4,0,12,2,0,1,1,1,0.32,0.3485,0.87,0,0,8,8,8
8004,12/5/2011,4,0,12,3,0,1,1,1,0.32,0.3485,0.87,0,0,2,2,2
8005,12/5/2011,4,0,12,4,0,1,1,1,0.3,0.3182,0.87,0.1045,0,7,7,7
8006,12/5/2011,4,0,12,5,0,1,1,1,0.3,0.3182,0.87,0.1045,1,24,25,24
8007,12/5/2011,4,0,12,6,0,1,1,1,0.3,0.3182,0.93,0.0896,1,89,90,89
8008,12/5/2011,4,0,12,7,0,1,1,1,0.32,0.3485,0.9,0,9,274,283,274
8009,12/5/2011,4,0,12,8,0,1,1,1,0.32,0.3485,0.93,0,12,392,404,392
8010,12/5/2011,4,0,12,9,0,1,1,2,0.36,0.3636,0.87,0.0896,12,178,190,178
8011,12/5/2011,4,0,12,10,0,1,1,2,0.36,0.3636,0.87,0.0896,9,78,87,78
8012,12/5/2011,4,0,12,11,0,1,1,2,0.36,0.3636,0.87,0.0896,17,106,123,106
8013,12/5/2011,4,0,12,12,0,1,1,2,0.4,0.4091,0.76,0.1045,29,125,154,125
8014,12/5/2011,4,0,12,13,0,1,1,2,0.42,0.4242,0.71,0.0896,18,153,171,153
8015,12/5/2011,4,0,12,14,0,1,1,2,0.46,0.4545,0.67,0,7,126,133,126
8016,12/5/2011,4,0,12,15,0,1,1,2,0.46,0.4545,0.72,0.0896,16,132,148,132
8017,12/5/2011,4,0,12,16,0,1,1,1,0.5,0.4848,0.63,0.0896,10,238,248,238
8018,12/5/2011,4,0,12,17,0,1,1,1,0.42,0.4242,0.77,0,16,430,446,430
8019,12/5/2011,4,0,12,18,0,1,1,1,0.44,0.4394,0.77,0,13,386,399,386
8020,12/5/2011,4,0,12,19,0,1,1,2,0.46,0.4545,0.77,0,13,295,308,295
8021,12/5/2011,4,0,12,20,0,1,1,2,0.46,0.4545,0.82,0.1045,15,190,205,190
8022,12/5/2011,4,0,12,21,0,1,1,2,0.44,0.4394,0.88,0.0896,10,166,176,166
8023,12/5/2011,4,0,12,22,0,1,1,2,0.44,0.4394,0.88,0.1343,12,94,106,94
8024,12/5/2011,4,0,12,23,0,1,1,2,0.46,0.4545,0.88,0.1343,8,54,62,54
8025,12/6/2011,4,0,12,0,0,2,1,2,0.5,0.4848,0.77,0.2985,3,25,28,25
8026,12/6/2011,4,0,12,1,0,2,1,2,0.46,0.4545,0.88,0.2985,2,14,16,14
8027,12/6/2011,4,0,12,2,0,2,1,2,0.46,0.4545,0.87,0.194,0,3,3,3
8028,12/6/2011,4,0,12,3,0,2,1,2,0.46,0.4545,0.87,0.194,0,3,3,3
8029,12/6/2011,4,0,12,4,0,2,1,3,0.46,0.4545,0.88,0.2239,0,7,7,7
8030,12/6/2011,4,0,12,5,0,2,1,3,0.46,0.4545,0.88,0.2239,0,20,20,20
8031,12/6/2011,4,0,12,6,0,2,1,2,0.44,0.4394,0.94,0.2836,5,81,86,81
8032,12/6/2011,4,0,12,7,0,2,1,2,0.46,0.4545,0.94,0.194,7,227,234,227
8033,12/6/2011,4,0,12,8,0,2,1,2,0.46,0.4545,0.94,0.194,13,401,414,401
8034,12/6/2011,4,0,12,9,0,2,1,2,0.46,0.4545,0.94,0.2239,4,200,204,200
8035,12/6/2011,4,0,12,10,0,2,1,3,0.46,0.4545,0.94,0.2836,6,44,50,44
8036,12/6/2011,4,0,12,11,0,2,1,3,0.46,0.4545,0.94,0.2537,4,28,32,28
8037,12/6/2011,4,0,12,12,0,2,1,3,0.46,0.4545,1,0.2239,5,50,55,50
8038,12/6/2011,4,0,12,13,0,2,1,3,0.46,0.4545,1,0.194,6,65,71,65
8039,12/6/2011,4,0,12,14,0,2,1,3,0.48,0.4697,1,0.2239,6,69,75,69
8040,12/6/2011,4,0,12,15,0,2,1,3,0.5,0.4848,1,0.194,2,43,45,43
8041,12/6/2011,4,0,12,16,0,2,1,3,0.46,0.4545,1,0.2537,4,84,88,84
8042,12/6/2011,4,0,12,17,0,2,1,2,0.46,0.4545,1,0.2239,13,249,262,249
8043,12/6/2011,4,0,12,18,0,2,1,2,0.46,0.4545,1,0.2836,17,287,304,287
8044,12/6/2011,4,0,12,19,0,2,1,3,0.46,0.4545,1,0.2985,10,223,233,223
8045,12/6/2011,4,0,12,20,0,2,1,3,0.46,0.4545,1,0.2985,3,107,110,107
8046,12/6/2011,4,0,12,21,0,2,1,2,0.44,0.4394,1,0.194,6,108,114,108
8047,12/6/2011,4,0,12,22,0,2,1,3,0.46,0.4545,1,0.1642,5,82,87,82
8048,12/6/2011,4,0,12,23,0,2,1,3,0.46,0.4545,1,0.1642,5,48,53,48
8049,12/7/2011,4,0,12,0,0,3,1,1,0.44,0.4394,1,0.194,3,30,33,30
8050,12/7/2011,4,0,12,1,0,3,1,2,0.46,0.4545,1,0.2537,4,9,13,9
8051,12/7/2011,4,0,12,2,0,3,1,3,0.46,0.4545,1,0.2239,2,4,6,4
8052,12/7/2011,4,0,12,3,0,3,1,3,0.46,0.4545,1,0.2239,0,3,3,3
8053,12/7/2011,4,0,12,4,0,3,1,3,0.46,0.4545,1,0.1642,0,1,1,1
8054,12/7/2011,4,0,12,5,0,3,1,3,0.46,0.4545,1,0.1642,0,3,3,3
8055,12/7/2011,4,0,12,6,0,3,1,3,0.48,0.4697,1,0.4179,0,18,18,18
8056,12/7/2011,4,0,12,7,0,3,1,3,0.44,0.4394,1,0.1045,3,43,46,43
8057,12/7/2011,4,0,12,8,0,3,1,3,0.44,0.4394,1,0,6,80,86,80
8058,12/7/2011,4,0,12,9,0,3,1,3,0.44,0.4394,1,0.2537,0,64,64,64
8059,12/7/2011,4,0,12,10,0,3,1,3,0.44,0.4394,1,0.0896,1,32,33,32
8060,12/7/2011,4,0,12,11,0,3,1,3,0.44,0.4394,1,0.0896,3,47,50,47
8061,12/7/2011,4,0,12,12,0,3,1,3,0.44,0.4394,1,0.1343,4,29,33,29
8062,12/7/2011,4,0,12,13,0,3,1,3,0.44,0.4394,1,0.194,5,28,33,28
8063,12/7/2011,4,0,12,14,0,3,1,3,0.44,0.4394,1,0.194,1,24,25,24
8064,12/7/2011,4,0,12,15,0,3,1,3,0.42,0.4242,0.94,0.2239,5,25,30,25
8065,12/7/2011,4,0,12,16,0,3,1,3,0.42,0.4242,0.94,0.194,3,28,31,28
8066,12/7/2011,4,0,12,17,0,3,1,3,0.4,0.4091,1,0.3284,4,48,52,48
8067,12/7/2011,4,0,12,18,0,3,1,3,0.4,0.4091,0.94,0.2985,3,48,51,48
8068,12/7/2011,4,0,12,19,0,3,1,3,0.34,0.2879,0.87,0.6418,2,31,33,31
8069,12/7/2011,4,0,12,20,0,3,1,3,0.34,0.2879,0.87,0.6418,1,25,26,25
8070,12/7/2011,4,0,12,21,0,3,1,3,0.3,0.2576,0.87,0.5224,0,6,6,6
8071,12/7/2011,4,0,12,22,0,3,1,3,0.24,0.197,0.93,0.4478,0,13,13,13
8072,12/7/2011,4,0,12,23,0,3,1,1,0.24,0.2121,0.93,0.3881,0,16,16,16
8073,12/8/2011,4,0,12,0,0,4,1,2,0.26,0.2273,0.87,0.2985,0,21,21,21
8074,12/8/2011,4,0,12,1,0,4,1,1,0.26,0.2273,0.81,0.3582,1,6,7,6
8075,12/8/2011,4,0,12,2,0,4,1,1,0.28,0.2727,0.65,0.2239,0,4,4,4
8076,12/8/2011,4,0,12,3,0,4,1,1,0.26,0.2273,0.6,0.2985,0,1,1,1
8077,12/8/2011,4,0,12,4,0,4,1,2,0.24,0.197,0.6,0.4627,0,2,2,2
8078,12/8/2011,4,0,12,5,0,4,1,1,0.22,0.2121,0.64,0.2239,0,12,12,12
8079,12/8/2011,4,0,12,6,0,4,1,1,0.22,0.2121,0.55,0.2836,0,71,71,71
8080,12/8/2011,4,0,12,7,0,4,1,1,0.22,0.2121,0.6,0.2239,11,233,244,233
8081,12/8/2011,4,0,12,8,0,4,1,1,0.22,0.2121,0.55,0.2836,11,418,429,418
8082,12/8/2011,4,0,12,9,0,4,1,1,0.24,0.2121,0.52,0.3881,7,218,225,218
8083,12/8/2011,4,0,12,10,0,4,1,1,0.26,0.2273,0.52,0.3284,1,109,110,109
8084,12/8/2011,4,0,12,11,0,4,1,1,0.28,0.2727,0.52,0.2537,6,100,106,100
8085,12/8/2011,4,0,12,12,0,4,1,1,0.28,0.2576,0.52,0.3284,8,148,156,148
8086,12/8/2011,4,0,12,13,0,4,1,1,0.3,0.2727,0.49,0.3582,9,115,124,115
8087,12/8/2011,4,0,12,14,0,4,1,1,0.32,0.303,0.45,0.2537,16,121,137,121
8088,12/8/2011,4,0,12,15,0,4,1,1,0.32,0.3333,0.45,0.1343,19,98,117,98
8089,12/8/2011,4,0,12,16,0,4,1,1,0.32,0.3182,0.45,0.194,7,201,208,201
8090,12/8/2011,4,0,12,17,0,4,1,1,0.3,0.3182,0.49,0.1045,10,321,331,321
8091,12/8/2011,4,0,12,18,0,4,1,1,0.28,0.2727,0.52,0.2239,12,306,318,306
8092,12/8/2011,4,0,12,19,0,4,1,1,0.26,0.2727,0.56,0.1045,12,220,232,220
8093,12/8/2011,4,0,12,20,0,4,1,1,0.26,0.2727,0.6,0.1045,5,170,175,170
8094,12/8/2011,4,0,12,21,0,4,1,1,0.28,0.303,0.61,0.0896,4,135,139,135
8095,12/8/2011,4,0,12,22,0,4,1,1,0.26,0.2727,0.65,0.1343,8,84,92,84
8096,12/8/2011,4,0,12,23,0,4,1,1,0.24,0.2576,0.7,0.1045,3,58,61,58
8097,12/9/2011,4,0,12,0,0,5,1,1,0.24,0.2879,0.65,0,8,26,34,26
8098,12/9/2011,4,0,12,1,0,5,1,1,0.24,0.2879,0.65,0,2,12,14,12
8099,12/9/2011,4,0,12,2,0,5,1,1,0.24,0.2879,0.7,0,2,10,12,10
8100,12/9/2011,4,0,12,3,0,5,1,1,0.22,0.2727,0.8,0,1,5,6,5
8101,12/9/2011,4,0,12,4,0,5,1,1,0.22,0.2727,0.8,0,1,1,2,1
8102,12/9/2011,4,0,12,5,0,5,1,1,0.22,0.2727,0.8,0,0,20,20,20
8103,12/9/2011,4,0,12,6,0,5,1,1,0.22,0.2576,0.8,0.0896,1,62,63,62
8104,12/9/2011,4,0,12,7,0,5,1,1,0.22,0.2576,0.75,0.0896,4,195,199,195
8105,12/9/2011,4,0,12,8,0,5,1,1,0.24,0.2879,0.81,0,7,378,385,378
8106,12/9/2011,4,0,12,9,0,5,1,1,0.26,0.2879,0.81,0.0896,8,256,264,256
8107,12/9/2011,4,0,12,10,0,5,1,2,0.3,0.303,0.7,0.1642,11,115,126,115
8108,12/9/2011,4,0,12,11,0,5,1,1,0.32,0.303,0.7,0.2537,15,121,136,121
8109,12/9/2011,4,0,12,12,0,5,1,1,0.36,0.3333,0.57,0.2985,27,146,173,146
8110,12/9/2011,4,0,12,13,0,5,1,1,0.38,0.3939,0.5,0.194,27,141,168,141
8111,12/9/2011,4,0,12,14,0,5,1,1,0.38,0.3939,0.46,0.2836,24,163,187,163
8112,12/9/2011,4,0,12,15,0,5,1,1,0.38,0.3939,0.46,0.2836,29,160,189,160
8113,12/9/2011,4,0,12,16,0,5,1,1,0.36,0.3485,0.62,0.1343,24,226,250,226
8114,12/9/2011,4,0,12,17,0,5,1,1,0.34,0.3485,0.66,0.1045,10,352,362,352
8115,12/9/2011,4,0,12,18,0,5,1,1,0.34,0.3636,0.61,0,10,308,318,308
8116,12/9/2011,4,0,12,19,0,5,1,1,0.34,0.3636,0.61,0,10,189,199,189
8117,12/9/2011,4,0,12,20,0,5,1,1,0.3,0.3333,0.81,0,10,140,150,140
8118,12/9/2011,4,0,12,21,0,5,1,1,0.3,0.3333,0.75,0,9,131,140,131
8119,12/9/2011,4,0,12,22,0,5,1,1,0.28,0.3182,0.87,0,15,114,129,114
8120,12/9/2011,4,0,12,23,0,5,1,1,0.28,0.3182,0.81,0,6,88,94,88
8121,12/10/2011,4,0,12,0,0,6,0,2,0.26,0.2727,0.81,0.1045,11,66,77,66
8122,12/10/2011,4,0,12,1,0,6,0,2,0.26,0.2576,0.7,0.1642,11,55,66,55
8123,12/10/2011,4,0,12,2,0,6,0,2,0.28,0.303,0.61,0.0896,12,48,60,48
8124,12/10/2011,4,0,12,3,0,6,0,2,0.28,0.303,0.61,0.0896,5,20,25,20
8125,12/10/2011,4,0,12,4,0,6,0,2,0.26,0.2727,0.65,0.1045,0,3,3,3
8126,12/10/2011,4,0,12,5,0,6,0,1,0.26,0.2576,0.6,0.1642,0,6,6,6
8127,12/10/2011,4,0,12,6,0,6,0,1,0.24,0.2576,0.65,0.1045,1,10,11,10
8128,12/10/2011,4,0,12,7,0,6,0,1,0.24,0.2273,0.65,0.194,0,11,11,11
8129,12/10/2011,4,0,12,8,0,6,0,1,0.26,0.2727,0.65,0.1343,5,68,73,68
8130,12/10/2011,4,0,12,9,0,6,0,1,0.28,0.2576,0.61,0.2836,15,134,149,134
8131,12/10/2011,4,0,12,10,0,6,0,1,0.32,0.303,0.57,0.2537,31,161,192,161
8132,12/10/2011,4,0,12,11,0,6,0,1,0.32,0.2879,0.53,0.4179,44,192,236,192
8133,12/10/2011,4,0,12,12,0,6,0,1,0.32,0.2879,0.45,0.4179,48,235,283,235
8134,12/10/2011,4,0,12,13,0,6,0,1,0.34,0.303,0.34,0.4179,47,239,286,239
8135,12/10/2011,4,0,12,14,0,6,0,1,0.34,0.303,0.31,0.3284,51,242,293,242
8136,12/10/2011,4,0,12,15,0,6,0,1,0.34,0.303,0.34,0.3582,60,239,299,239
8137,12/10/2011,4,0,12,16,0,6,0,1,0.32,0.2879,0.31,0.3881,58,183,241,183
8138,12/10/2011,4,0,12,17,0,6,0,1,0.28,0.2576,0.36,0.3284,34,151,185,151
8139,12/10/2011,4,0,12,18,0,6,0,1,0.26,0.2576,0.38,0.2239,28,144,172,144
8140,12/10/2011,4,0,12,19,0,6,0,1,0.26,0.2424,0.38,0.2836,15,139,154,139
8141,12/10/2011,4,0,12,20,0,6,0,1,0.24,0.2273,0.35,0.2239,10,114,124,114
8142,12/10/2011,4,0,12,21,0,6,0,1,0.22,0.2121,0.44,0.2239,4,79,83,79
8143,12/10/2011,4,0,12,22,0,6,0,1,0.22,0.2273,0.41,0.1343,7,88,95,88
8144,12/10/2011,4,0,12,23,0,6,0,1,0.2,0.2121,0.47,0.1642,5,61,66,61
8145,12/11/2011,4,0,12,0,0,0,0,1,0.2,0.197,0.51,0.2239,5,69,74,69
8146,12/11/2011,4,0,12,1,0,0,0,1,0.16,0.1515,0.59,0.2239,8,54,62,54
8147,12/11/2011,4,0,12,2,0,0,0,1,0.18,0.1667,0.55,0.2537,5,47,52,47
8148,12/11/2011,4,0,12,3,0,0,0,1,0.16,0.1818,0.59,0.1343,2,17,19,17
8149,12/11/2011,4,0,12,4,0,0,0,1,0.16,0.1667,0.59,0.1642,0,5,5,5
8150,12/11/2011,4,0,12,5,0,0,0,1,0.18,0.2121,0.59,0.1045,0,6,6,6
8151,12/11/2011,4,0,12,6,0,0,0,1,0.16,0.2273,0.59,0,0,10,10,10
8152,12/11/2011,4,0,12,7,0,0,0,1,0.18,0.2424,0.55,0,1,30,31,30
8153,12/11/2011,4,0,12,8,0,0,0,1,0.16,0.2273,0.69,0,4,68,72,68
8154,12/11/2011,4,0,12,9,0,0,0,1,0.2,0.2576,0.59,0,19,88,107,88
8155,12/11/2011,4,0,12,10,0,0,0,1,0.24,0.2879,0.44,0,30,164,194,164
8156,12/11/2011,4,0,12,11,0,0,0,1,0.26,0.303,0.35,0,31,166,197,166
8157,12/11/2011,4,0,12,12,0,0,0,1,0.26,0.303,0.35,0,42,246,288,246
8158,12/11/2011,4,0,12,13,0,0,0,1,0.3,0.3333,0.31,0,44,224,268,224
8159,12/11/2011,4,0,12,14,0,0,0,1,0.3,0.3333,0.28,0,44,198,242,198
8160,12/11/2011,4,0,12,15,0,0,0,1,0.3,0.3333,0.26,0,47,219,266,219
8161,12/11/2011,4,0,12,16,0,0,0,1,0.3,0.3333,0.26,0,32,174,206,174
8162,12/11/2011,4,0,12,17,0,0,0,1,0.28,0.3182,0.3,0,13,150,163,150
8163,12/11/2011,4,0,12,18,0,0,0,1,0.24,0.2273,0.48,0.194,12,151,163,151
8164,12/11/2011,4,0,12,19,0,0,0,1,0.22,0.2273,0.55,0.194,7,98,105,98
8165,12/11/2011,4,0,12,20,0,0,0,1,0.22,0.2424,0.55,0.1045,10,62,72,62
8166,12/11/2011,4,0,12,21,0,0,0,1,0.22,0.2727,0.55,0,10,53,63,53
8167,12/11/2011,4,0,12,22,0,0,0,1,0.22,0.2727,0.55,0,7,36,43,36
8168,12/11/2011,4,0,12,23,0,0,0,1,0.2,0.2576,0.69,0,4,31,35,31
8169,12/12/2011,4,0,12,0,0,1,1,1,0.2,0.2273,0.69,0.0896,4,16,20,16
8170,12/12/2011,4,0,12,1,0,1,1,1,0.2,0.2576,0.69,0,0,9,9,9
8171,12/12/2011,4,0,12,2,0,1,1,1,0.2,0.2576,0.69,0,0,4,4,4
8172,12/12/2011,4,0,12,3,0,1,1,1,0.18,0.2424,0.74,0,0,2,2,2
8173,12/12/2011,4,0,12,4,0,1,1,1,0.18,0.2424,0.74,0,0,3,3,3
8174,12/12/2011,4,0,12,5,0,1,1,1,0.16,0.2273,0.8,0,0,21,21,21
8175,12/12/2011,4,0,12,6,0,1,1,1,0.16,0.1818,0.8,0.1045,1,63,64,63
8176,12/12/2011,4,0,12,7,0,1,1,1,0.14,0.1515,0.86,0.1343,4,231,235,231
8177,12/12/2011,4,0,12,8,0,1,1,2,0.16,0.1818,0.8,0.1045,7,378,385,378
8178,12/12/2011,4,0,12,9,0,1,1,2,0.18,0.2121,0.74,0.0896,12,208,220,208
8179,12/12/2011,4,0,12,10,0,1,1,2,0.22,0.2424,0.69,0.1045,14,91,105,91
8180,12/12/2011,4,0,12,11,0,1,1,2,0.26,0.2879,0.6,0.0896,15,100,115,100
8181,12/12/2011,4,0,12,12,0,1,1,1,0.28,0.2879,0.52,0.1045,7,138,145,138
8182,12/12/2011,4,0,12,13,0,1,1,2,0.3,0.3182,0.52,0.1045,13,153,166,153
8183,12/12/2011,4,0,12,14,0,1,1,2,0.32,0.3333,0.53,0.1343,16,95,111,95
8184,12/12/2011,4,0,12,15,0,1,1,2,0.32,0.3333,0.57,0.1045,8,124,132,124
8185,12/12/2011,4,0,12,16,0,1,1,2,0.32,0.3333,0.57,0.0896,5,209,214,209
8186,12/12/2011,4,0,12,17,0,1,1,2,0.3,0.3333,0.56,0,7,352,359,352
8187,12/12/2011,4,0,12,18,0,1,1,1,0.3,0.3182,0.56,0.0896,8,349,357,349
8188,12/12/2011,4,0,12,19,0,1,1,1,0.28,0.303,0.61,0.0896,9,232,241,232
8189,12/12/2011,4,0,12,20,0,1,1,1,0.3,0.3182,0.56,0.0896,8,157,165,157
8190,12/12/2011,4,0,12,21,0,1,1,1,0.26,0.303,0.81,0,2,119,121,119
8191,12/12/2011,4,0,12,22,0,1,1,1,0.26,0.303,0.7,0,0,71,71,71
8192,12/12/2011,4,0,12,23,0,1,1,1,0.24,0.2879,0.75,0,3,42,45,42
8193,12/13/2011,4,0,12,0,0,2,1,1,0.22,0.2727,0.8,0,1,16,17,16
8194,12/13/2011,4,0,12,1,0,2,1,1,0.2,0.2576,0.8,0,0,4,4,4
8195,12/13/2011,4,0,12,2,0,2,1,1,0.2,0.2576,0.8,0,1,1,2,1
8196,12/13/2011,4,0,12,3,0,2,1,1,0.18,0.2424,0.8,0,0,3,3,3
8197,12/13/2011,4,0,12,4,0,2,1,1,0.2,0.2576,0.8,0,0,4,4,4
8198,12/13/2011,4,0,12,5,0,2,1,1,0.18,0.2424,0.86,0,0,20,20,20
8199,12/13/2011,4,0,12,6,0,2,1,1,0.2,0.2576,0.8,0,0,92,92,92
8200,12/13/2011,4,0,12,7,0,2,1,1,0.16,0.1667,0.8,0.1642,2,221,223,221
8201,12/13/2011,4,0,12,8,0,2,1,1,0.2,0.2273,0.69,0.1045,9,391,400,391
8202,12/13/2011,4,0,12,9,0,2,1,1,0.26,0.2576,0.6,0.1642,10,223,233,223
8203,12/13/2011,4,0,12,10,0,2,1,1,0.3,0.303,0.52,0.1642,3,99,102,99
8204,12/13/2011,4,0,12,11,0,2,1,1,0.34,0.3182,0.46,0.2537,9,115,124,115
8205,12/13/2011,4,0,12,12,0,2,1,1,0.36,0.3333,0.43,0.3582,20,147,167,147
8206,12/13/2011,4,0,12,13,0,2,1,1,0.4,0.4091,0.37,0.3284,7,120,127,120
8207,12/13/2011,4,0,12,14,0,2,1,1,0.4,0.4091,0.37,0.2537,18,116,134,116
8208,12/13/2011,4,0,12,15,0,2,1,1,0.4,0.4091,0.35,0.2537,7,144,151,144
8209,12/13/2011,4,0,12,16,0,2,1,1,0.38,0.3939,0.37,0.2537,13,194,207,194
8210,12/13/2011,4,0,12,17,0,2,1,1,0.36,0.3485,0.4,0.194,17,381,398,381
8211,12/13/2011,4,0,12,18,0,2,1,1,0.34,0.3182,0.42,0.2239,12,370,382,370
8212,12/13/2011,4,0,12,19,0,2,1,1,0.32,0.3182,0.49,0.1642,5,262,267,262
8213,12/13/2011,4,0,12,20,0,2,1,1,0.32,0.3182,0.49,0.1642,7,154,161,154
8214,12/13/2011,4,0,12,21,0,2,1,1,0.3,0.303,0.52,0.1642,5,134,139,134
8215,12/13/2011,4,0,12,22,0,2,1,1,0.3,0.303,0.52,0.1642,5,102,107,102
8216,12/13/2011,4,0,12,23,0,2,1,1,0.26,0.303,0.7,0,4,55,59,55
8217,12/14/2011,4,0,12,0,0,3,1,1,0.26,0.303,0.75,0,0,22,22,22
8218,12/14/2011,4,0,12,1,0,3,1,1,0.26,0.303,0.75,0,0,8,8,8
8219,12/14/2011,4,0,12,2,0,3,1,1,0.26,0.303,0.75,0,0,2,2,2
8220,12/14/2011,4,0,12,3,0,3,1,1,0.28,0.3182,0.65,0,0,3,3,3
8221,12/14/2011,4,0,12,4,0,3,1,1,0.26,0.303,0.75,0,0,4,4,4
8222,12/14/2011,4,0,12,5,0,3,1,2,0.26,0.303,0.81,0,0,26,26,26
8223,12/14/2011,4,0,12,6,0,3,1,2,0.26,0.303,0.87,0,0,87,87,87
8224,12/14/2011,4,0,12,7,0,3,1,1,0.28,0.3182,0.75,0,4,243,247,243
8225,12/14/2011,4,0,12,8,0,3,1,2,0.26,0.303,0.87,0,9,458,467,458
8226,12/14/2011,4,0,12,9,0,3,1,2,0.3,0.3333,0.61,0,9,230,239,230
8227,12/14/2011,4,0,12,10,0,3,1,2,0.32,0.3485,0.57,0,9,133,142,133
8228,12/14/2011,4,0,12,11,0,3,1,2,0.34,0.3636,0.55,0,12,103,115,103
8229,12/14/2011,4,0,12,12,0,3,1,2,0.36,0.3636,0.57,0.0896,6,138,144,138
8230,12/14/2011,4,0,12,13,0,3,1,2,0.36,0.3636,0.57,0.1045,14,119,133,119
8231,12/14/2011,4,0,12,14,0,3,1,2,0.38,0.3939,0.54,0.0896,17,134,151,134
8232,12/14/2011,4,0,12,15,0,3,1,2,0.38,0.3939,0.54,0.1045,24,143,167,143
8233,12/14/2011,4,0,12,16,0,3,1,2,0.38,0.3939,0.54,0.1045,12,233,245,233
8234,12/14/2011,4,0,12,17,0,3,1,2,0.36,0.3636,0.57,0.1045,19,377,396,377
8235,12/14/2011,4,0,12,18,0,3,1,2,0.36,0.3485,0.62,0.1642,11,379,390,379
8236,12/14/2011,4,0,12,19,0,3,1,2,0.36,0.3636,0.62,0.1045,9,259,268,259
8237,12/14/2011,4,0,12,20,0,3,1,2,0.34,0.3485,0.66,0.1045,6,169,175,169
8238,12/14/2011,4,0,12,21,0,3,1,2,0.34,0.3333,0.66,0.1642,9,145,154,145
8239,12/14/2011,4,0,12,22,0,3,1,1,0.34,0.3333,0.66,0.1642,5,99,104,99
8240,12/14/2011,4,0,12,23,0,3,1,1,0.32,0.3182,0.7,0.1642,3,48,51,48
8241,12/15/2011,4,0,12,0,0,4,1,1,0.32,0.3182,0.7,0.1642,5,45,50,45
8242,12/15/2011,4,0,12,1,0,4,1,2,0.32,0.3182,0.7,0.1642,5,15,20,15
8243,12/15/2011,4,0,12,2,0,4,1,2,0.32,0.3333,0.7,0.1343,2,5,7,5
8244,12/15/2011,4,0,12,3,0,4,1,2,0.32,0.3333,0.7,0.1343,1,2,3,2
8245,12/15/2011,4,0,12,4,0,4,1,2,0.32,0.303,0.7,0.2239,0,6,6,6
8246,12/15/2011,4,0,12,5,0,4,1,2,0.32,0.303,0.7,0.2836,0,24,24,24
8247,12/15/2011,4,0,12,6,0,4,1,1,0.32,0.3182,0.66,0.194,2,90,92,90
8248,12/15/2011,4,0,12,7,0,4,1,1,0.32,0.3182,0.7,0.194,6,252,258,252
8249,12/15/2011,4,0,12,8,0,4,1,2,0.34,0.3182,0.66,0.2239,8,449,457,449
8250,12/15/2011,4,0,12,9,0,4,1,2,0.36,0.3333,0.62,0.2836,6,274,280,274
8251,12/15/2011,4,0,12,10,0,4,1,2,0.4,0.4091,0.58,0.2985,4,105,109,105
8252,12/15/2011,4,0,12,11,0,4,1,2,0.4,0.4091,0.62,0.4179,9,126,135,126
8253,12/15/2011,4,0,12,12,0,4,1,2,0.46,0.4545,0.59,0.4925,17,140,157,140
8254,12/15/2011,4,0,12,13,0,4,1,2,0.5,0.4848,0.55,0.3582,14,150,164,150
8255,12/15/2011,4,0,12,14,0,4,1,2,0.52,0.5,0.52,0.3284,8,124,132,124
8256,12/15/2011,4,0,12,15,0,4,1,3,0.52,0.5,0.55,0.2239,6,76,82,76
8257,12/15/2011,4,0,12,16,0,4,1,3,0.46,0.4545,0.72,0.1642,7,124,131,124
8258,12/15/2011,4,0,12,17,0,4,1,2,0.52,0.5,0.59,0.2836,14,310,324,310
8259,12/15/2011,4,0,12,18,0,4,1,2,0.52,0.5,0.59,0.2985,14,363,377,363
8260,12/15/2011,4,0,12,19,0,4,1,2,0.52,0.5,0.59,0.2836,13,274,287,274
8261,12/15/2011,4,0,12,20,0,4,1,1,0.52,0.5,0.59,0.3284,12,209,221,209
8262,12/15/2011,4,0,12,21,0,4,1,1,0.5,0.4848,0.63,0.2985,10,145,155,145
8263,12/15/2011,4,0,12,22,0,4,1,1,0.52,0.5,0.63,0.3284,8,116,124,116
8264,12/15/2011,4,0,12,23,0,4,1,1,0.52,0.5,0.63,0.3284,10,104,114,104
8265,12/16/2011,4,0,12,0,0,5,1,1,0.5,0.4848,0.72,0.3284,12,60,72,60
8266,12/16/2011,4,0,12,1,0,5,1,1,0.5,0.4848,0.72,0.2239,3,28,31,28
8267,12/16/2011,4,0,12,2,0,5,1,1,0.48,0.4697,0.77,0.1045,0,23,23,23
8268,12/16/2011,4,0,12,3,0,5,1,1,0.46,0.4545,0.82,0.1343,2,3,5,3
8269,12/16/2011,4,0,12,4,0,5,1,2,0.5,0.4848,0.59,0.194,1,4,5,4
8270,12/16/2011,4,0,12,5,0,5,1,1,0.48,0.4697,0.44,0.3881,0,26,26,26
8271,12/16/2011,4,0,12,6,0,5,1,2,0.44,0.4394,0.33,0.2985,2,80,82,80
8272,12/16/2011,4,0,12,7,0,5,1,2,0.38,0.3939,0.46,0.2985,5,226,231,226
8273,12/16/2011,4,0,12,8,0,5,1,1,0.36,0.3333,0.46,0.4179,10,449,459,449
8274,12/16/2011,4,0,12,9,0,5,1,1,0.36,0.3333,0.46,0.3881,8,235,243,235
8275,12/16/2011,4,0,12,10,0,5,1,1,0.34,0.303,0.46,0.2985,10,122,132,122
8276,12/16/2011,4,0,12,11,0,5,1,2,0.34,0.303,0.42,0.2985,9,135,144,135
8277,12/16/2011,4,0,12,12,0,5,1,2,0.34,0.303,0.42,0.3582,10,163,173,163
8278,12/16/2011,4,0,12,13,0,5,1,2,0.34,0.303,0.39,0.3582,12,125,137,125
8279,12/16/2011,4,0,12,14,0,5,1,2,0.34,0.3182,0.42,0.2239,13,115,128,115
8280,12/16/2011,4,0,12,15,0,5,1,2,0.32,0.303,0.45,0.2985,12,141,153,141
8281,12/16/2011,4,0,12,16,0,5,1,2,0.32,0.303,0.45,0.2239,12,212,224,212
8282,12/16/2011,4,0,12,17,0,5,1,2,0.32,0.303,0.45,0.2836,13,352,365,352
8283,12/16/2011,4,0,12,18,0,5,1,2,0.32,0.303,0.45,0.2537,10,285,295,285
8284,12/16/2011,4,0,12,19,0,5,1,2,0.32,0.303,0.45,0.2239,11,203,214,203
8285,12/16/2011,4,0,12,20,0,5,1,2,0.32,0.3182,0.45,0.194,6,146,152,146
8286,12/16/2011,4,0,12,21,0,5,1,2,0.32,0.3182,0.45,0.1642,7,95,102,95
8287,12/16/2011,4,0,12,22,0,5,1,2,0.3,0.303,0.49,0.1642,6,100,106,100
8288,12/16/2011,4,0,12,23,0,5,1,2,0.3,0.303,0.49,0.1343,4,71,75,71
8289,12/17/2011,4,0,12,0,0,6,0,1,0.3,0.2879,0.49,0.2836,3,59,62,59
8290,12/17/2011,4,0,12,1,0,6,0,2,0.3,0.2879,0.52,0.2537,4,39,43,39
8291,12/17/2011,4,0,12,2,0,6,0,2,0.28,0.2727,0.56,0.2239,11,47,58,47
8292,12/17/2011,4,0,12,3,0,6,0,1,0.26,0.2576,0.6,0.194,4,22,26,22
8293,12/17/2011,4,0,12,4,0,6,0,1,0.24,0.2424,0.65,0.1642,0,9,9,9
8294,12/17/2011,4,0,12,5,0,6,0,2,0.26,0.2576,0.6,0.194,2,7,9,7
8295,12/17/2011,4,0,12,6,0,6,0,2,0.26,0.2424,0.56,0.2836,0,17,17,17
8296,12/17/2011,4,0,12,7,0,6,0,2,0.26,0.2576,0.56,0.2239,0,20,20,20
8297,12/17/2011,4,0,12,8,0,6,0,2,0.26,0.2576,0.56,0.2239,4,55,59,55
8298,12/17/2011,4,0,12,9,0,6,0,2,0.26,0.2424,0.56,0.2537,5,95,100,95
8299,12/17/2011,4,0,12,10,0,6,0,2,0.26,0.2424,0.52,0.2836,10,171,181,171
8300,12/17/2011,4,0,12,11,0,6,0,2,0.28,0.2576,0.45,0.3284,21,188,209,188
8301,12/17/2011,4,0,12,12,0,6,0,2,0.28,0.2576,0.45,0.2836,28,216,244,216
8302,12/17/2011,4,0,12,13,0,6,0,2,0.28,0.2727,0.48,0.2537,32,204,236,204
8303,12/17/2011,4,0,12,14,0,6,0,1,0.28,0.2576,0.45,0.3582,30,207,237,207
8304,12/17/2011,4,0,12,15,0,6,0,1,0.28,0.2576,0.45,0.2836,33,195,228,195
8305,12/17/2011,4,0,12,16,0,6,0,1,0.28,0.2727,0.45,0.2239,30,192,222,192
8306,12/17/2011,4,0,12,17,0,6,0,1,0.26,0.2576,0.48,0.2239,12,153,165,153
8307,12/17/2011,4,0,12,18,0,6,0,1,0.26,0.2273,0.48,0.3881,7,150,157,150
8308,12/17/2011,4,0,12,19,0,6,0,3,0.24,0.2121,0.65,0.3284,11,95,106,95
8309,12/17/2011,4,0,12,20,0,6,0,1,0.22,0.2121,0.69,0.2537,7,99,106,99
8310,12/17/2011,4,0,12,21,0,6,0,1,0.2,0.2121,0.75,0.1642,8,88,96,88
8311,12/17/2011,4,0,12,22,0,6,0,1,0.2,0.2121,0.75,0.1642,7,73,80,73
8312,12/17/2011,4,0,12,23,0,6,0,1,0.2,0.2273,0.75,0,6,63,69,63
8313,12/18/2011,4,0,12,0,0,0,0,1,0.2,0.2121,0.75,0.1343,7,64,71,64
8314,12/18/2011,4,0,12,1,0,0,0,1,0.2,0.2273,0.69,0.1045,3,43,46,43
8315,12/18/2011,4,0,12,2,0,0,0,1,0.22,0.2424,0.55,0.1045,2,39,41,39
8316,12/18/2011,4,0,12,3,0,0,0,1,0.22,0.2121,0.55,0.2239,2,16,18,16
8317,12/18/2011,4,0,12,4,0,0,0,1,0.22,0.2121,0.55,0.2239,0,1,1,1
8318,12/18/2011,4,0,12,5,0,0,0,1,0.2,0.2273,0.59,0.1045,1,4,5,4
8319,12/18/2011,4,0,12,6,0,0,0,1,0.2,0.2121,0.59,0.1343,0,3,3,3
8320,12/18/2011,4,0,12,7,0,0,0,1,0.2,0.2121,0.59,0.1642,1,11,12,11
8321,12/18/2011,4,0,12,8,0,0,0,1,0.2,0.2576,0.69,0,1,31,32,31
8322,12/18/2011,4,0,12,9,0,0,0,1,0.22,0.2273,0.64,0.1642,6,75,81,75
8323,12/18/2011,4,0,12,10,0,0,0,1,0.24,0.2273,0.6,0.2537,7,122,129,122
8324,12/18/2011,4,0,12,11,0,0,0,2,0.24,0.2273,0.6,0.2239,20,168,188,168
8325,12/18/2011,4,0,12,12,0,0,0,1,0.26,0.2576,0.6,0.2239,26,202,228,202
8326,12/18/2011,4,0,12,13,0,0,0,1,0.3,0.2727,0.49,0.2985,18,210,228,210
8327,12/18/2011,4,0,12,14,0,0,0,1,0.3,0.2879,0.49,0.2836,19,200,219,200
8328,12/18/2011,4,0,12,15,0,0,0,1,0.32,0.303,0.45,0.2836,23,184,207,184
8329,12/18/2011,4,0,12,16,0,0,0,1,0.28,0.2727,0.48,0.2537,27,207,234,207
8330,12/18/2011,4,0,12,17,0,0,0,1,0.28,0.2727,0.46,0.1642,10,126,136,126
8331,12/18/2011,4,0,12,18,0,0,0,1,0.28,0.2727,0.45,0.194,15,123,138,123
8332,12/18/2011,4,0,12,19,0,0,0,1,0.26,0.2727,0.52,0.1343,5,130,135,130
8333,12/18/2011,4,0,12,20,0,0,0,1,0.24,0.2576,0.6,0.1045,10,94,104,94
8334,12/18/2011,4,0,12,21,0,0,0,1,0.22,0.2727,0.64,0,9,80,89,80
8335,12/18/2011,4,0,12,22,0,0,0,1,0.22,0.2273,0.75,0.194,2,47,49,47
8336,12/18/2011,4,0,12,23,0,0,0,1,0.2,0.2273,0.75,0.1045,6,31,37,31
8337,12/19/2011,4,0,12,0,0,1,1,1,0.2,0.2273,0.75,0.0896,3,14,17,14
8338,12/19/2011,4,0,12,1,0,1,1,1,0.18,0.2121,0.8,0.0896,3,8,11,8
8339,12/19/2011,4,0,12,2,0,1,1,1,0.18,0.2121,0.8,0.0896,0,3,3,3
8340,12/19/2011,4,0,12,3,0,1,1,1,0.16,0.197,0.86,0.0896,0,3,3,3
8341,12/19/2011,4,0,12,4,0,1,1,1,0.16,0.1818,0.86,0.1343,0,4,4,4
8342,12/19/2011,4,0,12,5,0,1,1,1,0.14,0.1667,0.93,0.1045,0,21,21,21
8343,12/19/2011,4,0,12,6,0,1,1,1,0.16,0.1818,0.86,0.1045,0,68,68,68
8344,12/19/2011,4,0,12,7,0,1,1,1,0.18,0.2121,0.74,0.1045,4,187,191,187
8345,12/19/2011,4,0,12,8,0,1,1,1,0.2,0.197,0.75,0.194,8,389,397,389
8346,12/19/2011,4,0,12,9,0,1,1,1,0.22,0.2121,0.69,0.2239,17,166,183,166
8347,12/19/2011,4,0,12,10,0,1,1,1,0.24,0.2273,0.67,0.194,12,96,108,96
8348,12/19/2011,4,0,12,11,0,1,1,1,0.26,0.2424,0.65,0.2537,22,105,127,105
8349,12/19/2011,4,0,12,12,0,1,1,1,0.3,0.2727,0.61,0.3284,13,128,141,128
8350,12/19/2011,4,0,12,13,0,1,1,1,0.34,0.303,0.49,0.3284,15,127,142,127
8351,12/19/2011,4,0,12,14,0,1,1,1,0.36,0.3485,0.46,0.2239,30,107,137,107
8352,12/19/2011,4,0,12,15,0,1,1,1,0.38,0.3939,0.46,0.1642,24,135,159,135
8353,12/19/2011,4,0,12,16,0,1,1,1,0.4,0.4091,0.4,0.2537,19,189,208,189
8354,12/19/2011,4,0,12,17,0,1,1,1,0.38,0.3939,0.46,0.194,16,362,378,362
8355,12/19/2011,4,0,12,18,0,1,1,1,0.36,0.3485,0.5,0.194,11,343,354,343
8356,12/19/2011,4,0,12,19,0,1,1,2,0.36,0.3485,0.53,0.1642,17,234,251,234
8357,12/19/2011,4,0,12,20,0,1,1,1,0.4,0.4091,0.4,0.1642,9,197,206,197
8358,12/19/2011,4,0,12,21,0,1,1,2,0.36,0.3485,0.53,0.1343,15,112,127,112
8359,12/19/2011,4,0,12,22,0,1,1,2,0.36,0.3485,0.57,0.1642,12,95,107,95
8360,12/19/2011,4,0,12,23,0,1,1,1,0.36,0.3485,0.53,0.1642,10,50,60,50
8361,12/20/2011,4,0,12,0,0,2,1,1,0.36,0.3636,0.57,0.1045,0,21,21,21
8362,12/20/2011,4,0,12,1,0,2,1,1,0.36,0.3788,0.53,0,0,6,6,6
8363,12/20/2011,4,0,12,2,0,2,1,2,0.34,0.3636,0.61,0,1,10,11,10
8364,12/20/2011,4,0,12,3,0,2,1,2,0.34,0.3636,0.61,0,1,1,2,1
8365,12/20/2011,4,0,12,4,0,2,1,2,0.36,0.3636,0.53,0.1045,0,4,4,4
8366,12/20/2011,4,0,12,5,0,2,1,2,0.36,0.3788,0.57,0,0,15,15,15
8367,12/20/2011,4,0,12,6,0,2,1,2,0.36,0.3788,0.57,0,1,71,72,71
8368,12/20/2011,4,0,12,7,0,2,1,2,0.36,0.3788,0.62,0,7,261,268,261
8369,12/20/2011,4,0,12,8,0,2,1,2,0.42,0.4242,0.54,0.0896,10,422,432,422
8370,12/20/2011,4,0,12,9,0,2,1,2,0.36,0.3788,0.66,0,14,245,259,245
8371,12/20/2011,4,0,12,10,0,2,1,2,0.42,0.4242,0.58,0.194,20,109,129,109
8372,12/20/2011,4,0,12,11,0,2,1,2,0.4,0.4091,0.62,0.1642,13,116,129,116
8373,12/20/2011,4,0,12,12,0,2,1,2,0.44,0.4394,0.54,0.1343,16,159,175,159
8374,12/20/2011,4,0,12,13,0,2,1,2,0.44,0.4394,0.54,0.1343,18,163,181,163
8375,12/20/2011,4,0,12,14,0,2,1,2,0.44,0.4394,0.58,0.1045,11,127,138,127
8376,12/20/2011,4,0,12,15,0,2,1,2,0.44,0.4394,0.54,0,15,139,154,139
8377,12/20/2011,4,0,12,16,0,2,1,1,0.44,0.4394,0.54,0,20,218,238,218
8378,12/20/2011,4,0,12,17,0,2,1,1,0.4,0.4091,0.62,0.1642,14,417,431,417
8379,12/20/2011,4,0,12,18,0,2,1,1,0.38,0.3939,0.66,0.194,26,385,411,385
8380,12/20/2011,4,0,12,19,0,2,1,1,0.38,0.3939,0.66,0,6,218,224,218
8381,12/20/2011,4,0,12,20,0,2,1,1,0.36,0.3788,0.66,0,3,144,147,144
8382,12/20/2011,4,0,12,21,0,2,1,1,0.36,0.3636,0.66,0.0896,4,139,143,139
8383,12/20/2011,4,0,12,22,0,2,1,2,0.36,0.3788,0.66,0,3,104,107,104
8384,12/20/2011,4,0,12,23,0,2,1,2,0.38,0.3939,0.62,0,13,40,53,40
8385,12/21/2011,1,0,12,0,0,3,1,2,0.34,0.3333,0.71,0.1343,7,18,25,18
8386,12/21/2011,1,0,12,1,0,3,1,2,0.36,0.3636,0.66,0.1045,1,10,11,10
8387,12/21/2011,1,0,12,2,0,3,1,2,0.36,0.3788,0.71,0,0,4,4,4
8388,12/21/2011,1,0,12,3,0,3,1,2,0.36,0.3788,0.71,0,0,2,2,2
8389,12/21/2011,1,0,12,4,0,3,1,2,0.36,0.3788,0.71,0,0,2,2,2
8390,12/21/2011,1,0,12,5,0,3,1,2,0.38,0.3939,0.82,0.1045,0,28,28,28
8391,12/21/2011,1,0,12,6,0,3,1,2,0.36,0.3788,0.87,0,1,75,76,75
8392,12/21/2011,1,0,12,7,0,3,1,2,0.36,0.3636,0.87,0.1045,5,224,229,224
8393,12/21/2011,1,0,12,8,0,3,1,3,0.36,0.3788,0.93,0,12,393,405,393
8394,12/21/2011,1,0,12,9,0,3,1,2,0.4,0.4091,0.87,0.2239,14,220,234,220
8395,12/21/2011,1,0,12,10,0,3,1,2,0.48,0.4697,0.82,0.4179,6,83,89,83
8396,12/21/2011,1,0,12,11,0,3,1,2,0.48,0.4697,0.82,0.4179,3,53,56,53
8397,12/21/2011,1,0,12,12,0,3,1,3,0.46,0.4545,0.88,0.3881,3,58,61,58
8398,12/21/2011,1,0,12,13,0,3,1,3,0.44,0.4394,0.94,0.2985,3,55,58,55
8399,12/21/2011,1,0,12,14,0,3,1,2,0.48,0.4697,0.88,0.3582,11,40,51,40
8400,12/21/2011,1,0,12,15,0,3,1,2,0.48,0.4697,0.88,0.3881,4,57,61,57
8401,12/21/2011,1,0,12,16,0,3,1,3,0.44,0.4394,1,0.3284,6,95,101,95
8402,12/21/2011,1,0,12,17,0,3,1,3,0.44,0.4394,1,0.3284,3,226,229,226
8403,12/21/2011,1,0,12,18,0,3,1,2,0.44,0.4394,1,0.2985,2,278,280,278
8404,12/21/2011,1,0,12,19,0,3,1,2,0.5,0.4848,0.94,0.3284,9,200,209,200
8405,12/21/2011,1,0,12,20,0,3,1,2,0.5,0.4848,0.94,0.3582,5,162,167,162
8406,12/21/2011,1,0,12,21,0,3,1,1,0.5,0.4848,0.88,0.2836,9,114,123,114
8407,12/21/2011,1,0,12,22,0,3,1,1,0.5,0.4848,0.88,0.2537,3,102,105,102
8408,12/21/2011,1,0,12,23,0,3,1,1,0.5,0.4848,0.88,0.194,0,54,54,54
8409,12/22/2011,1,0,12,0,0,4,1,2,0.5,0.4848,0.82,0.1045,3,24,27,24
8410,12/22/2011,1,0,12,1,0,4,1,1,0.44,0.4394,0.94,0.0896,0,15,15,15
8411,12/22/2011,1,0,12,2,0,4,1,1,0.48,0.4697,0.82,0.1045,1,10,11,10
8412,12/22/2011,1,0,12,3,0,4,1,1,0.44,0.4394,0.67,0.1642,0,6,6,6
8413,12/22/2011,1,0,12,4,0,4,1,1,0.38,0.3939,0.82,0.1343,0,3,3,3
8414,12/22/2011,1,0,12,5,0,4,1,1,0.38,0.3939,0.82,0,1,15,16,15
8415,12/22/2011,1,0,12,6,0,4,1,1,0.36,0.3788,0.87,0,1,63,64,63
8416,12/22/2011,1,0,12,7,0,4,1,1,0.34,0.3636,0.93,0,4,182,186,182
8417,12/22/2011,1,0,12,8,0,4,1,2,0.36,0.3788,0.87,0,10,333,343,333
8418,12/22/2011,1,0,12,9,0,4,1,2,0.38,0.3939,0.87,0.0896,10,218,228,218
8419,12/22/2011,1,0,12,10,0,4,1,2,0.4,0.4091,0.82,0.0896,13,128,141,128
8420,12/22/2011,1,0,12,11,0,4,1,2,0.44,0.4394,0.77,0,10,135,145,135
8421,12/22/2011,1,0,12,12,0,4,1,2,0.48,0.4697,0.55,0,22,180,202,180
8422,12/22/2011,1,0,12,13,0,4,1,2,0.46,0.4545,0.63,0,21,167,188,167
8423,12/22/2011,1,0,12,14,0,4,1,2,0.46,0.4545,0.63,0,23,136,159,136
8424,12/22/2011,1,0,12,15,0,4,1,2,0.48,0.4697,0.59,0,28,186,214,186
8425,12/22/2011,1,0,12,16,0,4,1,2,0.46,0.4545,0.63,0,30,226,256,226
8426,12/22/2011,1,0,12,17,0,4,1,2,0.44,0.4394,0.67,0.1642,24,332,356,332
8427,12/22/2011,1,0,12,18,0,4,1,2,0.44,0.4394,0.62,0.0896,11,277,288,277
8428,12/22/2011,1,0,12,19,0,4,1,2,0.44,0.4394,0.62,0,12,130,142,130
8429,12/22/2011,1,0,12,20,0,4,1,3,0.42,0.4242,0.71,0,0,33,33,33
8430,12/22/2011,1,0,12,21,0,4,1,3,0.42,0.4242,0.71,0,2,15,17,15
8431,12/22/2011,1,0,12,22,0,4,1,3,0.36,0.3636,0.93,0.1045,0,17,17,17
8432,12/22/2011,1,0,12,23,0,4,1,3,0.4,0.4091,0.87,0,1,10,11,10
8433,12/23/2011,1,0,12,0,0,5,1,3,0.4,0.4091,0.87,0.194,2,7,9,7
8434,12/23/2011,1,0,12,1,0,5,1,3,0.4,0.4091,0.87,0.194,1,11,12,11
8435,12/23/2011,1,0,12,2,0,5,1,3,0.38,0.3939,0.94,0.1343,1,12,13,12
8436,12/23/2011,1,0,12,3,0,5,1,3,0.38,0.3939,0.94,0.1343,0,4,4,4
8437,12/23/2011,1,0,12,4,0,5,1,3,0.38,0.3939,0.94,0.2836,0,2,2,2
8438,12/23/2011,1,0,12,5,0,5,1,1,0.36,0.3485,0.93,0.194,0,8,8,8
8439,12/23/2011,1,0,12,6,0,5,1,1,0.38,0.3939,0.82,0.2537,0,40,40,40
8440,12/23/2011,1,0,12,7,0,5,1,1,0.38,0.3939,0.82,0.2239,4,88,92,88
8441,12/23/2011,1,0,12,8,0,5,1,1,0.4,0.4091,0.76,0.2537,9,173,182,173
8442,12/23/2011,1,0,12,9,0,5,1,1,0.4,0.4091,0.66,0.2985,4,152,156,152
8443,12/23/2011,1,0,12,10,0,5,1,1,0.4,0.4091,0.62,0.3582,8,96,104,96
8444,12/23/2011,1,0,12,11,0,5,1,1,0.4,0.4091,0.58,0.4478,26,148,174,148
8445,12/23/2011,1,0,12,12,0,5,1,1,0.4,0.4091,0.54,0.5224,14,156,170,156
8446,12/23/2011,1,0,12,13,0,5,1,1,0.4,0.4091,0.5,0.4627,17,177,194,177
8447,12/23/2011,1,0,12,14,0,5,1,1,0.4,0.4091,0.54,0.4179,23,177,200,177
8448,12/23/2011,1,0,12,15,0,5,1,1,0.38,0.3939,0.54,0.3582,12,191,203,191
8449,12/23/2011,1,0,12,16,0,5,1,1,0.38,0.3939,0.5,0.2985,15,166,181,166
8450,12/23/2011,1,0,12,17,0,5,1,1,0.36,0.3485,0.53,0.2239,11,129,140,129
8451,12/23/2011,1,0,12,18,0,5,1,1,0.36,0.3333,0.5,0.2537,4,91,95,91
8452,12/23/2011,1,0,12,19,0,5,1,1,0.34,0.3333,0.53,0.194,1,75,76,75
8453,12/23/2011,1,0,12,20,0,5,1,1,0.32,0.303,0.61,0.3284,3,47,50,47
8454,12/23/2011,1,0,12,21,0,5,1,1,0.32,0.303,0.61,0.2239,0,32,32,32
8455,12/23/2011,1,0,12,22,0,5,1,1,0.32,0.3182,0.66,0.194,4,43,47,43
8456,12/23/2011,1,0,12,23,0,5,1,1,0.32,0.3333,0.66,0.1343,4,21,25,21
8457,12/24/2011,1,0,12,0,0,6,0,2,0.32,0.3182,0.7,0.1642,3,20,23,20
8458,12/24/2011,1,0,12,1,0,6,0,2,0.32,0.3485,0.66,0,1,15,16,15
8459,12/24/2011,1,0,12,2,0,6,0,2,0.32,0.3333,0.66,0.0896,4,22,26,22
8460,12/24/2011,1,0,12,3,0,6,0,2,0.32,0.3333,0.7,0.0896,0,5,5,5
8461,12/24/2011,1,0,12,4,0,6,0,2,0.32,0.3182,0.66,0.1642,0,3,3,3
8462,12/24/2011,1,0,12,5,0,6,0,2,0.32,0.3182,0.66,0.1642,1,3,4,3
8463,12/24/2011,1,0,12,6,0,6,0,2,0.3,0.303,0.75,0.1642,0,10,10,10
8464,12/24/2011,1,0,12,7,0,6,0,1,0.3,0.2727,0.7,0.3582,0,10,10,10
8465,12/24/2011,1,0,12,8,0,6,0,1,0.28,0.2727,0.7,0.194,0,27,27,27
8466,12/24/2011,1,0,12,9,0,6,0,1,0.3,0.2727,0.45,0.4179,3,53,56,53
8467,12/24/2011,1,0,12,10,0,6,0,1,0.3,0.2576,0.42,0.4925,4,52,56,52
8468,12/24/2011,1,0,12,11,0,6,0,1,0.32,0.2879,0.39,0.3582,9,62,71,62
8469,12/24/2011,1,0,12,12,0,6,0,1,0.34,0.3182,0.39,0.2836,15,79,94,79
8470,12/24/2011,1,0,12,13,0,6,0,1,0.34,0.303,0.39,0.2985,24,97,121,97
8471,12/24/2011,1,0,12,14,0,6,0,1,0.34,0.303,0.39,0.2985,15,70,85,70
8472,12/24/2011,1,0,12,15,0,6,0,1,0.32,0.303,0.39,0.2239,15,82,97,82
8473,12/24/2011,1,0,12,16,0,6,0,1,0.32,0.3182,0.42,0.194,25,74,99,74
8474,12/24/2011,1,0,12,17,0,6,0,1,0.28,0.2879,0.45,0.1343,15,53,68,53
8475,12/24/2011,1,0,12,18,0,6,0,1,0.3,0.3182,0.42,0.0896,2,33,35,33
8476,12/24/2011,1,0,12,19,0,6,0,1,0.3,0.3182,0.52,0.0896,1,24,25,24
8477,12/24/2011,1,0,12,20,0,6,0,1,0.26,0.2727,0.56,0.1343,5,19,24,19
8478,12/24/2011,1,0,12,21,0,6,0,1,0.26,0.2576,0.56,0.1642,4,15,19,15
8479,12/24/2011,1,0,12,22,0,6,0,1,0.24,0.2879,0.52,0,8,12,20,12
8480,12/24/2011,1,0,12,23,0,6,0,1,0.24,0.2576,0.56,0,1,16,17,16
8481,12/25/2011,1,0,12,0,0,0,0,1,0.24,0.2273,0.6,0.194,2,4,6,4
8482,12/25/2011,1,0,12,1,0,0,0,1,0.22,0.2273,0.69,0.1343,2,2,4,2
8483,12/25/2011,1,0,12,2,0,0,0,1,0.22,0.2576,0.75,0.0896,0,2,2,2
8484,12/25/2011,1,0,12,3,0,0,0,1,0.22,0.2727,0.72,0,1,3,4,3
8485,12/25/2011,1,0,12,5,0,0,0,1,0.2,0.2273,0.75,0.1045,0,1,1,1
8486,12/25/2011,1,0,12,6,0,0,0,1,0.2,0.2273,0.75,0.1045,0,1,1,1
8487,12/25/2011,1,0,12,7,0,0,0,1,0.22,0.2424,0.8,0.1045,0,4,4,4
8488,12/25/2011,1,0,12,8,0,0,0,1,0.2,0.2121,0.8,0.1642,1,4,5,4
8489,12/25/2011,1,0,12,9,0,0,0,1,0.24,0.2424,0.87,0.1642,3,20,23,20
8490,12/25/2011,1,0,12,10,0,0,0,1,0.26,0.2424,0.81,0.2537,31,12,43,12
8491,12/25/2011,1,0,12,11,0,0,0,1,0.3,0.303,0.7,0.1642,43,42,85,42
8492,12/25/2011,1,0,12,12,0,0,0,1,0.3,0.2727,0.75,0.2985,25,41,66,41
8493,12/25/2011,1,0,12,13,0,0,0,1,0.32,0.303,0.7,0.2537,40,39,79,39
8494,12/25/2011,1,0,12,14,0,0,0,1,0.34,0.3182,0.61,0.2537,41,45,86,45
8495,12/25/2011,1,0,12,15,0,0,0,1,0.34,0.3333,0.61,0.194,43,48,91,48
8496,12/25/2011,1,0,12,16,0,0,0,1,0.36,0.3636,0.57,0.1045,35,51,86,51
8497,12/25/2011,1,0,12,17,0,0,0,1,0.34,0.3333,0.61,0.1343,11,33,44,33
8498,12/25/2011,1,0,12,18,0,0,0,1,0.32,0.3182,0.7,0.194,7,23,30,23
8499,12/25/2011,1,0,12,19,0,0,0,1,0.32,0.3333,0.57,0.1343,2,14,16,14
8500,12/25/2011,1,0,12,20,0,0,0,1,0.32,0.3333,0.49,0.0896,8,18,26,18
8501,12/25/2011,1,0,12,21,0,0,0,1,0.3,0.303,0.56,0.1343,4,15,19,15
8502,12/25/2011,1,0,12,22,0,0,0,1,0.28,0.2727,0.61,0.1642,2,15,17,15
8503,12/25/2011,1,0,12,23,0,0,0,1,0.26,0.2727,0.65,0.1343,2,14,16,14
8504,12/26/2011,1,0,12,0,1,1,0,1,0.22,0.2273,0.75,0.1642,5,6,11,6
8505,12/26/2011,1,0,12,1,1,1,0,1,0.28,0.2727,0.56,0.194,3,7,10,7
8506,12/26/2011,1,0,12,2,1,1,0,1,0.34,0.3182,0.46,0.2239,2,5,7,5
8507,12/26/2011,1,0,12,4,1,1,0,1,0.34,0.303,0.46,0.2985,0,2,2,2
8508,12/26/2011,1,0,12,5,1,1,0,1,0.34,0.303,0.42,0.3881,0,4,4,4
8509,12/26/2011,1,0,12,6,1,1,0,1,0.32,0.303,0.45,0.2836,0,4,4,4
8510,12/26/2011,1,0,12,7,1,1,0,1,0.32,0.3182,0.45,0.194,2,17,19,17
8511,12/26/2011,1,0,12,8,1,1,0,1,0.32,0.3333,0.45,0.1343,5,13,18,13
8512,12/26/2011,1,0,12,9,1,1,0,1,0.34,0.303,0.46,0.2985,24,38,62,38
8513,12/26/2011,1,0,12,10,1,1,0,1,0.34,0.2879,0.42,0.5224,31,39,70,39
8514,12/26/2011,1,0,12,11,1,1,0,1,0.34,0.2879,0.46,0.5821,40,51,91,51
8515,12/26/2011,1,0,12,12,1,1,0,1,0.36,0.3182,0.43,0.4627,34,66,100,66
8516,12/26/2011,1,0,12,13,1,1,0,1,0.38,0.3939,0.4,0.2985,57,83,140,83
8517,12/26/2011,1,0,12,14,1,1,0,1,0.38,0.3939,0.4,0.3284,73,80,153,80
8518,12/26/2011,1,0,12,15,1,1,0,1,0.38,0.3939,0.4,0.2537,26,105,131,105
8519,12/26/2011,1,0,12,16,1,1,0,1,0.36,0.3333,0.43,0.2836,28,69,97,69
8520,12/26/2011,1,0,12,17,1,1,0,1,0.34,0.3182,0.46,0.2239,30,67,97,67
8521,12/26/2011,1,0,12,18,1,1,0,1,0.32,0.3333,0.49,0.0896,21,54,75,54
8522,12/26/2011,1,0,12,19,1,1,0,1,0.3,0.3182,0.65,0.0896,16,49,65,49
8523,12/26/2011,1,0,12,20,1,1,0,1,0.3,0.3182,0.56,0.0896,14,42,56,42
8524,12/26/2011,1,0,12,21,1,1,0,1,0.26,0.303,0.7,0,10,39,49,39
8525,12/26/2011,1,0,12,22,1,1,0,1,0.26,0.303,0.7,0,5,22,27,22
8526,12/26/2011,1,0,12,23,1,1,0,1,0.26,0.2727,0.7,0.1045,4,25,29,25
8527,12/27/2011,1,0,12,0,0,2,1,1,0.26,0.2576,0.7,0.1642,3,9,12,9
8528,12/27/2011,1,0,12,1,0,2,1,1,0.26,0.2727,0.7,0.1343,0,6,6,6
8529,12/27/2011,1,0,12,2,0,2,1,1,0.26,0.2727,0.7,0.1343,2,2,4,2
8530,12/27/2011,1,0,12,3,0,2,1,2,0.3,0.2879,0.61,0.2239,0,3,3,3
8531,12/27/2011,1,0,12,4,0,2,1,2,0.3,0.2879,0.65,0.2239,0,3,3,3
8532,12/27/2011,1,0,12,5,0,2,1,2,0.3,0.2727,0.64,0.2836,0,8,8,8
8533,12/27/2011,1,0,12,6,0,2,1,2,0.3,0.2727,0.61,0.2985,0,35,35,35
8534,12/27/2011,1,0,12,7,0,2,1,2,0.3,0.2879,0.65,0.2836,1,79,80,79
8535,12/27/2011,1,0,12,8,0,2,1,2,0.3,0.303,0.65,0.1642,9,155,164,155
8536,12/27/2011,1,0,12,9,0,2,1,3,0.32,0.3333,0.66,0.1045,19,85,104,85
8537,12/27/2011,1,0,12,10,0,2,1,2,0.32,0.3333,0.66,0.0896,13,47,60,47
8538,12/27/2011,1,0,12,11,0,2,1,3,0.32,0.3333,0.66,0.1045,6,24,30,24
8539,12/27/2011,1,0,12,12,0,2,1,3,0.3,0.3182,0.81,0.0896,8,16,24,16
8540,12/27/2011,1,0,12,13,0,2,1,3,0.3,0.303,0.87,0.1343,1,19,20,19
8541,12/27/2011,1,0,12,14,0,2,1,3,0.42,0.4242,0.82,0.3881,0,14,14,14
8542,12/27/2011,1,0,12,15,0,2,1,3,0.42,0.4242,0.82,0.3881,2,17,19,17
8543,12/27/2011,1,0,12,16,0,2,1,3,0.44,0.4394,0.88,0.3284,2,44,46,44
8544,12/27/2011,1,0,12,17,0,2,1,3,0.4,0.4091,0.87,0.1343,6,109,115,109
8545,12/27/2011,1,0,12,18,0,2,1,1,0.38,0.3939,0.87,0.2836,9,126,135,126
8546,12/27/2011,1,0,12,19,0,2,1,1,0.34,0.3333,0.87,0.1642,3,87,90,87
8547,12/27/2011,1,0,12,20,0,2,1,1,0.32,0.3333,0.93,0.0896,3,66,69,66
8548,12/27/2011,1,0,12,21,0,2,1,1,0.32,0.3333,0.87,0.0896,11,52,63,52
8549,12/27/2011,1,0,12,22,0,2,1,1,0.32,0.3333,0.87,0.0896,3,29,32,29
8550,12/27/2011,1,0,12,23,0,2,1,1,0.3,0.303,0.93,0.1343,2,24,26,24
8551,12/28/2011,1,0,12,0,0,3,1,1,0.32,0.3182,0.87,0.1642,0,10,10,10
8552,12/28/2011,1,0,12,1,0,3,1,1,0.32,0.3182,0.76,0.1642,0,12,12,12
8553,12/28/2011,1,0,12,2,0,3,1,1,0.32,0.303,0.61,0.2537,0,7,7,7
8554,12/28/2011,1,0,12,3,0,3,1,1,0.32,0.303,0.61,0.2537,0,4,4,4
8555,12/28/2011,1,0,12,5,0,3,1,1,0.32,0.2879,0.57,0.3582,0,9,9,9
8556,12/28/2011,1,0,12,6,0,3,1,1,0.32,0.303,0.57,0.2537,1,42,43,42
8557,12/28/2011,1,0,12,7,0,3,1,1,0.32,0.303,0.57,0.2537,4,106,110,106
8558,12/28/2011,1,0,12,8,0,3,1,1,0.32,0.2879,0.57,0.3582,11,206,217,206
8559,12/28/2011,1,0,12,9,0,3,1,1,0.32,0.303,0.57,0.3284,18,171,189,171
8560,12/28/2011,1,0,12,10,0,3,1,1,0.34,0.3182,0.57,0.2239,12,84,96,84
8561,12/28/2011,1,0,12,11,0,3,1,1,0.36,0.3333,0.46,0.3582,18,93,111,93
8562,12/28/2011,1,0,12,12,0,3,1,1,0.34,0.2879,0.46,0.5522,32,108,140,108
8563,12/28/2011,1,0,12,13,0,3,1,1,0.34,0.2879,0.39,0.4627,24,135,159,135
8564,12/28/2011,1,0,12,14,0,3,1,1,0.32,0.2879,0.39,0.3881,24,96,120,96
8565,12/28/2011,1,0,12,15,0,3,1,1,0.32,0.2879,0.36,0.4179,16,101,117,101
8566,12/28/2011,1,0,12,16,0,3,1,1,0.3,0.2727,0.36,0.4179,23,144,167,144
8567,12/28/2011,1,0,12,17,0,3,1,1,0.28,0.2727,0.38,0.2537,25,225,250,225
8568,12/28/2011,1,0,12,18,0,3,1,1,0.26,0.2273,0.38,0.3284,10,159,169,159
8569,12/28/2011,1,0,12,19,0,3,1,1,0.24,0.2273,0.41,0.2537,16,135,151,135
8570,12/28/2011,1,0,12,20,0,3,1,1,0.24,0.2273,0.41,0.2239,9,70,79,70
8571,12/28/2011,1,0,12,21,0,3,1,1,0.22,0.2273,0.44,0.1343,7,63,70,63
8572,12/28/2011,1,0,12,22,0,3,1,1,0.22,0.2424,0.44,0.1045,2,31,33,31
8573,12/28/2011,1,0,12,23,0,3,1,1,0.22,0.2121,0.44,0.2537,3,36,39,36
8574,12/29/2011,1,0,12,0,0,4,1,2,0.22,0.2273,0.47,0.194,4,24,28,24
8575,12/29/2011,1,0,12,1,0,4,1,1,0.22,0.2121,0.47,0.2239,0,15,15,15
8576,12/29/2011,1,0,12,2,0,4,1,1,0.2,0.2273,0.51,0.1045,0,3,3,3
8577,12/29/2011,1,0,12,3,0,4,1,1,0.2,0.197,0.55,0.194,0,2,2,2
8578,12/29/2011,1,0,12,4,0,4,1,1,0.2,0.2121,0.55,0.1642,1,2,3,2
8579,12/29/2011,1,0,12,5,0,4,1,1,0.2,0.2273,0.55,0.1045,0,10,10,10
8580,12/29/2011,1,0,12,6,0,4,1,1,0.2,0.2576,0.59,0,2,39,41,39
8581,12/29/2011,1,0,12,7,0,4,1,1,0.18,0.2121,0.64,0.0896,2,104,106,104
8582,12/29/2011,1,0,12,8,0,4,1,2,0.2,0.2576,0.64,0,3,207,210,207
8583,12/29/2011,1,0,12,9,0,4,1,2,0.2,0.2121,0.64,0.1343,15,155,170,155
8584,12/29/2011,1,0,12,10,0,4,1,2,0.22,0.2273,0.64,0.1642,13,97,110,97
8585,12/29/2011,1,0,12,11,0,4,1,2,0.24,0.2576,0.6,0.0896,23,99,122,99
8586,12/29/2011,1,0,12,12,0,4,1,2,0.26,0.2727,0.56,0.1045,12,118,130,118
8587,12/29/2011,1,0,12,13,0,4,1,2,0.28,0.2879,0.52,0.1045,36,95,131,95
8588,12/29/2011,1,0,12,14,0,4,1,2,0.3,0.3333,0.52,0,30,112,142,112
8589,12/29/2011,1,0,12,15,0,4,1,2,0.3,0.3182,0.52,0.0896,27,150,177,150
8590,12/29/2011,1,0,12,16,0,4,1,1,0.3,0.303,0.52,0.1642,22,155,177,155
8591,12/29/2011,1,0,12,17,0,4,1,1,0.3,0.303,0.61,0.1642,14,226,240,226
8592,12/29/2011,1,0,12,18,0,4,1,1,0.3,0.303,0.56,0.1343,15,192,207,192
8593,12/29/2011,1,0,12,19,0,4,1,1,0.3,0.3182,0.56,0.1045,11,124,135,124
8594,12/29/2011,1,0,12,20,0,4,1,1,0.28,0.2879,0.65,0.1045,8,88,96,88
8595,12/29/2011,1,0,12,21,0,4,1,2,0.28,0.2879,0.61,0.1343,8,60,68,60
8596,12/29/2011,1,0,12,22,0,4,1,1,0.28,0.2879,0.65,0.1343,7,48,55,48
8597,12/29/2011,1,0,12,23,0,4,1,1,0.3,0.303,0.65,0.1642,1,44,45,44
8598,12/30/2011,1,0,12,0,0,5,1,1,0.28,0.2879,0.7,0.1343,4,26,30,26
8599,12/30/2011,1,0,12,1,0,5,1,1,0.26,0.2879,0.65,0.0896,9,11,20,11
8600,12/30/2011,1,0,12,2,0,5,1,1,0.24,0.2576,0.7,0.1045,2,10,12,10
8601,12/30/2011,1,0,12,3,0,5,1,1,0.24,0.2576,0.7,0.1045,0,6,6,6
8602,12/30/2011,1,0,12,4,0,5,1,1,0.24,0.2576,0.7,0.0896,0,2,2,2
8603,12/30/2011,1,0,12,5,0,5,1,1,0.22,0.2576,0.75,0.0896,0,10,10,10
8604,12/30/2011,1,0,12,6,0,5,1,1,0.24,0.2576,0.7,0.0896,1,31,32,31
8605,12/30/2011,1,0,12,7,0,5,1,1,0.24,0.2576,0.75,0.0896,3,92,95,92
8606,12/30/2011,1,0,12,8,0,5,1,2,0.24,0.2576,0.75,0.0896,12,193,205,193
8607,12/30/2011,1,0,12,9,0,5,1,1,0.26,0.303,0.75,0,19,175,194,175
8608,12/30/2011,1,0,12,10,0,5,1,1,0.3,0.2879,0.65,0.2537,10,108,118,108
8609,12/30/2011,1,0,12,11,0,5,1,1,0.32,0.3182,0.66,0.194,45,126,171,126
8610,12/30/2011,1,0,12,12,0,5,1,1,0.32,0.3333,0.57,0.1343,38,159,197,159
8611,12/30/2011,1,0,12,13,0,5,1,2,0.36,0.3485,0.53,0.1343,53,154,207,154
8612,12/30/2011,1,0,12,14,0,5,1,2,0.4,0.4091,0.47,0.0896,67,178,245,178
8613,12/30/2011,1,0,12,15,0,5,1,1,0.42,0.4242,0.44,0,56,236,292,236
8614,12/30/2011,1,0,12,16,0,5,1,1,0.42,0.4242,0.47,0.194,36,247,283,247
8615,12/30/2011,1,0,12,17,0,5,1,1,0.38,0.3939,0.54,0.1642,54,188,242,188
8616,12/30/2011,1,0,12,18,0,5,1,1,0.36,0.3485,0.62,0.1343,19,163,182,163
8617,12/30/2011,1,0,12,19,0,5,1,2,0.34,0.303,0.49,0.4179,16,96,112,96
8618,12/30/2011,1,0,12,20,0,5,1,2,0.34,0.3485,0.66,0.1045,16,75,91,75
8619,12/30/2011,1,0,12,21,0,5,1,2,0.36,0.3636,0.66,0.1045,11,84,95,84
8620,12/30/2011,1,0,12,22,0,5,1,2,0.34,0.3333,0.71,0.1642,7,78,85,78
8621,12/30/2011,1,0,12,23,0,5,1,2,0.36,0.3333,0.66,0.2537,13,60,73,60
8622,12/31/2011,1,0,12,0,0,6,0,2,0.38,0.3939,0.62,0.3284,7,37,44,37
8623,12/31/2011,1,0,12,1,0,6,0,2,0.4,0.4091,0.62,0.2836,4,31,35,31
8624,12/31/2011,1,0,12,2,0,6,0,2,0.4,0.4091,0.62,0.2836,1,27,28,27
8625,12/31/2011,1,0,12,3,0,6,0,2,0.4,0.4091,0.62,0.2836,1,17,18,17
8626,12/31/2011,1,0,12,4,0,6,0,1,0.38,0.3939,0.71,0.2239,1,9,10,9
8627,12/31/2011,1,0,12,5,0,6,0,2,0.36,0.3485,0.76,0.2239,1,0,1,0
8628,12/31/2011,1,0,12,6,0,6,0,2,0.4,0.4091,0.71,0.0896,1,5,6,5
8629,12/31/2011,1,0,12,7,0,6,0,3,0.38,0.3939,0.76,0,6,13,19,13
8630,12/31/2011,1,0,12,8,0,6,0,1,0.34,0.3333,0.81,0.1343,7,42,49,42
8631,12/31/2011,1,0,12,9,0,6,0,1,0.38,0.3939,0.76,0,18,72,90,72
8632,12/31/2011,1,0,12,10,0,6,0,1,0.4,0.4091,0.76,0.1642,20,108,128,108
8633,12/31/2011,1,0,12,11,0,6,0,1,0.42,0.4242,0.71,0.1642,65,152,217,152
8634,12/31/2011,1,0,12,12,0,6,0,1,0.52,0.5,0.39,0.2985,93,180,273,180
8635,12/31/2011,1,0,12,13,0,6,0,1,0.5,0.4848,0.42,0.4925,108,205,313,205
8636,12/31/2011,1,0,12,14,0,6,0,1,0.46,0.4545,0.51,0.3284,115,185,300,185
8637,12/31/2011,1,0,12,15,0,6,0,1,0.46,0.4545,0.47,0.4925,89,164,253,164
8638,12/31/2011,1,0,12,16,0,6,0,1,0.44,0.4394,0.51,0.3881,52,143,195,143
8639,12/31/2011,1,0,12,17,0,6,0,1,0.42,0.4242,0.54,0.194,28,101,129,101
8640,12/31/2011,1,0,12,18,0,6,0,1,0.42,0.4242,0.54,0.1343,13,80,93,80
8641,12/31/2011,1,0,12,19,0,6,0,1,0.42,0.4242,0.54,0.2239,19,73,92,73
8642,12/31/2011,1,0,12,20,0,6,0,1,0.42,0.4242,0.54,0.2239,8,63,71,63
8643,12/31/2011,1,0,12,21,0,6,0,1,0.4,0.4091,0.58,0.194,2,50,52,50
8644,12/31/2011,1,0,12,22,0,6,0,1,0.38,0.3939,0.62,0.1343,2,36,38,36
8645,12/31/2011,1,0,12,23,0,6,0,1,0.36,0.3788,0.66,0,4,27,31,27
8646,1/1/2012,1,1,1,0,0,0,0,1,0.36,0.3788,0.66,0,5,43,48,43
8647,1/1/2012,1,1,1,1,0,0,0,1,0.36,0.3485,0.66,0.1343,15,78,93,78
8648,1/1/2012,1,1,1,2,0,0,0,1,0.32,0.3485,0.76,0,16,59,75,59
8649,1/1/2012,1,1,1,3,0,0,0,1,0.3,0.3333,0.81,0,11,41,52,41
8650,1/1/2012,1,1,1,4,0,0,0,1,0.28,0.303,0.81,0.0896,0,8,8,8
8651,1/1/2012,1,1,1,5,0,0,0,1,0.28,0.2879,0.81,0.1045,0,5,5,5
8652,1/1/2012,1,1,1,6,0,0,0,1,0.26,0.2727,0.93,0.1343,1,1,2,1
8653,1/1/2012,1,1,1,7,0,0,0,1,0.26,0.2576,0.93,0.1642,1,6,7,6
8654,1/1/2012,1,1,1,8,0,0,0,1,0.26,0.2727,0.87,0.1045,4,10,14,10
8655,1/1/2012,1,1,1,9,0,0,0,1,0.26,0.2727,0.93,0.1045,13,27,40,27
8656,1/1/2012,1,1,1,10,0,0,0,1,0.3,0.3182,0.81,0.1045,18,52,70,52
8657,1/1/2012,1,1,1,11,0,0,0,1,0.34,0.3333,0.76,0.1343,40,98,138,98
8658,1/1/2012,1,1,1,12,0,0,0,1,0.4,0.4091,0.62,0.2836,58,143,201,143
8659,1/1/2012,1,1,1,13,0,0,0,1,0.42,0.4242,0.58,0.2836,82,141,223,141
8660,1/1/2012,1,1,1,14,0,0,0,1,0.44,0.4394,0.54,0.2985,120,147,267,147
8661,1/1/2012,1,1,1,15,0,0,0,1,0.46,0.4545,0.51,0.2985,101,164,265,164
8662,1/1/2012,1,1,1,16,0,0,0,2,0.44,0.4394,0.54,0.2985,68,147,215,147
8663,1/1/2012,1,1,1,17,0,0,0,2,0.48,0.4697,0.48,0.1642,36,75,111,75
8664,1/1/2012,1,1,1,18,0,0,0,3,0.46,0.4545,0.59,0.2537,25,81,106,81
8665,1/1/2012,1,1,1,19,0,0,0,3,0.42,0.4242,0.67,0.3881,20,85,105,85
8666,1/1/2012,1,1,1,20,0,0,0,2,0.44,0.4394,0.62,0.2985,25,58,83,58
8667,1/1/2012,1,1,1,21,0,0,0,2,0.44,0.4394,0.67,0.2537,10,61,71,61
8668,1/1/2012,1,1,1,22,0,0,0,1,0.46,0.4545,0.55,0.4179,13,53,66,53
8669,1/1/2012,1,1,1,23,0,0,0,1,0.44,0.4394,0.51,0.2985,4,25,29,25
8670,1/2/2012,1,1,1,0,1,1,0,1,0.4,0.4091,0.4,0.4627,8,31,39,31
8671,1/2/2012,1,1,1,1,1,1,0,1,0.36,0.3333,0.43,0.4179,1,11,12,11
8672,1/2/2012,1,1,1,2,1,1,0,1,0.36,0.3182,0.34,0.4478,1,6,7,6
8673,1/2/2012,1,1,1,4,1,1,0,1,0.28,0.2576,0.45,0.3284,0,4,4,4
8674,1/2/2012,1,1,1,5,1,1,0,1,0.28,0.2576,0.45,0.3284,1,3,4,3
8675,1/2/2012,1,1,1,6,1,1,0,1,0.26,0.2273,0.41,0.3881,0,14,14,14
8676,1/2/2012,1,1,1,7,1,1,0,1,0.24,0.2121,0.32,0.3881,0,16,16,16
8677,1/2/2012,1,1,1,8,1,1,0,1,0.24,0.2273,0.35,0.2537,2,51,53,51
8678,1/2/2012,1,1,1,9,1,1,0,1,0.24,0.2576,0.35,0,15,53,68,53
8679,1/2/2012,1,1,1,10,1,1,0,1,0.26,0.2424,0.35,0.2836,20,89,109,89
8680,1/2/2012,1,1,1,11,1,1,0,1,0.26,0.2121,0.35,0.4925,33,142,175,142
8681,1/2/2012,1,1,1,12,1,1,0,1,0.28,0.2727,0.36,0.2537,41,161,202,161
8682,1/2/2012,1,1,1,13,1,1,0,1,0.3,0.2727,0.36,0.2985,26,150,176,150
8683,1/2/2012,1,1,1,14,1,1,0,1,0.3,0.2727,0.36,0.4179,10,141,151,141
8684,1/2/2012,1,1,1,15,1,1,0,1,0.28,0.2424,0.38,0.4478,29,139,168,139
8685,1/2/2012,1,1,1,16,1,1,0,1,0.26,0.2273,0.35,0.4179,10,144,154,144
8686,1/2/2012,1,1,1,17,1,1,0,1,0.26,0.2273,0.35,0.3881,17,136,153,136
8687,1/2/2012,1,1,1,18,1,1,0,1,0.26,0.2424,0.33,0.2537,13,113,126,113
8688,1/2/2012,1,1,1,19,1,1,0,1,0.24,0.2273,0.38,0.2239,4,89,93,89
8689,1/2/2012,1,1,1,20,1,1,0,1,0.24,0.2273,0.41,0.2239,5,83,88,83
8690,1/2/2012,1,1,1,21,1,1,0,2,0.24,0.2121,0.41,0.3284,3,63,66,63
8691,1/2/2012,1,1,1,22,1,1,0,2,0.22,0.2121,0.44,0.2836,3,36,39,36
8692,1/2/2012,1,1,1,23,1,1,0,1,0.22,0.2121,0.44,0.2537,2,32,34,32
8693,1/3/2012,1,1,1,0,0,2,1,1,0.2,0.197,0.51,0.2537,0,13,13,13
8694,1/3/2012,1,1,1,1,0,2,1,1,0.18,0.1818,0.55,0.2239,1,5,6,5
8695,1/3/2012,1,1,1,2,0,2,1,1,0.18,0.1667,0.51,0.2537,0,3,3,3
8696,1/3/2012,1,1,1,3,0,2,1,1,0.16,0.1364,0.55,0.2836,0,2,2,2
8697,1/3/2012,1,1,1,4,0,2,1,1,0.16,0.1515,0.55,0.2537,0,5,5,5
8698,1/3/2012,1,1,1,5,0,2,1,1,0.14,0.1364,0.54,0.194,0,12,12,12
8699,1/3/2012,1,1,1,6,0,2,1,1,0.14,0.1212,0.59,0.2836,4,81,85,81
8700,1/3/2012,1,1,1,7,0,2,1,1,0.14,0.1212,0.59,0.2537,2,168,170,168
8701,1/3/2012,1,1,1,8,0,2,1,1,0.16,0.1364,0.55,0.2836,5,349,354,349
8702,1/3/2012,1,1,1,9,0,2,1,1,0.16,0.1364,0.5,0.2836,8,145,153,145
8703,1/3/2012,1,1,1,10,0,2,1,1,0.16,0.1212,0.47,0.4627,5,55,60,55
8704,1/3/2012,1,1,1,11,0,2,1,1,0.18,0.1364,0.37,0.5224,12,63,75,63
8705,1/3/2012,1,1,1,12,0,2,1,1,0.18,0.1364,0.37,0.5224,4,70,74,70
8706,1/3/2012,1,1,1,13,0,2,1,1,0.18,0.1212,0.34,0.6567,5,68,73,68
8707,1/3/2012,1,1,1,14,0,2,1,1,0.16,0.1212,0.43,0.5224,7,72,79,72
8708,1/3/2012,1,1,1,15,0,2,1,1,0.16,0.1212,0.37,0.4179,9,68,77,68
8709,1/3/2012,1,1,1,16,0,2,1,1,0.14,0.0909,0.39,0.5821,7,129,136,129
8710,1/3/2012,1,1,1,17,0,2,1,1,0.14,0.1061,0.26,0.4627,4,241,245,241
8711,1/3/2012,1,1,1,18,0,2,1,1,0.14,0.0909,0.26,0.5224,10,214,224,214
8712,1/3/2012,1,1,1,19,0,2,1,1,0.12,0.0909,0.28,0.4179,4,152,156,152
8713,1/3/2012,1,1,1,20,0,2,1,1,0.12,0.1212,0.33,0.2537,0,115,115,115
8714,1/3/2012,1,1,1,21,0,2,1,1,0.1,0.1061,0.36,0.2239,2,66,68,66
8715,1/3/2012,1,1,1,22,0,2,1,1,0.1,0.1061,0.46,0.2537,0,33,33,33
8716,1/3/2012,1,1,1,23,0,2,1,1,0.1,0.0758,0.46,0.3881,0,18,18,18
8717,1/4/2012,1,1,1,0,0,3,1,1,0.08,0.0606,0.42,0.3284,0,9,9,9
8718,1/4/2012,1,1,1,1,0,3,1,1,0.04,0.0303,0.38,0.2985,0,3,3,3
8719,1/4/2012,1,1,1,2,0,3,1,1,0.02,0.0152,0.34,0.2836,0,1,1,1
8720,1/4/2012,1,1,1,3,0,3,1,1,0.02,0.0152,0.34,0.2836,0,1,1,1
8721,1/4/2012,1,1,1,4,0,3,1,1,0.02,0.0455,0.41,0.194,0,2,2,2
8722,1/4/2012,1,1,1,5,0,3,1,1,0.02,0.0455,0.41,0.194,0,14,14,14
8723,1/4/2012,1,1,1,6,0,3,1,1,0.02,0.0455,0.41,0.1642,0,59,59,59
8724,1/4/2012,1,1,1,7,0,3,1,1,0.02,0.0455,0.44,0.194,1,151,152,151
8725,1/4/2012,1,1,1,8,0,3,1,1,0.02,0.0606,0.44,0.1343,5,310,315,310
8726,1/4/2012,1,1,1,9,0,3,1,1,0.04,0.0606,0.45,0.1343,7,173,180,173
8727,1/4/2012,1,1,1,10,0,3,1,1,0.06,0.1061,0.45,0,7,57,64,57
8728,1/4/2012,1,1,1,11,0,3,1,2,0.08,0.1212,0.42,0.0896,6,40,46,40
8729,1/4/2012,1,1,1,12,0,3,1,2,0.1,0.1061,0.46,0.194,9,75,84,75
8730,1/4/2012,1,1,1,13,0,3,1,2,0.14,0.1212,0.43,0.2537,9,82,91,82
8731,1/4/2012,1,1,1,14,0,3,1,2,0.14,0.1212,0.46,0.2537,6,69,75,69
8732,1/4/2012,1,1,1,15,0,3,1,2,0.18,0.1515,0.37,0.3284,9,81,90,81
8733,1/4/2012,1,1,1,16,0,3,1,2,0.18,0.1667,0.4,0.2836,8,123,131,123
8734,1/4/2012,1,1,1,17,0,3,1,2,0.2,0.197,0.4,0.194,9,272,281,272
8735,1/4/2012,1,1,1,18,0,3,1,2,0.2,0.2121,0.37,0.1343,9,280,289,280
8736,1/4/2012,1,1,1,19,0,3,1,2,0.2,0.2273,0.4,0.1045,2,182,184,182
8737,1/4/2012,1,1,1,20,0,3,1,2,0.2,0.197,0.4,0.194,2,121,123,121
8738,1/4/2012,1,1,1,21,0,3,1,2,0.2,0.2576,0.44,0,2,88,90,88
8739,1/4/2012,1,1,1,22,0,3,1,2,0.2,0.2273,0.47,0.0896,4,48,52,48
8740,1/4/2012,1,1,1,23,0,3,1,2,0.2,0.2273,0.44,0.1045,0,32,32,32
8741,1/5/2012,1,1,1,0,0,4,1,2,0.22,0.2273,0.47,0.194,1,13,14,13
8742,1/5/2012,1,1,1,1,0,4,1,1,0.2,0.2273,0.51,0.0896,0,5,5,5
8743,1/5/2012,1,1,1,2,0,4,1,1,0.2,0.2273,0.51,0.0896,0,4,4,4
8744,1/5/2012,1,1,1,3,0,4,1,1,0.2,0.2576,0.61,0,0,4,4,4
8745,1/5/2012,1,1,1,4,0,4,1,2,0.2,0.2273,0.59,0.0896,0,5,5,5
8746,1/5/2012,1,1,1,5,0,4,1,2,0.2,0.2273,0.59,0.0896,0,26,26,26
8747,1/5/2012,1,1,1,6,0,4,1,2,0.2,0.2121,0.75,0.1343,0,78,78,78
8748,1/5/2012,1,1,1,7,0,4,1,2,0.2,0.2273,0.69,0.0896,3,212,215,212
8749,1/5/2012,1,1,1,8,0,4,1,2,0.2,0.2576,0.75,0,11,377,388,377
8750,1/5/2012,1,1,1,9,0,4,1,2,0.22,0.2727,0.69,0,7,220,227,220
8751,1/5/2012,1,1,1,10,0,4,1,2,0.24,0.2576,0.52,0.0896,5,81,86,81
8752,1/5/2012,1,1,1,11,0,4,1,1,0.3,0.3333,0.49,0,6,78,84,78
8753,1/5/2012,1,1,1,12,0,4,1,1,0.3,0.2879,0.49,0.2537,6,114,120,114
8754,1/5/2012,1,1,1,13,0,4,1,1,0.34,0.303,0.42,0.2985,6,112,118,112
8755,1/5/2012,1,1,1,14,0,4,1,1,0.34,0.3182,0.39,0.2836,13,104,117,104
8756,1/5/2012,1,1,1,15,0,4,1,1,0.36,0.3333,0.34,0.2836,6,113,119,113
8757,1/5/2012,1,1,1,16,0,4,1,1,0.36,0.3333,0.34,0.2836,19,178,197,178
8758,1/5/2012,1,1,1,17,0,4,1,2,0.36,0.3485,0.34,0.194,19,393,412,393
8759,1/5/2012,1,1,1,18,0,4,1,1,0.34,0.3333,0.36,0.1642,9,374,383,374
8760,1/5/2012,1,1,1,19,0,4,1,1,0.34,0.3485,0.34,0.0896,10,255,265,255
8761,1/5/2012,1,1,1,20,0,4,1,1,0.3,0.3333,0.49,0,5,172,177,172
8762,1/5/2012,1,1,1,21,0,4,1,1,0.26,0.2727,0.6,0.1343,9,88,97,88
8763,1/5/2012,1,1,1,22,0,4,1,1,0.26,0.2576,0.6,0.1642,1,70,71,70
8764,1/5/2012,1,1,1,23,0,4,1,1,0.24,0.2576,0.7,0.1045,4,56,60,56
8765,1/6/2012,1,1,1,0,0,5,1,1,0.22,0.2576,0.75,0.0896,1,24,25,24
8766,1/6/2012,1,1,1,1,0,5,1,1,0.22,0.2727,0.75,0,2,6,8,6
8767,1/6/2012,1,1,1,2,0,5,1,1,0.22,0.2273,0.69,0.1642,2,3,5,3
8768,1/6/2012,1,1,1,3,0,5,1,1,0.22,0.2424,0.69,0.1045,1,3,4,3
8769,1/6/2012,1,1,1,4,0,5,1,1,0.22,0.2273,0.69,0.1343,0,3,3,3
8770,1/6/2012,1,1,1,5,0,5,1,2,0.2,0.2121,0.8,0.1343,0,13,13,13
8771,1/6/2012,1,1,1,6,0,5,1,2,0.22,0.2424,0.73,0.1045,1,69,70,69
8772,1/6/2012,1,1,1,7,0,5,1,2,0.24,0.2879,0.65,0,4,201,205,201
8773,1/6/2012,1,1,1,8,0,5,1,1,0.24,0.2424,0.7,0.1343,11,436,447,436
8774,1/6/2012,1,1,1,9,0,5,1,1,0.24,0.2424,0.7,0.1642,4,237,241,237
8775,1/6/2012,1,1,1,10,0,5,1,1,0.26,0.2576,0.65,0.194,14,102,116,102
8776,1/6/2012,1,1,1,11,0,5,1,1,0.3,0.303,0.56,0.1642,8,130,138,130
8777,1/6/2012,1,1,1,12,0,5,1,1,0.36,0.3333,0.5,0.2537,23,168,191,168
8778,1/6/2012,1,1,1,13,0,5,1,1,0.4,0.4091,0.43,0.2836,16,188,204,188
8779,1/6/2012,1,1,1,14,0,5,1,1,0.46,0.4545,0.36,0.194,26,152,178,152
8780,1/6/2012,1,1,1,15,0,5,1,1,0.52,0.5,0.27,0.2537,44,178,222,178
8781,1/6/2012,1,1,1,16,0,5,1,1,0.52,0.5,0.27,0.2836,35,259,294,259
8782,1/6/2012,1,1,1,17,0,5,1,1,0.46,0.4545,0.36,0.2239,20,456,476,456
8783,1/6/2012,1,1,1,18,0,5,1,1,0.5,0.4848,0.29,0.2537,28,391,419,391
8784,1/6/2012,1,1,1,19,0,5,1,1,0.46,0.4545,0.33,0.2836,11,261,272,261
8785,1/6/2012,1,1,1,20,0,5,1,1,0.42,0.4242,0.41,0.194,14,163,177,163
8786,1/6/2012,1,1,1,21,0,5,1,1,0.4,0.4091,0.43,0.2239,17,137,154,137
8787,1/6/2012,1,1,1,22,0,5,1,1,0.36,0.3485,0.5,0.194,12,123,135,123
8788,1/6/2012,1,1,1,23,0,5,1,1,0.36,0.3788,0.5,0,13,88,101,88
8789,1/7/2012,1,1,1,0,0,6,0,1,0.36,0.3485,0.5,0.1642,2,77,79,77
8790,1/7/2012,1,1,1,1,0,6,0,1,0.38,0.3939,0.46,0.1642,6,56,62,56
8791,1/7/2012,1,1,1,2,0,6,0,1,0.36,0.3636,0.5,0.1045,2,36,38,36
8792,1/7/2012,1,1,1,3,0,6,0,1,0.32,0.3333,0.57,0.1045,1,19,20,19
8793,1/7/2012,1,1,1,4,0,6,0,1,0.32,0.3333,0.57,0.0896,1,9,10,9
8794,1/7/2012,1,1,1,5,0,6,0,1,0.26,0.2727,0.75,0.1045,2,7,9,7
8795,1/7/2012,1,1,1,6,0,6,0,1,0.26,0.2727,0.75,0.1045,0,7,7,7
8796,1/7/2012,1,1,1,7,0,6,0,1,0.22,0.2273,0.87,0.194,0,20,20,20
8797,1/7/2012,1,1,1,8,0,6,0,1,0.24,0.2576,0.75,0.1045,0,64,64,64
8798,1/7/2012,1,1,1,9,0,6,0,1,0.22,0.2273,0.8,0.1343,14,116,130,116
8799,1/7/2012,1,1,1,10,0,6,0,1,0.28,0.303,0.75,0.0896,43,160,203,160
8800,1/7/2012,1,1,1,11,0,6,0,1,0.34,0.3182,0.57,0.2239,74,250,324,250
8801,1/7/2012,1,1,1,12,0,6,0,1,0.4,0.4091,0.43,0.2239,100,276,376,276
8802,1/7/2012,1,1,1,13,0,6,0,1,0.44,0.4394,0.44,0.194,149,296,445,296
8803,1/7/2012,1,1,1,14,0,6,0,1,0.5,0.4848,0.42,0.2836,156,356,512,356
8804,1/7/2012,1,1,1,15,0,6,0,1,0.58,0.5455,0.37,0.2985,132,317,449,317
8805,1/7/2012,1,1,1,16,0,6,0,2,0.56,0.5303,0.37,0.2836,133,268,401,268
8806,1/7/2012,1,1,1,17,0,6,0,2,0.54,0.5152,0.43,0.1343,87,235,322,235
8807,1/7/2012,1,1,1,18,0,6,0,1,0.54,0.5152,0.45,0.1343,49,248,297,248
8808,1/7/2012,1,1,1,19,0,6,0,1,0.52,0.5,0.42,0.1045,44,171,215,171
8809,1/7/2012,1,1,1,20,0,6,0,1,0.5,0.4848,0.39,0.2537,21,149,170,149
8810,1/7/2012,1,1,1,21,0,6,0,1,0.44,0.4394,0.44,0.2239,22,118,140,118
8811,1/7/2012,1,1,1,22,0,6,0,1,0.44,0.4394,0.38,0.2537,16,93,109,93
8812,1/7/2012,1,1,1,23,0,6,0,1,0.42,0.4242,0.38,0.2239,16,103,119,103
8813,1/8/2012,1,1,1,0,0,0,0,1,0.38,0.3939,0.4,0.2836,14,77,91,77
8814,1/8/2012,1,1,1,1,0,0,0,1,0.34,0.3333,0.42,0.194,10,62,72,62
8815,1/8/2012,1,1,1,2,0,0,0,1,0.36,0.3333,0.37,0.2836,10,57,67,57
8816,1/8/2012,1,1,1,3,0,0,0,1,0.34,0.3333,0.42,0.1343,6,26,32,26
8817,1/8/2012,1,1,1,4,0,0,0,1,0.32,0.303,0.49,0.2537,2,4,6,4
8818,1/8/2012,1,1,1,5,0,0,0,2,0.32,0.3333,0.49,0.1045,0,2,2,2
8819,1/8/2012,1,1,1,6,0,0,0,2,0.3,0.3333,0.52,0,0,2,2,2
8820,1/8/2012,1,1,1,7,0,0,0,2,0.3,0.3333,0.52,0,1,23,24,23
8821,1/8/2012,1,1,1,8,0,0,0,1,0.3,0.303,0.52,0.1343,4,53,57,53
8822,1/8/2012,1,1,1,9,0,0,0,1,0.32,0.3333,0.53,0.1343,23,102,125,102
8823,1/8/2012,1,1,1,10,0,0,0,1,0.34,0.3333,0.49,0.1642,27,181,208,181
8824,1/8/2012,1,1,1,11,0,0,0,1,0.36,0.3485,0.46,0.2239,55,201,256,201
8825,1/8/2012,1,1,1,12,0,0,0,1,0.38,0.3939,0.43,0.2239,78,273,351,273
8826,1/8/2012,1,1,1,13,0,0,0,1,0.4,0.4091,0.37,0.2985,77,266,343,266
8827,1/8/2012,1,1,1,14,0,0,0,1,0.4,0.4091,0.4,0.194,75,253,328,253
8828,1/8/2012,1,1,1,15,0,0,0,1,0.4,0.4091,0.37,0.2836,89,241,330,241
8829,1/8/2012,1,1,1,16,0,0,0,1,0.4,0.4091,0.37,0.2985,58,256,314,256
8830,1/8/2012,1,1,1,17,0,0,0,1,0.38,0.3939,0.4,0.2239,22,197,219,197
8831,1/8/2012,1,1,1,18,0,0,0,1,0.34,0.3182,0.46,0.2239,19,162,181,162
8832,1/8/2012,1,1,1,19,0,0,0,1,0.32,0.3182,0.49,0.194,8,104,112,104
8833,1/8/2012,1,1,1,20,0,0,0,1,0.3,0.303,0.52,0.1642,7,119,126,119
8834,1/8/2012,1,1,1,21,0,0,0,1,0.28,0.2727,0.56,0.2239,10,81,91,81
8835,1/8/2012,1,1,1,22,0,0,0,1,0.26,0.2727,0.6,0.1045,4,54,58,54
8836,1/8/2012,1,1,1,23,0,0,0,1,0.26,0.2424,0.56,0.2537,0,30,30,30
8837,1/9/2012,1,1,1,0,0,1,1,1,0.24,0.2273,0.6,0.2239,3,12,15,12
8838,1/9/2012,1,1,1,1,0,1,1,1,0.24,0.2424,0.6,0.1343,1,4,5,4
8839,1/9/2012,1,1,1,2,0,1,1,1,0.24,0.2424,0.56,0.1343,2,3,5,3
8840,1/9/2012,1,1,1,3,0,1,1,1,0.24,0.2424,0.52,0.1642,0,3,3,3
8841,1/9/2012,1,1,1,4,0,1,1,1,0.22,0.2424,0.64,0.1045,0,4,4,4
8842,1/9/2012,1,1,1,5,0,1,1,2,0.2,0.2273,0.64,0.0896,0,21,21,21
8843,1/9/2012,1,1,1,6,0,1,1,2,0.22,0.2273,0.6,0.1343,3,85,88,85
8844,1/9/2012,1,1,1,7,0,1,1,2,0.22,0.2424,0.6,0.1045,1,239,240,239
8845,1/9/2012,1,1,1,8,0,1,1,2,0.22,0.2576,0.55,0.0896,13,407,420,407
8846,1/9/2012,1,1,1,9,0,1,1,2,0.22,0.2727,0.64,0,9,188,197,188
8847,1/9/2012,1,1,1,10,0,1,1,1,0.24,0.2879,0.6,0,13,95,108,95
8848,1/9/2012,1,1,1,11,0,1,1,2,0.26,0.2879,0.56,0.0896,6,82,88,82
8849,1/9/2012,1,1,1,12,0,1,1,2,0.26,0.2727,0.56,0.1045,10,93,103,93
8850,1/9/2012,1,1,1,13,0,1,1,2,0.26,0.2727,0.56,0.1045,3,77,80,77
8851,1/9/2012,1,1,1,14,0,1,1,3,0.22,0.2273,0.75,0.1642,5,45,50,45
8852,1/9/2012,1,1,1,15,0,1,1,3,0.22,0.2273,0.75,0.1642,5,64,69,64
8853,1/9/2012,1,1,1,16,0,1,1,3,0.22,0.2576,0.87,0.0896,3,46,49,46
8854,1/9/2012,1,1,1,17,0,1,1,3,0.22,0.2727,0.87,0,5,147,152,147
8855,1/9/2012,1,1,1,18,0,1,1,4,0.2,0.2273,0.86,0.0896,6,158,164,158
8856,1/9/2012,1,1,1,19,0,1,1,3,0.2,0.2273,0.93,0.0896,3,187,190,187
8857,1/9/2012,1,1,1,20,0,1,1,2,0.2,0.2273,0.86,0.0896,5,127,132,127
8858,1/9/2012,1,1,1,21,0,1,1,2,0.2,0.2576,0.93,0,1,78,79,78
8859,1/9/2012,1,1,1,22,0,1,1,2,0.2,0.2273,0.92,0.1045,8,54,62,54
8860,1/9/2012,1,1,1,23,0,1,1,2,0.22,0.2424,0.87,0.1045,1,51,52,51
8861,1/10/2012,1,1,1,0,0,2,1,2,0.22,0.2424,0.87,0.1045,0,14,14,14
8862,1/10/2012,1,1,1,1,0,2,1,2,0.22,0.2424,0.93,0.1045,2,3,5,3
8863,1/10/2012,1,1,1,2,0,2,1,2,0.22,0.2273,0.87,0.1642,2,2,4,2
8864,1/10/2012,1,1,1,4,0,2,1,2,0.2,0.2121,0.86,0.1642,0,4,4,4
8865,1/10/2012,1,1,1,5,0,2,1,1,0.4,0.4091,0.47,0.2239,0,23,23,23
8866,1/10/2012,1,1,1,6,0,2,1,2,0.18,0.1818,0.93,0.194,0,79,79,79
8867,1/10/2012,1,1,1,7,0,2,1,2,0.18,0.197,0.93,0.1642,3,219,222,219
8868,1/10/2012,1,1,1,8,0,2,1,2,0.18,0.197,0.93,0.1642,6,465,471,465
8869,1/10/2012,1,1,1,9,0,2,1,2,0.18,0.197,0.93,0.1642,11,184,195,184
8870,1/10/2012,1,1,1,10,0,2,1,2,0.18,0.197,0.93,0.1642,3,80,83,80
8871,1/10/2012,1,1,1,11,0,2,1,1,0.42,0.4242,0.38,0.2985,8,93,101,93
8872,1/10/2012,1,1,1,12,0,2,1,1,0.42,0.4242,0.38,0.2985,13,127,140,127
8873,1/10/2012,1,1,1,13,0,2,1,1,0.42,0.4242,0.38,0.2985,15,163,178,163
8874,1/10/2012,1,1,1,14,0,2,1,1,0.42,0.4242,0.38,0.2985,10,96,106,96
8875,1/10/2012,1,1,1,15,0,2,1,1,0.42,0.4242,0.38,0.2985,17,119,136,119
8876,1/10/2012,1,1,1,16,0,2,1,1,0.42,0.4242,0.38,0.3582,15,225,240,225
8877,1/10/2012,1,1,1,17,0,2,1,1,0.42,0.4242,0.38,0.2537,14,446,460,446
8878,1/10/2012,1,1,1,18,0,2,1,1,0.4,0.4091,0.4,0.1045,13,372,385,372
8879,1/10/2012,1,1,1,19,0,2,1,1,0.38,0.3939,0.46,0.1045,11,270,281,270
8880,1/10/2012,1,1,1,20,0,2,1,1,0.34,0.3485,0.53,0.1045,10,190,200,190
8881,1/10/2012,1,1,1,21,0,2,1,1,0.32,0.3333,0.66,0.0896,7,109,116,109
8882,1/10/2012,1,1,1,22,0,2,1,1,0.3,0.303,0.7,0.0896,10,104,114,104
8883,1/10/2012,1,1,1,23,0,2,1,1,0.26,0.2727,0.81,0.1045,3,38,41,38
8884,1/11/2012,1,1,1,0,0,3,1,1,0.26,0.303,0.81,0,2,26,28,26
8885,1/11/2012,1,1,1,1,0,3,1,1,0.24,0.2576,0.87,0.0896,1,6,7,6
8886,1/11/2012,1,1,1,2,0,3,1,1,0.2,0.2121,0.85,0.1642,0,5,5,5
8887,1/11/2012,1,1,1,3,0,3,1,1,0.22,0.2727,0.8,0,0,4,4,4
8888,1/11/2012,1,1,1,4,0,3,1,1,0.2,0.2121,0.8,0.1343,0,2,2,2
8889,1/11/2012,1,1,1,5,0,3,1,1,0.2,0.2121,0.8,0.1343,0,22,22,22
8890,1/11/2012,1,1,1,6,0,3,1,1,0.2,0.2121,0.86,0.1343,2,72,74,72
8891,1/11/2012,1,1,1,7,0,3,1,1,0.2,0.2121,0.8,0.1343,9,247,256,247
8892,1/11/2012,1,1,1,8,0,3,1,1,0.2,0.2273,0.82,0.1045,11,488,499,488
8893,1/11/2012,1,1,1,9,0,3,1,2,0.2,0.2121,0.86,0.1343,7,218,225,218
8894,1/11/2012,1,1,1,10,0,3,1,2,0.24,0.2424,0.87,0.1343,13,84,97,84
8895,1/11/2012,1,1,1,11,0,3,1,2,0.26,0.2879,0.87,0.0896,9,90,99,90
8896,1/11/2012,1,1,1,12,0,3,1,3,0.3,0.3333,0.81,0,4,51,55,51
8897,1/11/2012,1,1,1,13,0,3,1,3,0.32,0.3485,0.76,0,8,57,65,57
8898,1/11/2012,1,1,1,14,0,3,1,3,0.32,0.3333,0.81,0.1045,3,70,73,70
8899,1/11/2012,1,1,1,15,0,3,1,2,0.34,0.3485,0.87,0.0896,6,73,79,73
8900,1/11/2012,1,1,1,16,0,3,1,2,0.34,0.3182,0.87,0.2537,6,112,118,112
8901,1/11/2012,1,1,1,17,0,3,1,3,0.34,0.3182,0.87,0.2239,6,128,134,128
8902,1/11/2012,1,1,1,18,0,3,1,3,0.34,0.3333,0.87,0.194,2,96,98,96
8903,1/11/2012,1,1,1,19,0,3,1,3,0.32,0.303,0.93,0.2239,1,92,93,92
8904,1/11/2012,1,1,1,20,0,3,1,3,0.32,0.3182,0.93,0.1642,2,55,57,55
8905,1/11/2012,1,1,1,21,0,3,1,3,0.34,0.3182,0.87,0.2239,0,29,29,29
8906,1/11/2012,1,1,1,22,0,3,1,3,0.34,0.3333,0.87,0.194,0,49,49,49
8907,1/11/2012,1,1,1,23,0,3,1,3,0.34,0.3182,0.87,0.2239,0,9,9,9
8908,1/12/2012,1,1,1,0,0,4,1,3,0.34,0.3333,0.93,0.194,0,3,3,3
8909,1/12/2012,1,1,1,1,0,4,1,3,0.36,0.3485,0.93,0.194,0,3,3,3
8910,1/12/2012,1,1,1,2,0,4,1,3,0.36,0.3485,0.93,0.2537,1,1,2,1
8911,1/12/2012,1,1,1,3,0,4,1,3,0.36,0.3485,0.93,0.2537,0,3,3,3
8912,1/12/2012,1,1,1,4,0,4,1,3,0.36,0.3485,0.93,0.194,0,2,2,2
8913,1/12/2012,1,1,1,5,0,4,1,3,0.34,0.3485,0.93,0.0896,0,16,16,16
8914,1/12/2012,1,1,1,6,0,4,1,3,0.36,0.3485,0.93,0.1343,1,88,89,88
8915,1/12/2012,1,1,1,7,0,4,1,2,0.34,0.3182,0.87,0.2836,2,218,220,218
8916,1/12/2012,1,1,1,8,0,4,1,1,0.32,0.3182,0.81,0.194,11,497,508,497
8917,1/12/2012,1,1,1,9,0,4,1,1,0.32,0.3333,0.81,0.1045,10,220,230,220
8918,1/12/2012,1,1,1,10,0,4,1,1,0.34,0.3485,0.81,0.1045,6,84,90,84
8919,1/12/2012,1,1,1,11,0,4,1,2,0.34,0.3485,0.81,0.1045,18,101,119,101
8920,1/12/2012,1,1,1,12,0,4,1,2,0.34,0.3485,0.81,0.1045,14,130,144,130
8921,1/12/2012,1,1,1,13,0,4,1,1,0.42,0.4242,0.77,0.1642,13,170,183,170
8922,1/12/2012,1,1,1,14,0,4,1,1,0.42,0.4242,0.77,0.1642,24,132,156,132
8923,1/12/2012,1,1,1,15,0,4,1,1,0.44,0.4394,0.72,0.1343,32,156,188,156
8924,1/12/2012,1,1,1,16,0,4,1,1,0.46,0.4545,0.67,0.194,33,248,281,248
8925,1/12/2012,1,1,1,17,0,4,1,1,0.46,0.4545,0.63,0.1642,23,472,495,472
8926,1/12/2012,1,1,1,18,0,4,1,1,0.44,0.4394,0.67,0.194,22,399,421,399
8927,1/12/2012,1,1,1,19,0,4,1,2,0.42,0.4242,0.71,0.1642,17,313,330,313
8928,1/12/2012,1,1,1,20,0,4,1,2,0.42,0.4242,0.71,0.194,11,229,240,229
8929,1/12/2012,1,1,1,21,0,4,1,1,0.44,0.4394,0.67,0.1343,12,162,174,162
8930,1/12/2012,1,1,1,22,0,4,1,1,0.38,0.3939,0.76,0.2985,12,121,133,121
8931,1/12/2012,1,1,1,23,0,4,1,1,0.4,0.4091,0.76,0.3284,7,60,67,60
8932,1/13/2012,1,1,1,0,0,5,1,2,0.4,0.4091,0.71,0.2836,4,38,42,38
8933,1/13/2012,1,1,1,1,0,5,1,2,0.38,0.3939,0.76,0.2985,0,12,12,12
8934,1/13/2012,1,1,1,2,0,5,1,1,0.4,0.4091,0.76,0.3582,1,13,14,13
8935,1/13/2012,1,1,1,3,0,5,1,1,0.36,0.3333,0.87,0.2537,3,4,7,4
8936,1/13/2012,1,1,1,4,0,5,1,3,0.32,0.2879,0.7,0.4925,1,2,3,2
8937,1/13/2012,1,1,1,5,0,5,1,2,0.3,0.2424,0.7,0.5522,0,21,21,21
8938,1/13/2012,1,1,1,6,0,5,1,2,0.26,0.2576,0.75,0.2239,2,71,73,71
8939,1/13/2012,1,1,1,7,0,5,1,1,0.26,0.2576,0.6,0.2239,3,174,177,174
8940,1/13/2012,1,1,1,8,0,5,1,1,0.24,0.2121,0.52,0.3582,11,408,419,408
8941,1/13/2012,1,1,1,9,0,5,1,1,0.22,0.197,0.47,0.3881,10,204,214,204
8942,1/13/2012,1,1,1,10,0,5,1,1,0.24,0.197,0.44,0.4478,2,101,103,101
8943,1/13/2012,1,1,1,11,0,5,1,1,0.24,0.1818,0.38,0.6119,12,102,114,102
8944,1/13/2012,1,1,1,12,0,5,1,1,0.24,0.197,0.38,0.4925,14,140,154,140
8945,1/13/2012,1,1,1,13,0,5,1,1,0.26,0.2121,0.33,0.5224,14,140,154,140
8946,1/13/2012,1,1,1,14,0,5,1,1,0.26,0.2121,0.33,0.5522,10,119,129,119
8947,1/13/2012,1,1,1,15,0,5,1,1,0.26,0.2121,0.33,0.5821,15,123,138,123
8948,1/13/2012,1,1,1,16,0,5,1,1,0.28,0.2424,0.3,0.4627,18,215,233,215
8949,1/13/2012,1,1,1,17,0,5,1,1,0.28,0.2424,0.33,0.4179,15,317,332,317
8950,1/13/2012,1,1,1,18,0,5,1,1,0.26,0.2273,0.38,0.2985,7,294,301,294
8951,1/13/2012,1,1,1,19,0,5,1,1,0.26,0.2424,0.38,0.2836,7,199,206,199
8952,1/13/2012,1,1,1,20,0,5,1,1,0.24,0.2424,0.41,0.1642,6,130,136,130
8953,1/13/2012,1,1,1,21,0,5,1,1,0.24,0.2121,0.41,0.2836,7,95,102,95
8954,1/13/2012,1,1,1,22,0,5,1,1,0.2,0.1818,0.47,0.3284,7,58,65,58
8955,1/13/2012,1,1,1,23,0,5,1,1,0.18,0.1818,0.47,0.194,5,60,65,60
8956,1/14/2012,1,1,1,0,0,6,0,1,0.16,0.1818,0.47,0.1045,2,42,44,42
8957,1/14/2012,1,1,1,1,0,6,0,1,0.16,0.1515,0.47,0.194,6,44,50,44
8958,1/14/2012,1,1,1,2,0,6,0,1,0.16,0.1667,0.47,0.1642,6,32,38,32
8959,1/14/2012,1,1,1,3,0,6,0,1,0.14,0.1667,0.54,0.1045,6,14,20,14
8960,1/14/2012,1,1,1,4,0,6,0,1,0.14,0.1515,0.5,0.1343,0,3,3,3
8961,1/14/2012,1,1,1,5,0,6,0,1,0.14,0.1515,0.5,0.1343,0,4,4,4
8962,1/14/2012,1,1,1,6,0,6,0,1,0.14,0.1515,0.5,0,0,5,5,5
8963,1/14/2012,1,1,1,7,0,6,0,1,0.14,0.1515,0.5,0.1343,0,24,24,24
8964,1/14/2012,1,1,1,8,0,6,0,1,0.12,0.1515,0.54,0.1045,3,89,92,89
8965,1/14/2012,1,1,1,9,0,6,0,1,0.14,0.1667,0.5,0.1045,3,78,81,78
8966,1/14/2012,1,1,1,10,0,6,0,1,0.16,0.2273,0.47,0,14,135,149,135
8967,1/14/2012,1,1,1,11,0,6,0,1,0.2,0.197,0.4,0.194,28,150,178,150
8968,1/14/2012,1,1,1,12,0,6,0,1,0.22,0.2121,0.41,0.2537,30,189,219,189
8969,1/14/2012,1,1,1,13,0,6,0,1,0.22,0.2121,0.44,0.2836,38,182,220,182
8970,1/14/2012,1,1,1,14,0,6,0,1,0.24,0.2121,0.41,0.2985,52,179,231,179
8971,1/14/2012,1,1,1,15,0,6,0,1,0.24,0.2121,0.38,0.2985,49,177,226,177
8972,1/14/2012,1,1,1,16,0,6,0,1,0.24,0.2273,0.38,0.2239,28,178,206,178
8973,1/14/2012,1,1,1,17,0,6,0,1,0.24,0.2273,0.41,0.2537,15,129,144,129
8974,1/14/2012,1,1,1,18,0,6,0,1,0.22,0.2273,0.41,0.194,21,122,143,122
8975,1/14/2012,1,1,1,19,0,6,0,1,0.2,0.197,0.47,0.2239,12,90,102,90
8976,1/14/2012,1,1,1,20,0,6,0,1,0.2,0.197,0.44,0.2537,8,95,103,95
8977,1/14/2012,1,1,1,21,0,6,0,1,0.18,0.1667,0.43,0.2537,3,66,69,66
8978,1/14/2012,1,1,1,22,0,6,0,1,0.16,0.1364,0.47,0.3582,4,62,66,62
8979,1/14/2012,1,1,1,23,0,6,0,1,0.16,0.1515,0.47,0.2239,5,71,76,71
8980,1/15/2012,1,1,1,0,0,0,0,1,0.16,0.1364,0.47,0.3284,9,50,59,50
8981,1/15/2012,1,1,1,1,0,0,0,2,0.16,0.1364,0.47,0.2985,2,40,42,40
8982,1/15/2012,1,1,1,2,0,0,0,2,0.16,0.1364,0.47,0.2836,5,38,43,38
8983,1/15/2012,1,1,1,3,0,0,0,2,0.16,0.1364,0.48,0.3881,1,24,25,24
8984,1/15/2012,1,1,1,4,0,0,0,2,0.16,0.1364,0.47,0.3881,1,5,6,5
8985,1/15/2012,1,1,1,5,0,0,0,2,0.16,0.1364,0.47,0.3284,0,5,5,5
8986,1/15/2012,1,1,1,6,0,0,0,2,0.14,0.1212,0.5,0.2836,1,7,8,7
8987,1/15/2012,1,1,1,7,0,0,0,1,0.12,0.1212,0.54,0.2836,3,14,17,14
8988,1/15/2012,1,1,1,8,0,0,0,1,0.12,0.1212,0.54,0.2239,2,34,36,34
8989,1/15/2012,1,1,1,9,0,0,0,1,0.12,0.1364,0.54,0.194,10,80,90,80
8990,1/15/2012,1,1,1,10,0,0,0,1,0.14,0.1212,0.54,0.2836,11,115,126,115
8991,1/15/2012,1,1,1,11,0,0,0,1,0.16,0.1515,0.47,0.2239,21,144,165,144
8992,1/15/2012,1,1,1,12,0,0,0,1,0.18,0.1667,0.4,0.2985,42,192,234,192
8993,1/15/2012,1,1,1,13,0,0,0,1,0.2,0.1818,0.34,0.2836,40,184,224,184
8994,1/15/2012,1,1,1,14,0,0,0,1,0.2,0.1818,0.32,0.3582,25,163,188,163
8995,1/15/2012,1,1,1,15,0,0,0,1,0.22,0.2273,0.27,0.194,33,173,206,173
8996,1/15/2012,1,1,1,16,0,0,0,1,0.22,0.2121,0.29,0.2985,31,174,205,174
8997,1/15/2012,1,1,1,17,0,0,0,1,0.22,0.2121,0.25,0.2537,15,131,146,131
8998,1/15/2012,1,1,1,18,0,0,0,1,0.18,0.1818,0.29,0.2239,7,113,120,113
8999,1/15/2012,1,1,1,19,0,0,0,1,0.16,0.1667,0.37,0.1642,9,101,110,101
9000,1/15/2012,1,1,1,20,0,0,0,1,0.16,0.1818,0.37,0.1045,10,85,95,85
9001,1/15/2012,1,1,1,21,0,0,0,1,0.16,0.1667,0.4,0.1642,1,71,72,71
9002,1/15/2012,1,1,1,22,0,0,0,1,0.18,0.2121,0.37,0.0896,2,58,60,58
9003,1/15/2012,1,1,1,23,0,0,0,1,0.16,0.197,0.43,0.0896,3,26,29,26
9004,1/16/2012,1,1,1,0,1,1,0,1,0.14,0.1515,0.46,0.1343,2,23,25,23
9005,1/16/2012,1,1,1,1,1,1,0,1,0.14,0.1667,0.43,0.1045,2,18,20,18
9006,1/16/2012,1,1,1,2,1,1,0,1,0.14,0.2121,0.46,0,3,14,17,14
9007,1/16/2012,1,1,1,3,1,1,0,1,0.12,0.197,0.5,0,0,3,3,3
9008,1/16/2012,1,1,1,4,1,1,0,1,0.12,0.1515,0.58,0.1045,2,6,8,6
9009,1/16/2012,1,1,1,5,1,1,0,1,0.12,0.1667,0.54,0.0896,1,5,6,5
9010,1/16/2012,1,1,1,6,1,1,0,1,0.1,0.1364,0.54,0.0896,0,13,13,13
9011,1/16/2012,1,1,1,7,1,1,0,1,0.1,0.1364,0.54,0.1045,5,28,33,28
9012,1/16/2012,1,1,1,8,1,1,0,1,0.1,0.1212,0.58,0.1642,3,75,78,75
9013,1/16/2012,1,1,1,9,1,1,0,1,0.1,0.1212,0.58,0.1642,7,89,96,89
9014,1/16/2012,1,1,1,10,1,1,0,2,0.14,0.1364,0.59,0.194,19,107,126,107
9015,1/16/2012,1,1,1,11,1,1,0,1,0.16,0.1515,0.59,0.2537,21,158,179,158
9016,1/16/2012,1,1,1,12,1,1,0,1,0.2,0.1818,0.55,0.3284,20,165,185,165
9017,1/16/2012,1,1,1,13,1,1,0,2,0.24,0.197,0.41,0.4179,26,202,228,202
9018,1/16/2012,1,1,1,14,1,1,0,1,0.24,0.2121,0.44,0.3881,23,158,181,158
9019,1/16/2012,1,1,1,15,1,1,0,1,0.26,0.2121,0.44,0.4478,17,175,192,175
9020,1/16/2012,1,1,1,16,1,1,0,1,0.26,0.2273,0.44,0.3582,22,158,180,158
9021,1/16/2012,1,1,1,17,1,1,0,1,0.26,0.2273,0.48,0.3284,19,174,193,174
9022,1/16/2012,1,1,1,18,1,1,0,1,0.26,0.2273,0.52,0.3284,6,175,181,175
9023,1/16/2012,1,1,1,19,1,1,0,1,0.26,0.2424,0.56,0.2836,10,134,144,134
9024,1/16/2012,1,1,1,20,1,1,0,1,0.26,0.2424,0.6,0.2836,2,88,90,88
9025,1/16/2012,1,1,1,21,1,1,0,1,0.28,0.2576,0.52,0.3284,3,46,49,46
9026,1/16/2012,1,1,1,22,1,1,0,2,0.3,0.2727,0.49,0.3582,4,39,43,39
9027,1/16/2012,1,1,1,23,1,1,0,3,0.26,0.2273,0.7,0.2985,0,28,28,28
9028,1/17/2012,1,1,1,0,0,2,1,2,0.26,0.2273,0.7,0.3284,0,12,12,12
9029,1/17/2012,1,1,1,1,0,2,1,2,0.28,0.2576,0.65,0.3582,0,2,2,2
9030,1/17/2012,1,1,1,2,0,2,1,3,0.28,0.2727,0.75,0.2537,0,12,12,12
9031,1/17/2012,1,1,1,4,0,2,1,3,0.32,0.303,0.66,0.3284,0,2,2,2
9032,1/17/2012,1,1,1,5,0,2,1,3,0.32,0.303,0.66,0.3284,0,13,13,13
9033,1/17/2012,1,1,1,6,0,2,1,3,0.3,0.2879,0.75,0.2537,0,57,57,57
9034,1/17/2012,1,1,1,7,0,2,1,3,0.3,0.2879,0.81,0.2239,5,121,126,121
9035,1/17/2012,1,1,1,8,0,2,1,3,0.3,0.2879,0.81,0.2836,3,90,93,90
9036,1/17/2012,1,1,1,9,0,2,1,3,0.32,0.303,0.81,0.2537,7,61,68,61
9037,1/17/2012,1,1,1,10,0,2,1,3,0.3,0.2879,0.87,0.2537,1,61,62,61
9038,1/17/2012,1,1,1,11,0,2,1,2,0.34,0.3485,0.87,0.1045,2,73,75,73
9039,1/17/2012,1,1,1,12,0,2,1,2,0.32,0.303,0.87,0.2836,3,83,86,83
9040,1/17/2012,1,1,1,13,0,2,1,2,0.38,0.3939,0.76,0.3284,8,95,103,95
9041,1/17/2012,1,1,1,14,0,2,1,1,0.44,0.4394,0.62,0.4925,12,120,132,120
9042,1/17/2012,1,1,1,15,0,2,1,1,0.44,0.4394,0.62,0.4925,6,123,129,123
9043,1/17/2012,1,1,1,16,0,2,1,1,0.46,0.4545,0.63,0.5522,14,205,219,205
9044,1/17/2012,1,1,1,17,0,2,1,1,0.46,0.4545,0.63,0.4478,20,442,462,442
9045,1/17/2012,1,1,1,18,0,2,1,1,0.46,0.4545,0.63,0.4478,12,451,463,451
9046,1/17/2012,1,1,1,19,0,2,1,1,0.46,0.4545,0.63,0.4179,11,297,308,297
9047,1/17/2012,1,1,1,20,0,2,1,1,0.46,0.4545,0.63,0.3582,11,169,180,169
9048,1/17/2012,1,1,1,21,0,2,1,1,0.46,0.4545,0.67,0.4627,6,174,180,174
9049,1/17/2012,1,1,1,22,0,2,1,1,0.46,0.4545,0.72,0.3881,5,85,90,85
9050,1/17/2012,1,1,1,23,0,2,1,1,0.46,0.4545,0.72,0.3881,1,60,61,60
9051,1/18/2012,1,1,1,0,0,3,1,2,0.46,0.4545,0.77,0.3284,3,14,17,14
9052,1/18/2012,1,1,1,1,0,3,1,2,0.46,0.4545,0.77,0.3284,0,10,10,10
9053,1/18/2012,1,1,1,2,0,3,1,2,0.44,0.4394,0.51,0.4925,1,1,2,1
9054,1/18/2012,1,1,1,3,0,3,1,2,0.44,0.4394,0.51,0.4925,1,3,4,3
9055,1/18/2012,1,1,1,4,0,3,1,1,0.34,0.2879,0.46,0.5224,0,1,1,1
9056,1/18/2012,1,1,1,5,0,3,1,1,0.34,0.2879,0.46,0.5224,0,29,29,29
9057,1/18/2012,1,1,1,6,0,3,1,1,0.34,0.2879,0.36,0.5224,0,88,88,88
9058,1/18/2012,1,1,1,7,0,3,1,1,0.32,0.2879,0.42,0.3582,1,262,263,262
9059,1/18/2012,1,1,1,8,0,3,1,1,0.3,0.2727,0.52,0.4179,15,474,489,474
9060,1/18/2012,1,1,1,9,0,3,1,1,0.28,0.2576,0.52,0.3284,6,196,202,196
9061,1/18/2012,1,1,1,10,0,3,1,1,0.3,0.2727,0.42,0.4627,5,88,93,88
9062,1/18/2012,1,1,1,11,0,3,1,1,0.3,0.2727,0.42,0.3881,4,110,114,110
9063,1/18/2012,1,1,1,12,0,3,1,1,0.3,0.2576,0.39,0.4925,6,155,161,155
9064,1/18/2012,1,1,1,13,0,3,1,1,0.3,0.2727,0.42,0.4627,6,124,130,124
9065,1/18/2012,1,1,1,14,0,3,1,1,0.3,0.2727,0.33,0.3881,7,98,105,98
9066,1/18/2012,1,1,1,15,0,3,1,1,0.3,0.2576,0.33,0.5224,8,122,130,122
9067,1/18/2012,1,1,1,16,0,3,1,1,0.28,0.2273,0.3,0.5224,13,163,176,163
9068,1/18/2012,1,1,1,17,0,3,1,1,0.26,0.2121,0.33,0.4478,8,338,346,338
9069,1/18/2012,1,1,1,18,0,3,1,1,0.24,0.2121,0.32,0.3582,8,347,355,347
9070,1/18/2012,1,1,1,19,0,3,1,1,0.22,0.197,0.37,0.3881,5,251,256,251
9071,1/18/2012,1,1,1,20,0,3,1,1,0.22,0.2121,0.37,0.2537,1,164,165,164
9072,1/18/2012,1,1,1,21,0,3,1,1,0.2,0.1667,0.4,0.4179,5,119,124,119
9073,1/18/2012,1,1,1,22,0,3,1,1,0.18,0.1667,0.47,0.2537,4,74,78,74
9074,1/18/2012,1,1,1,23,0,3,1,1,0.16,0.1364,0.47,0.2985,2,36,38,36
9075,1/19/2012,1,1,1,0,0,4,1,1,0.14,0.1364,0.5,0.194,0,16,16,16
9076,1/19/2012,1,1,1,1,0,4,1,1,0.14,0.1515,0.5,0.1642,0,5,5,5
9077,1/19/2012,1,1,1,2,0,4,1,1,0.14,0.1515,0.5,0.1343,0,3,3,3
9078,1/19/2012,1,1,1,3,0,4,1,1,0.12,0.1515,0.54,0.1045,0,4,4,4
9079,1/19/2012,1,1,1,4,0,4,1,1,0.12,0.1515,0.54,0.1045,0,1,1,1
9080,1/19/2012,1,1,1,5,0,4,1,1,0.12,0.1212,0.55,0.2537,0,19,19,19
9081,1/19/2012,1,1,1,6,0,4,1,1,0.12,0.1364,0.54,0.1642,0,86,86,86
9082,1/19/2012,1,1,1,7,0,4,1,1,0.12,0.1667,0.54,0.0896,2,204,206,204
9083,1/19/2012,1,1,1,8,0,4,1,1,0.12,0.1515,0.54,0.1045,9,414,423,414
9084,1/19/2012,1,1,1,9,0,4,1,1,0.12,0.197,0.54,0,6,204,210,204
9085,1/19/2012,1,1,1,10,0,4,1,1,0.14,0.2121,0.59,0,10,98,108,98
9086,1/19/2012,1,1,1,11,0,4,1,1,0.16,0.1667,0.55,0.1642,6,93,99,93
9087,1/19/2012,1,1,1,12,0,4,1,1,0.2,0.197,0.51,0.194,5,106,111,106
9088,1/19/2012,1,1,1,13,0,4,1,1,0.22,0.2121,0.47,0.2836,6,118,124,118
9089,1/19/2012,1,1,1,14,0,4,1,1,0.24,0.2273,0.44,0.194,15,104,119,104
9090,1/19/2012,1,1,1,15,0,4,1,1,0.26,0.2273,0.44,0.2985,9,118,127,118
9091,1/19/2012,1,1,1,16,0,4,1,1,0.26,0.2273,0.41,0.3284,8,185,193,185
9092,1/19/2012,1,1,1,17,0,4,1,2,0.26,0.2273,0.44,0.3284,21,364,385,364
9093,1/19/2012,1,1,1,18,0,4,1,2,0.26,0.2273,0.44,0.3284,16,345,361,345
9094,1/19/2012,1,1,1,19,0,4,1,2,0.26,0.2273,0.48,0.2985,5,229,234,229
9095,1/19/2012,1,1,1,20,0,4,1,1,0.26,0.2121,0.52,0.4478,7,184,191,184
9096,1/19/2012,1,1,1,21,0,4,1,1,0.26,0.2273,0.44,0.3582,4,117,121,117
9097,1/19/2012,1,1,1,22,0,4,1,2,0.26,0.2273,0.44,0.4179,0,90,90,90
9098,1/19/2012,1,1,1,23,0,4,1,1,0.26,0.2273,0.48,0.3284,1,55,56,55
9099,1/20/2012,1,1,1,0,0,5,1,2,0.26,0.2273,0.48,0.2985,3,24,27,24
9100,1/20/2012,1,1,1,1,0,5,1,1,0.26,0.2727,0.48,0.1343,0,15,15,15
9101,1/20/2012,1,1,1,2,0,5,1,1,0.26,0.2727,0.48,0.1343,0,11,11,11
9102,1/20/2012,1,1,1,3,0,5,1,1,0.24,0.2576,0.52,0.1045,0,4,4,4
9103,1/20/2012,1,1,1,4,0,5,1,1,0.22,0.2424,0.6,0.1045,0,3,3,3
9104,1/20/2012,1,1,1,5,0,5,1,1,0.22,0.2424,0.6,0.1045,0,19,19,19
9105,1/20/2012,1,1,1,6,0,5,1,1,0.24,0.2121,0.6,0.2836,0,68,68,68
9106,1/20/2012,1,1,1,7,0,5,1,1,0.22,0.2121,0.69,0.2239,2,183,185,183
9107,1/20/2012,1,1,1,8,0,5,1,1,0.22,0.2121,0.64,0.2537,4,421,425,421
9108,1/20/2012,1,1,1,9,0,5,1,1,0.22,0.197,0.47,0.3881,21,242,263,242
9109,1/20/2012,1,1,1,10,0,5,1,2,0.22,0.2121,0.44,0.2836,1,96,97,96
9110,1/20/2012,1,1,1,11,0,5,1,2,0.2,0.1818,0.32,0.3582,6,117,123,117
9111,1/20/2012,1,1,1,12,0,5,1,2,0.2,0.1818,0.34,0.3284,5,119,124,119
9112,1/20/2012,1,1,1,13,0,5,1,1,0.22,0.2121,0.32,0.2985,12,144,156,144
9113,1/20/2012,1,1,1,14,0,5,1,2,0.22,0.2121,0.35,0.2985,8,107,115,107
9114,1/20/2012,1,1,1,15,0,5,1,2,0.22,0.2273,0.35,0.194,12,144,156,144
9115,1/20/2012,1,1,1,16,0,5,1,2,0.2,0.2121,0.37,0.1642,11,163,174,163
9116,1/20/2012,1,1,1,17,0,5,1,2,0.22,0.2576,0.32,0.0896,9,340,349,340
9117,1/20/2012,1,1,1,18,0,5,1,2,0.2,0.2273,0.34,0.0896,5,296,301,296
9118,1/20/2012,1,1,1,19,0,5,1,2,0.2,0.2273,0.37,0.1045,6,186,192,186
9119,1/20/2012,1,1,1,20,0,5,1,2,0.2,0.2273,0.34,0.0896,1,141,142,141
9120,1/20/2012,1,1,1,21,0,5,1,2,0.2,0.2273,0.37,0.0896,5,99,104,99
9121,1/20/2012,1,1,1,22,0,5,1,2,0.2,0.197,0.37,0.2239,1,71,72,71
9122,1/20/2012,1,1,1,23,0,5,1,3,0.16,0.1515,0.64,0.2239,3,35,38,35
9123,1/21/2012,1,1,1,0,0,6,0,3,0.16,0.1515,0.64,0.2239,0,24,24,24
9124,1/21/2012,1,1,1,1,0,6,0,4,0.14,0.1364,0.86,0.194,1,22,23,22
9125,1/21/2012,1,1,1,2,0,6,0,3,0.14,0.2121,0.86,0,1,25,26,25
9126,1/21/2012,1,1,1,3,0,6,0,3,0.14,0.1818,0.93,0.0896,0,13,13,13
9127,1/21/2012,1,1,1,4,0,6,0,3,0.16,0.197,0.86,0.0896,0,1,1,1
9128,1/21/2012,1,1,1,5,0,6,0,3,0.16,0.1818,0.86,0.1045,0,2,2,2
9129,1/21/2012,1,1,1,6,0,6,0,3,0.16,0.1667,0.93,0.1642,0,1,1,1
9130,1/21/2012,1,1,1,7,0,6,0,3,0.16,0.1667,0.93,0.1642,3,10,13,10
9131,1/21/2012,1,1,1,8,0,6,0,2,0.16,0.1515,0.93,0.2537,3,22,25,22
9132,1/21/2012,1,1,1,9,0,6,0,2,0.16,0.1515,0.93,0.2537,2,40,42,40
9133,1/21/2012,1,1,1,10,0,6,0,3,0.16,0.1515,0.93,0.2537,0,45,45,45
9134,1/21/2012,1,1,1,11,0,6,0,2,0.18,0.2121,0.86,0.1045,1,62,63,62
9135,1/21/2012,1,1,1,12,0,6,0,2,0.2,0.2121,0.8,0.1642,5,62,67,62
9136,1/21/2012,1,1,1,13,0,6,0,2,0.2,0.197,0.8,0.2537,10,66,76,66
9137,1/21/2012,1,1,1,14,0,6,0,3,0.2,0.197,0.8,0.194,6,89,95,89
9138,1/21/2012,1,1,1,15,0,6,0,3,0.2,0.197,0.8,0.194,6,113,119,113
9139,1/21/2012,1,1,1,16,0,6,0,2,0.2,0.1818,0.8,0.2985,5,113,118,113
9140,1/21/2012,1,1,1,17,0,6,0,2,0.2,0.1818,0.8,0.3881,7,99,106,99
9141,1/21/2012,1,1,1,18,0,6,0,2,0.2,0.1818,0.75,0.3881,3,107,110,107
9142,1/21/2012,1,1,1,19,0,6,0,2,0.18,0.1515,0.8,0.3881,0,85,85,85
9143,1/21/2012,1,1,1,20,0,6,0,2,0.18,0.1667,0.8,0.2985,5,62,67,62
9144,1/21/2012,1,1,1,21,0,6,0,1,0.18,0.1515,0.74,0.3284,5,64,69,64
9145,1/21/2012,1,1,1,22,0,6,0,2,0.18,0.1667,0.74,0.2985,3,56,59,56
9146,1/21/2012,1,1,1,23,0,6,0,2,0.16,0.1515,0.8,0.2537,1,51,52,51
9147,1/22/2012,1,1,1,0,0,0,0,1,0.16,0.1364,0.8,0.2985,1,51,52,51
9148,1/22/2012,1,1,1,1,0,0,0,2,0.18,0.1667,0.74,0.2985,1,49,50,49
9149,1/22/2012,1,1,1,2,0,0,0,2,0.18,0.1667,0.74,0.2836,1,46,47,46
9150,1/22/2012,1,1,1,3,0,0,0,2,0.18,0.1667,0.69,0.2836,1,20,21,20
9151,1/22/2012,1,1,1,4,0,0,0,3,0.16,0.1364,0.8,0.2836,1,1,2,1
9152,1/22/2012,1,1,1,5,0,0,0,3,0.16,0.1515,0.74,0.2239,1,2,3,2
9153,1/22/2012,1,1,1,6,0,0,0,2,0.16,0.1515,0.74,0.2239,0,4,4,4
9154,1/22/2012,1,1,1,7,0,0,0,2,0.16,0.1515,0.74,0.2239,2,11,13,11
9155,1/22/2012,1,1,1,8,0,0,0,2,0.16,0.1515,0.74,0.2239,3,29,32,29
9156,1/22/2012,1,1,1,9,0,0,0,2,0.16,0.1515,0.74,0.2239,9,54,63,54
9157,1/22/2012,1,1,1,10,0,0,0,2,0.16,0.1364,0.74,0.2836,9,120,129,120
9158,1/22/2012,1,1,1,11,0,0,0,3,0.16,0.1515,0.8,0.2537,18,115,133,115
9159,1/22/2012,1,1,1,12,0,0,0,2,0.16,0.1515,0.8,0.2239,24,161,185,161
9160,1/22/2012,1,1,1,13,0,0,0,2,0.16,0.1818,0.8,0.1343,24,175,199,175
9161,1/22/2012,1,1,1,14,0,0,0,2,0.16,0.1667,0.8,0.1642,19,163,182,163
9162,1/22/2012,1,1,1,15,0,0,0,2,0.16,0.1515,0.8,0.194,27,149,176,149
9163,1/22/2012,1,1,1,16,0,0,0,2,0.16,0.1515,0.8,0.194,12,143,155,143
9164,1/22/2012,1,1,1,17,0,0,0,2,0.16,0.1818,0.8,0.1045,8,100,108,100
9165,1/22/2012,1,1,1,18,0,0,0,3,0.16,0.1818,0.86,0.1045,11,110,121,110
9166,1/22/2012,1,1,1,19,0,0,0,3,0.16,0.1818,0.86,0.1045,9,80,89,80
9167,1/22/2012,1,1,1,20,0,0,0,3,0.16,0.1667,0.86,0.1642,5,69,74,69
9168,1/22/2012,1,1,1,21,0,0,0,3,0.16,0.1818,0.86,0.1045,8,36,44,36
9169,1/22/2012,1,1,1,22,0,0,0,2,0.16,0.197,0.93,0.0896,0,58,58,58
9170,1/22/2012,1,1,1,23,0,0,0,2,0.16,0.1818,0.93,0.1045,2,35,37,35
9171,1/23/2012,1,1,1,0,0,1,1,2,0.18,0.2424,0.86,0,2,17,19,17
9172,1/23/2012,1,1,1,1,0,1,1,2,0.18,0.2121,0.86,0.1045,0,4,4,4
9173,1/23/2012,1,1,1,2,0,1,1,2,0.18,0.2121,0.86,0.1045,0,2,2,2
9174,1/23/2012,1,1,1,3,0,1,1,2,0.18,0.2424,0.86,0,0,1,1,1
9175,1/23/2012,1,1,1,4,0,1,1,2,0.2,0.2576,0.8,0,0,1,1,1
9176,1/23/2012,1,1,1,5,0,1,1,2,0.2,0.2576,0.86,0,0,19,19,19
9177,1/23/2012,1,1,1,6,0,1,1,2,0.2,0.2576,0.86,0,6,36,42,36
9178,1/23/2012,1,1,1,7,0,1,1,3,0.2,0.2576,0.86,0,8,114,122,114
9179,1/23/2012,1,1,1,8,0,1,1,3,0.2,0.2121,0.86,0.1343,5,267,272,267
9180,1/23/2012,1,1,1,9,0,1,1,2,0.2,0.2273,0.86,0.0896,13,198,211,198
9181,1/23/2012,1,1,1,10,0,1,1,2,0.2,0.2576,0.93,0,10,139,149,139
9182,1/23/2012,1,1,1,11,0,1,1,2,0.2,0.2273,0.93,0.0896,5,57,62,57
9183,1/23/2012,1,1,1,12,0,1,1,2,0.22,0.2727,0.93,0,10,52,62,52
9184,1/23/2012,1,1,1,13,0,1,1,3,0.22,0.2576,0.93,0.0896,5,32,37,32
9185,1/23/2012,1,1,1,14,0,1,1,3,0.22,0.2273,0.93,0.194,13,48,61,48
9186,1/23/2012,1,1,1,15,0,1,1,2,0.22,0.2121,1,0.2239,10,64,74,64
9187,1/23/2012,1,1,1,16,0,1,1,2,0.24,0.2424,0.93,0.1642,14,108,122,108
9188,1/23/2012,1,1,1,17,0,1,1,2,0.24,0.2576,0.96,0.1045,6,270,276,270
9189,1/23/2012,1,1,1,18,0,1,1,2,0.24,0.2424,0.93,0.1343,7,275,282,275
9190,1/23/2012,1,1,1,19,0,1,1,2,0.26,0.2576,0.93,0.1642,9,211,220,211
9191,1/23/2012,1,1,1,20,0,1,1,2,0.26,0.2576,1,0.1642,8,161,169,161
9192,1/23/2012,1,1,1,21,0,1,1,2,0.26,0.2424,1,0.2836,8,112,120,112
9193,1/23/2012,1,1,1,22,0,1,1,2,0.26,0.2424,1,0.2836,4,64,68,64
9194,1/23/2012,1,1,1,23,0,1,1,2,0.28,0.2576,0.93,0.3284,2,35,37,35
9195,1/24/2012,1,1,1,0,0,2,1,2,0.3,0.2879,1,0.2836,6,19,25,19
9196,1/24/2012,1,1,1,1,0,2,1,2,0.32,0.303,0.93,0.2537,2,7,9,7
9197,1/24/2012,1,1,1,2,0,2,1,2,0.32,0.303,0.93,0.2239,2,6,8,6
9198,1/24/2012,1,1,1,3,0,2,1,2,0.32,0.3333,0.93,0.1343,0,3,3,3
9199,1/24/2012,1,1,1,4,0,2,1,2,0.3,0.3182,1,0.0896,0,2,2,2
9200,1/24/2012,1,1,1,5,0,2,1,2,0.3,0.3182,1,0.0896,0,26,26,26
9201,1/24/2012,1,1,1,6,0,2,1,2,0.32,0.3182,0.93,0.194,1,88,89,88
9202,1/24/2012,1,1,1,7,0,2,1,2,0.32,0.3333,0.93,0.1343,11,221,232,221
9203,1/24/2012,1,1,1,8,0,2,1,2,0.32,0.3333,0.93,0.1343,11,479,490,479
9204,1/24/2012,1,1,1,9,0,2,1,2,0.32,0.3333,0.87,0.0896,11,244,255,244
9205,1/24/2012,1,1,1,10,0,2,1,1,0.32,0.3333,0.93,0.0896,23,93,116,93
9206,1/24/2012,1,1,1,11,0,2,1,1,0.34,0.3333,0.87,0.1343,30,123,153,123
9207,1/24/2012,1,1,1,12,0,2,1,1,0.34,0.3333,0.87,0.1642,25,150,175,150
9208,1/24/2012,1,1,1,13,0,2,1,1,0.34,0.3333,0.87,0.1642,33,170,203,170
9209,1/24/2012,1,1,1,14,0,2,1,1,0.36,0.3485,0.81,0.2239,35,138,173,138
9210,1/24/2012,1,1,1,15,0,2,1,2,0.4,0.4091,0.71,0.1642,52,156,208,156
9211,1/24/2012,1,1,1,16,0,2,1,1,0.4,0.4091,0.71,0.1343,35,243,278,243
9212,1/24/2012,1,1,1,17,0,2,1,1,0.42,0.4242,0.67,0.0896,41,474,515,474
9213,1/24/2012,1,1,1,18,0,2,1,1,0.4,0.4091,0.62,0.0896,32,391,423,391
9214,1/24/2012,1,1,1,19,0,2,1,1,0.44,0.4394,0.51,0.0896,20,311,331,311
9215,1/24/2012,1,1,1,20,0,2,1,1,0.32,0.3485,0.76,0,18,211,229,211
9216,1/24/2012,1,1,1,21,0,2,1,1,0.36,0.3788,0.71,0,18,154,172,154
9217,1/24/2012,1,1,1,22,0,2,1,1,0.32,0.3485,0.81,0,14,111,125,111
9218,1/24/2012,1,1,1,23,0,2,1,1,0.32,0.3485,0.76,0,19,80,99,80
9219,1/25/2012,1,1,1,0,0,3,1,1,0.26,0.303,0.93,0,6,25,31,25
9220,1/25/2012,1,1,1,1,0,3,1,1,0.3,0.2879,0.7,0.2239,4,9,13,9
9221,1/25/2012,1,1,1,2,0,3,1,1,0.28,0.2727,0.7,0.194,3,3,6,3
9222,1/25/2012,1,1,1,3,0,3,1,1,0.26,0.2576,0.75,0.194,0,1,1,1
9223,1/25/2012,1,1,1,4,0,3,1,1,0.26,0.2424,0.7,0.2836,0,4,4,4
9224,1/25/2012,1,1,1,5,0,3,1,1,0.26,0.2424,0.7,0.2836,0,33,33,33
9225,1/25/2012,1,1,1,6,0,3,1,1,0.24,0.2273,0.73,0.2239,1,87,88,87
9226,1/25/2012,1,1,1,7,0,3,1,1,0.24,0.2273,0.75,0.2239,14,243,257,243
9227,1/25/2012,1,1,1,8,0,3,1,1,0.24,0.2273,0.7,0.2537,18,495,513,495
9228,1/25/2012,1,1,1,9,0,3,1,1,0.24,0.2273,0.7,0.2537,18,218,236,218
9229,1/25/2012,1,1,1,10,0,3,1,2,0.26,0.2273,0.7,0.3284,30,111,141,111
9230,1/25/2012,1,1,1,11,0,3,1,2,0.3,0.2727,0.61,0.2985,52,105,157,105
9231,1/25/2012,1,1,1,12,0,3,1,1,0.32,0.3333,0.53,0.1343,46,147,193,147
9232,1/25/2012,1,1,1,13,0,3,1,1,0.34,0.3333,0.49,0.1343,63,149,212,149
9233,1/25/2012,1,1,1,14,0,3,1,1,0.34,0.3485,0.49,0.0896,53,107,160,107
9234,1/25/2012,1,1,1,15,0,3,1,1,0.36,0.3788,0.46,0,30,125,155,125
9235,1/25/2012,1,1,1,16,0,3,1,1,0.34,0.3333,0.53,0.1642,29,217,246,217
9236,1/25/2012,1,1,1,17,0,3,1,1,0.36,0.3485,0.53,0.1642,27,443,470,443
9237,1/25/2012,1,1,1,18,0,3,1,1,0.32,0.3333,0.66,0.1343,24,415,439,415
9238,1/25/2012,1,1,1,19,0,3,1,2,0.34,0.3636,0.53,0,5,311,316,311
9239,1/25/2012,1,1,1,20,0,3,1,1,0.32,0.3182,0.61,0.194,10,225,235,225
9240,1/25/2012,1,1,1,21,0,3,1,1,0.3,0.3333,0.65,0,19,166,185,166
9241,1/25/2012,1,1,1,22,0,3,1,1,0.3,0.3182,0.65,0.0896,12,101,113,101
9242,1/25/2012,1,1,1,23,0,3,1,2,0.28,0.3182,0.65,0,3,63,66,63
9243,1/26/2012,1,1,1,0,0,4,1,2,0.28,0.2879,0.75,0.1045,3,22,25,22
9244,1/26/2012,1,1,1,1,0,4,1,2,0.28,0.3182,0.75,0,5,16,21,16
9245,1/26/2012,1,1,1,2,0,4,1,2,0.28,0.2727,0.75,0.1642,1,6,7,6
9246,1/26/2012,1,1,1,3,0,4,1,2,0.28,0.303,0.75,0.0896,1,5,6,5
9247,1/26/2012,1,1,1,4,0,4,1,1,0.28,0.3182,0.75,0,0,3,3,3
9248,1/26/2012,1,1,1,5,0,4,1,2,0.3,0.3182,0.75,0.1045,0,28,28,28
9249,1/26/2012,1,1,1,6,0,4,1,2,0.28,0.3182,0.81,0,0,88,88,88
9250,1/26/2012,1,1,1,7,0,4,1,2,0.28,0.303,0.81,0.0896,11,228,239,228
9251,1/26/2012,1,1,1,8,0,4,1,2,0.28,0.303,0.81,0.0896,16,514,530,514
9252,1/26/2012,1,1,1,9,0,4,1,2,0.3,0.3333,0.81,0,18,256,274,256
9253,1/26/2012,1,1,1,10,0,4,1,2,0.3,0.303,0.81,0.1343,16,92,108,92
9254,1/26/2012,1,1,1,11,0,4,1,2,0.3,0.3182,0.87,0.1045,11,100,111,100
9255,1/26/2012,1,1,1,12,0,4,1,2,0.34,0.3333,0.81,0.1343,29,136,165,136
9256,1/26/2012,1,1,1,13,0,4,1,2,0.38,0.3939,0.71,0,17,156,173,156
9257,1/26/2012,1,1,1,14,0,4,1,2,0.4,0.4091,0.71,0.1045,16,112,128,112
9258,1/26/2012,1,1,1,15,0,4,1,2,0.42,0.4242,0.71,0.1045,22,142,164,142
9259,1/26/2012,1,1,1,16,0,4,1,2,0.4,0.4091,0.71,0.0896,15,209,224,209
9260,1/26/2012,1,1,1,17,0,4,1,2,0.42,0.4242,0.71,0,16,397,413,397
9261,1/26/2012,1,1,1,18,0,4,1,2,0.42,0.4242,0.71,0,12,394,406,394
9262,1/26/2012,1,1,1,19,0,4,1,2,0.4,0.4091,0.76,0.1045,11,302,313,302
9263,1/26/2012,1,1,1,20,0,4,1,2,0.4,0.4091,0.82,0.1343,8,216,224,216
9264,1/26/2012,1,1,1,21,0,4,1,2,0.4,0.4091,0.76,0.1045,8,184,192,184
9265,1/26/2012,1,1,1,22,0,4,1,1,0.38,0.3939,0.82,0.1045,3,139,142,139
9266,1/26/2012,1,1,1,23,0,4,1,2,0.4,0.4091,0.82,0,5,86,91,86
9267,1/27/2012,1,1,1,0,0,5,1,2,0.4,0.4091,0.82,0.2537,6,32,38,32
9268,1/27/2012,1,1,1,1,0,5,1,2,0.4,0.4091,0.87,0.2239,6,23,29,23
9269,1/27/2012,1,1,1,2,0,5,1,1,0.42,0.4242,0.94,0.1343,2,11,13,11
9270,1/27/2012,1,1,1,3,0,5,1,2,0.42,0.4242,0.94,0.2836,3,5,8,5
9271,1/27/2012,1,1,1,4,0,5,1,2,0.4,0.4091,1,0.2985,1,3,4,3
9272,1/27/2012,1,1,1,5,0,5,1,2,0.42,0.4242,0.94,0.3284,0,24,24,24
9273,1/27/2012,1,1,1,6,0,5,1,2,0.42,0.4242,1,0.3284,0,72,72,72
9274,1/27/2012,1,1,1,7,0,5,1,2,0.42,0.4242,1,0.2985,6,128,134,128
9275,1/27/2012,1,1,1,8,0,5,1,3,0.5,0.4848,0.88,0.2836,14,206,220,206
9276,1/27/2012,1,1,1,9,0,5,1,3,0.5,0.4848,0.88,0.2836,6,101,107,101
9277,1/27/2012,1,1,1,10,0,5,1,3,0.48,0.4697,1,0.1642,9,117,126,117
9278,1/27/2012,1,1,1,11,0,5,1,2,0.48,0.4697,0.94,0.1343,10,95,105,95
9279,1/27/2012,1,1,1,12,0,5,1,2,0.5,0.4848,0.88,0.1642,25,155,180,155
9280,1/27/2012,1,1,1,13,0,5,1,1,0.5,0.4848,0.59,0.4627,26,175,201,175
9281,1/27/2012,1,1,1,14,0,5,1,1,0.5,0.4848,0.55,0.5522,23,153,176,153
9282,1/27/2012,1,1,1,15,0,5,1,1,0.48,0.4697,0.51,0.3284,27,170,197,170
9283,1/27/2012,1,1,1,16,0,5,1,1,0.44,0.4394,0.51,0.5522,26,241,267,241
9284,1/27/2012,1,1,1,17,0,5,1,1,0.42,0.4242,0.5,0.5821,16,406,422,406
9285,1/27/2012,1,1,1,18,0,5,1,1,0.4,0.4091,0.5,0.4925,20,363,383,363
9286,1/27/2012,1,1,1,19,0,5,1,1,0.36,0.3333,0.5,0.3881,10,241,251,241
9287,1/27/2012,1,1,1,20,0,5,1,1,0.34,0.303,0.53,0.3582,6,153,159,153
9288,1/27/2012,1,1,1,21,0,5,1,1,0.34,0.2879,0.53,0.5224,8,127,135,127
9289,1/27/2012,1,1,1,22,0,5,1,1,0.34,0.303,0.49,0.3881,11,108,119,108
9290,1/27/2012,1,1,1,23,0,5,1,1,0.32,0.2879,0.49,0.4179,8,78,86,78
9291,1/28/2012,1,1,1,0,0,6,0,1,0.3,0.2879,0.52,0.2836,1,68,69,68
9292,1/28/2012,1,1,1,1,0,6,0,1,0.3,0.303,0.52,0.1642,1,57,58,57
9293,1/28/2012,1,1,1,2,0,6,0,1,0.26,0.303,0.6,0,3,38,41,38
9294,1/28/2012,1,1,1,3,0,6,0,1,0.26,0.2879,0.6,0.0896,1,16,17,16
9295,1/28/2012,1,1,1,4,0,6,0,1,0.26,0.2576,0.6,0.1642,0,8,8,8
9296,1/28/2012,1,1,1,5,0,6,0,1,0.24,0.2576,0.75,0.0896,0,10,10,10
9297,1/28/2012,1,1,1,6,0,6,0,1,0.24,0.2879,0.7,0,3,12,15,12
9298,1/28/2012,1,1,1,7,0,6,0,1,0.22,0.2727,0.75,0,3,28,31,28
9299,1/28/2012,1,1,1,8,0,6,0,1,0.2,0.2273,0.8,0.0896,9,82,91,82
9300,1/28/2012,1,1,1,9,0,6,0,1,0.22,0.2727,0.8,0,13,145,158,145
9301,1/28/2012,1,1,1,10,0,6,0,1,0.26,0.2727,0.7,0.1343,27,164,191,164
9302,1/28/2012,1,1,1,11,0,6,0,1,0.3,0.303,0.56,0.1343,55,241,296,241
9303,1/28/2012,1,1,1,12,0,6,0,1,0.3,0.2879,0.61,0.2836,70,244,314,244
9304,1/28/2012,1,1,1,13,0,6,0,1,0.34,0.3182,0.57,0.2537,80,293,373,293
9305,1/28/2012,1,1,1,14,0,6,0,1,0.38,0.3939,0.5,0.3881,123,239,362,239
9306,1/28/2012,1,1,1,15,0,6,0,1,0.4,0.4091,0.47,0.3284,90,320,410,320
9307,1/28/2012,1,1,1,16,0,6,0,1,0.42,0.4242,0.44,0.3582,131,276,407,276
9308,1/28/2012,1,1,1,17,0,6,0,1,0.42,0.4242,0.44,0.3881,57,233,290,233
9309,1/28/2012,1,1,1,18,0,6,0,1,0.42,0.4242,0.41,0.2239,40,201,241,201
9310,1/28/2012,1,1,1,19,0,6,0,2,0.42,0.4242,0.41,0.5522,33,173,206,173
9311,1/28/2012,1,1,1,20,0,6,0,1,0.4,0.4091,0.35,0.3881,5,115,120,115
9312,1/28/2012,1,1,1,21,0,6,0,1,0.36,0.3333,0.29,0.3582,18,109,127,109
9313,1/28/2012,1,1,1,22,0,6,0,1,0.34,0.3333,0.34,0.194,6,97,103,97
9314,1/28/2012,1,1,1,23,0,6,0,1,0.32,0.3182,0.31,0.194,6,79,85,79
9315,1/29/2012,1,1,1,0,0,0,0,1,0.3,0.2879,0.33,0.2239,15,81,96,81
9316,1/29/2012,1,1,1,1,0,0,0,1,0.3,0.2727,0.28,0.3582,5,68,73,68
9317,1/29/2012,1,1,1,2,0,0,0,1,0.28,0.2576,0.26,0.3284,3,48,51,48
9318,1/29/2012,1,1,1,3,0,0,0,1,0.26,0.2576,0.28,0.194,4,17,21,17
9319,1/29/2012,1,1,1,4,0,0,0,1,0.24,0.2576,0.3,0,0,5,5,5
9320,1/29/2012,1,1,1,5,0,0,0,1,0.2,0.2121,0.51,0.1343,1,6,7,6
9321,1/29/2012,1,1,1,6,0,0,0,1,0.2,0.2273,0.4,0.1045,1,4,5,4
9322,1/29/2012,1,1,1,7,0,0,0,1,0.2,0.2121,0.37,0.1343,0,12,12,12
9323,1/29/2012,1,1,1,8,0,0,0,1,0.18,0.197,0.4,0.1343,9,61,70,61
9324,1/29/2012,1,1,1,9,0,0,0,1,0.18,0.197,0.43,0.1343,13,98,111,98
9325,1/29/2012,1,1,1,10,0,0,0,1,0.24,0.2424,0.35,0.1343,38,153,191,153
9326,1/29/2012,1,1,1,11,0,0,0,1,0.28,0.2727,0.28,0.2239,57,198,255,198
9327,1/29/2012,1,1,1,12,0,0,0,1,0.32,0.303,0.26,0.2239,73,215,288,215
9328,1/29/2012,1,1,1,13,0,0,0,1,0.32,0.303,0.26,0.2239,78,238,316,238
9329,1/29/2012,1,1,1,14,0,0,0,1,0.32,0.303,0.26,0.2537,51,229,280,229
9330,1/29/2012,1,1,1,15,0,0,0,1,0.36,0.3333,0.25,0.2836,68,242,310,242
9331,1/29/2012,1,1,1,16,0,0,0,1,0.36,0.3333,0.21,0.4179,54,268,322,268
9332,1/29/2012,1,1,1,17,0,0,0,1,0.36,0.3333,0.21,0.4179,33,201,234,201
9333,1/29/2012,1,1,1,18,0,0,0,1,0.34,0.303,0.23,0.3582,17,151,168,151
9334,1/29/2012,1,1,1,19,0,0,0,1,0.32,0.303,0.29,0.2537,14,145,159,145
9335,1/29/2012,1,1,1,20,0,0,0,1,0.3,0.2879,0.39,0.2239,13,98,111,98
9336,1/29/2012,1,1,1,21,0,0,0,1,0.3,0.2879,0.33,0.2836,0,69,69,69
9337,1/29/2012,1,1,1,22,0,0,0,1,0.32,0.2879,0.26,0.3881,7,57,64,57
9338,1/29/2012,1,1,1,23,0,0,0,1,0.3,0.2727,0.33,0.3284,4,21,25,21
9339,1/30/2012,1,1,1,0,0,1,1,2,0.32,0.2879,0.26,0.4179,0,10,10,10
9340,1/30/2012,1,1,1,1,0,1,1,1,0.26,0.2273,0.6,0.3582,0,9,9,9
9341,1/30/2012,1,1,1,2,0,1,1,1,0.24,0.2121,0.48,0.3582,1,6,7,6
9342,1/30/2012,1,1,1,3,0,1,1,1,0.24,0.2273,0.48,0.194,0,4,4,4
9343,1/30/2012,1,1,1,4,0,1,1,1,0.2,0.2121,0.51,0.1343,0,5,5,5
9344,1/30/2012,1,1,1,5,0,1,1,1,0.2,0.2121,0.51,0.1343,0,26,26,26
9345,1/30/2012,1,1,1,6,0,1,1,1,0.22,0.2121,0.44,0.2537,0,80,80,80
9346,1/30/2012,1,1,1,7,0,1,1,1,0.22,0.2121,0.44,0.2836,4,221,225,221
9347,1/30/2012,1,1,1,8,0,1,1,1,0.2,0.197,0.47,0.2239,12,481,493,481
9348,1/30/2012,1,1,1,9,0,1,1,1,0.2,0.197,0.47,0.2239,5,193,198,193
9349,1/30/2012,1,1,1,10,0,1,1,1,0.22,0.2121,0.41,0.2836,3,82,85,82
9350,1/30/2012,1,1,1,11,0,1,1,1,0.26,0.2576,0.38,0,6,93,99,93
9351,1/30/2012,1,1,1,12,0,1,1,1,0.26,0.2273,0.35,0.3881,5,129,134,129
9352,1/30/2012,1,1,1,13,0,1,1,1,0.3,0.2879,0.31,0.194,15,117,132,117
9353,1/30/2012,1,1,1,14,0,1,1,1,0.32,0.3333,0.24,0.1343,15,100,115,100
9354,1/30/2012,1,1,1,15,0,1,1,1,0.32,0.3182,0.24,0.194,7,131,138,131
9355,1/30/2012,1,1,1,16,0,1,1,1,0.34,0.3333,0.25,0.194,11,210,221,210
9356,1/30/2012,1,1,1,17,0,1,1,1,0.36,0.3485,0.21,0.194,16,422,438,422
9357,1/30/2012,1,1,1,18,0,1,1,1,0.34,0.3333,0.23,0.1642,11,399,410,399
9358,1/30/2012,1,1,1,19,0,1,1,1,0.3,0.3182,0.45,0.1045,8,298,306,298
9359,1/30/2012,1,1,1,20,0,1,1,1,0.3,0.303,0.39,0.1642,2,179,181,179
9360,1/30/2012,1,1,1,21,0,1,1,1,0.3,0.303,0.42,0.1642,3,159,162,159
9361,1/30/2012,1,1,1,22,0,1,1,1,0.28,0.2727,0.48,0.2239,2,92,94,92
9362,1/30/2012,1,1,1,23,0,1,1,1,0.26,0.2576,0.6,0.194,0,52,52,52
9363,1/31/2012,1,1,1,0,0,2,1,1,0.28,0.2727,0.52,0.2537,0,15,15,15
9364,1/31/2012,1,1,1,1,0,2,1,1,0.3,0.2727,0.42,0.2985,1,7,8,7
9365,1/31/2012,1,1,1,2,0,2,1,1,0.3,0.2879,0.42,0.2239,0,2,2,2
9366,1/31/2012,1,1,1,3,0,2,1,1,0.3,0.2879,0.45,0.2239,0,2,2,2
9367,1/31/2012,1,1,1,4,0,2,1,1,0.3,0.2879,0.49,0.194,0,1,1,1
9368,1/31/2012,1,1,1,5,0,2,1,1,0.3,0.2879,0.49,0.194,0,22,22,22
9369,1/31/2012,1,1,1,6,0,2,1,1,0.28,0.2727,0.52,0.1642,0,104,104,104
9370,1/31/2012,1,1,1,7,0,2,1,1,0.26,0.2576,0.6,0.194,6,273,279,273
9371,1/31/2012,1,1,1,8,0,2,1,1,0.26,0.2727,0.6,0.1045,14,498,512,498
9372,1/31/2012,1,1,1,9,0,2,1,1,0.3,0.2879,0.52,0.194,30,231,261,231
9373,1/31/2012,1,1,1,10,0,2,1,2,0.32,0.3182,0.57,0.194,34,110,144,110
9374,1/31/2012,1,1,1,11,0,2,1,1,0.4,0.4091,0.37,0.2836,14,125,139,125
9375,1/31/2012,1,1,1,12,0,2,1,1,0.4,0.4091,0.43,0.2985,13,181,194,181
9376,1/31/2012,1,1,1,13,0,2,1,1,0.46,0.4545,0.36,0.2239,27,171,198,171
9377,1/31/2012,1,1,1,14,0,2,1,1,0.5,0.4848,0.29,0.3284,18,142,160,142
9378,1/31/2012,1,1,1,15,0,2,1,1,0.54,0.5152,0.26,0.4478,27,150,177,150
9379,1/31/2012,1,1,1,16,0,2,1,1,0.54,0.5152,0.26,0.4478,30,277,307,277
9380,1/31/2012,1,1,1,17,0,2,1,1,0.54,0.5152,0.26,0.4179,41,518,559,518
9381,1/31/2012,1,1,1,18,0,2,1,1,0.54,0.5152,0.24,0.3582,16,486,502,486
9382,1/31/2012,1,1,1,19,0,2,1,1,0.5,0.4848,0.29,0.2836,22,306,328,306
9383,1/31/2012,1,1,1,20,0,2,1,1,0.4,0.4091,0.58,0.1045,15,223,238,223
9384,1/31/2012,1,1,1,21,0,2,1,1,0.46,0.4545,0.33,0.2985,3,162,165,162
9385,1/31/2012,1,1,1,22,0,2,1,1,0.44,0.4394,0.35,0.2985,11,118,129,118
9386,1/31/2012,1,1,1,23,0,2,1,1,0.44,0.4394,0.38,0.2537,2,61,63,61
9387,2/1/2012,1,1,2,0,0,3,1,1,0.44,0.4394,0.38,0.2836,0,31,31,31
9388,2/1/2012,1,1,2,1,0,3,1,1,0.44,0.4394,0.41,0.2836,0,4,4,4
9389,2/1/2012,1,1,2,2,0,3,1,1,0.44,0.4394,0.44,0.2836,1,6,7,6
9390,2/1/2012,1,1,2,3,0,3,1,1,0.44,0.4394,0.44,0.194,0,3,3,3
9391,2/1/2012,1,1,2,4,0,3,1,1,0.4,0.4091,0.5,0.1642,0,1,1,1
9392,2/1/2012,1,1,2,5,0,3,1,1,0.4,0.4091,0.5,0.1642,0,18,18,18
9393,2/1/2012,1,1,2,6,0,3,1,3,0.4,0.4091,0.54,0.1642,0,67,67,67
9394,2/1/2012,1,1,2,7,0,3,1,3,0.38,0.3939,0.62,0.0896,7,201,208,201
9395,2/1/2012,1,1,2,8,0,3,1,3,0.36,0.3636,0.73,0.1045,15,505,520,505
9396,2/1/2012,1,1,2,9,0,3,1,2,0.36,0.3485,0.71,0.194,9,267,276,267
9397,2/1/2012,1,1,2,10,0,3,1,1,0.4,0.4091,0.62,0.1343,9,124,133,124
9398,2/1/2012,1,1,2,11,0,3,1,1,0.4,0.4091,0.58,0.1642,27,116,143,116
9399,2/1/2012,1,1,2,12,0,3,1,1,0.44,0.4394,0.54,0.1045,26,153,179,153
9400,2/1/2012,1,1,2,13,0,3,1,1,0.46,0.4545,0.47,0.2239,12,174,186,174
9401,2/1/2012,1,1,2,14,0,3,1,1,0.62,0.6212,0.33,0.2239,33,159,192,159
9402,2/1/2012,1,1,2,15,0,3,1,1,0.6,0.6212,0.35,0.2836,25,169,194,169
9403,2/1/2012,1,1,2,16,0,3,1,1,0.6,0.6212,0.4,0.2239,22,261,283,261
9404,2/1/2012,1,1,2,17,0,3,1,1,0.58,0.5455,0.43,0.194,31,508,539,508
9405,2/1/2012,1,1,2,18,0,3,1,1,0.56,0.5303,0.46,0.1642,12,514,526,514
9406,2/1/2012,1,1,2,19,0,3,1,1,0.54,0.5152,0.52,0.2836,20,315,335,315
9407,2/1/2012,1,1,2,20,0,3,1,1,0.52,0.5,0.52,0.1642,10,254,264,254
9408,2/1/2012,1,1,2,21,0,3,1,1,0.52,0.5,0.52,0.1642,16,217,233,217
9409,2/1/2012,1,1,2,22,0,3,1,1,0.5,0.4848,0.55,0.194,7,133,140,133
9410,2/1/2012,1,1,2,23,0,3,1,1,0.46,0.4545,0.63,0.0896,22,75,97,75
9411,2/2/2012,1,1,2,0,0,4,1,1,0.46,0.4545,0.59,0.1343,7,24,31,24
9412,2/2/2012,1,1,2,1,0,4,1,2,0.46,0.4545,0.55,0,3,14,17,14
9413,2/2/2012,1,1,2,2,0,4,1,2,0.42,0.4242,0.67,0.1343,2,7,9,7
9414,2/2/2012,1,1,2,3,0,4,1,2,0.42,0.4242,0.67,0.1343,0,2,2,2
9415,2/2/2012,1,1,2,4,0,4,1,3,0.4,0.4091,0.82,0.0896,0,1,1,1
9416,2/2/2012,1,1,2,5,0,4,1,3,0.4,0.4091,0.82,0,0,19,19,19
9417,2/2/2012,1,1,2,6,0,4,1,3,0.36,0.3788,0.9,0,1,73,74,73
9418,2/2/2012,1,1,2,7,0,4,1,3,0.36,0.3788,0.93,0,4,201,205,201
9419,2/2/2012,1,1,2,8,0,4,1,3,0.4,0.4091,0.87,0,9,436,445,436
9420,2/2/2012,1,1,2,9,0,4,1,3,0.38,0.3939,0.87,0,15,213,228,213
9421,2/2/2012,1,1,2,10,0,4,1,3,0.42,0.4242,0.77,0.1045,6,72,78,72
9422,2/2/2012,1,1,2,11,0,4,1,3,0.4,0.4091,0.82,0.2537,6,99,105,99
9423,2/2/2012,1,1,2,12,0,4,1,1,0.42,0.4242,0.82,0,8,140,148,140
9424,2/2/2012,1,1,2,13,0,4,1,2,0.42,0.4242,0.77,0,13,124,137,124
9425,2/2/2012,1,1,2,14,0,4,1,1,0.4,0.4091,0.76,0.1045,12,129,141,129
9426,2/2/2012,1,1,2,15,0,4,1,1,0.46,0.4545,0.67,0.1642,24,150,174,150
9427,2/2/2012,1,1,2,16,0,4,1,1,0.46,0.4545,0.55,0.2836,18,211,229,211
9428,2/2/2012,1,1,2,17,0,4,1,1,0.42,0.4242,0.54,0.4925,13,437,450,437
9429,2/2/2012,1,1,2,18,0,4,1,1,0.4,0.4091,0.43,0.4627,17,393,410,393
9430,2/2/2012,1,1,2,19,0,4,1,1,0.38,0.3939,0.43,0.5224,16,311,327,311
9431,2/2/2012,1,1,2,20,0,4,1,1,0.36,0.3182,0.46,0.5224,9,204,213,204
9432,2/2/2012,1,1,2,21,0,4,1,1,0.34,0.303,0.46,0.4179,4,144,148,144
9433,2/2/2012,1,1,2,22,0,4,1,1,0.32,0.2879,0.49,0.4179,3,106,109,106
9434,2/2/2012,1,1,2,23,0,4,1,1,0.32,0.303,0.49,0.2537,0,61,61,61
9435,2/3/2012,1,1,2,0,0,5,1,1,0.32,0.2879,0.53,0.3881,1,37,38,37
9436,2/3/2012,1,1,2,1,0,5,1,1,0.3,0.2727,0.56,0.3284,3,19,22,19
9437,2/3/2012,1,1,2,2,0,5,1,1,0.3,0.2879,0.52,0.2239,0,6,6,6
9438,2/3/2012,1,1,2,3,0,5,1,1,0.28,0.2576,0.56,0.2985,0,4,4,4
9439,2/3/2012,1,1,2,4,0,5,1,1,0.26,0.2576,0.6,0.2239,0,2,2,2
9440,2/3/2012,1,1,2,5,0,5,1,1,0.26,0.2576,0.6,0.2239,0,17,17,17
9441,2/3/2012,1,1,2,6,0,5,1,1,0.24,0.2424,0.65,0.1642,0,88,88,88
9442,2/3/2012,1,1,2,7,0,5,1,1,0.24,0.2273,0.65,0.2239,10,216,226,216
9443,2/3/2012,1,1,2,8,0,5,1,1,0.24,0.2273,0.65,0.2239,12,429,441,429
9444,2/3/2012,1,1,2,9,0,5,1,1,0.24,0.2273,0.65,0.194,18,252,270,252
9445,2/3/2012,1,1,2,10,0,5,1,1,0.28,0.2576,0.56,0.2836,15,114,129,114
9446,2/3/2012,1,1,2,11,0,5,1,1,0.32,0.303,0.53,0.2985,15,149,164,149
9447,2/3/2012,1,1,2,12,0,5,1,1,0.34,0.3333,0.46,0.1343,25,191,216,191
9448,2/3/2012,1,1,2,13,0,5,1,1,0.36,0.3636,0.46,0,25,173,198,173
9449,2/3/2012,1,1,2,14,0,5,1,1,0.36,0.3485,0.46,0.2239,22,148,170,148
9450,2/3/2012,1,1,2,15,0,5,1,1,0.38,0.3939,0.4,0,48,168,216,168
9451,2/3/2012,1,1,2,16,0,5,1,1,0.4,0.4091,0.37,0.1045,36,275,311,275
9452,2/3/2012,1,1,2,17,0,5,1,1,0.4,0.4091,0.37,0.0896,30,458,488,458
9453,2/3/2012,1,1,2,18,0,5,1,1,0.38,0.3939,0.4,0.1343,17,368,385,368
9454,2/3/2012,1,1,2,19,0,5,1,1,0.34,0.3485,0.49,0.1045,11,256,267,256
9455,2/3/2012,1,1,2,20,0,5,1,1,0.34,0.3485,0.49,0.1045,8,155,163,155
9456,2/3/2012,1,1,2,21,0,5,1,1,0.34,0.3485,0.49,0.1045,8,126,134,126
9457,2/3/2012,1,1,2,22,0,5,1,1,0.34,0.3485,0.49,0.1045,3,116,119,116
9458,2/3/2012,1,1,2,23,0,5,1,1,0.26,0.2727,0.7,0.1045,3,74,77,74
9459,2/4/2012,1,1,2,0,0,6,0,1,0.26,0.2727,0.7,0.1045,10,76,86,76
9460,2/4/2012,1,1,2,1,0,6,0,1,0.26,0.2727,0.7,0.1045,0,43,43,43
9461,2/4/2012,1,1,2,2,0,6,0,1,0.24,0.2576,0.7,0.0896,6,38,44,38
9462,2/4/2012,1,1,2,3,0,6,0,1,0.24,0.2879,0.75,0,1,17,18,17
9463,2/4/2012,1,1,2,4,0,6,0,1,0.24,0.2576,0.81,0.0896,1,5,6,5
9464,2/4/2012,1,1,2,5,0,6,0,1,0.24,0.2576,0.81,0.0896,1,3,4,3
9465,2/4/2012,1,1,2,6,0,6,0,1,0.22,0.2273,0.87,0.1343,1,4,5,4
9466,2/4/2012,1,1,2,7,0,6,0,2,0.24,0.2424,0.87,0.1343,1,27,28,27
9467,2/4/2012,1,1,2,8,0,6,0,1,0.24,0.2879,0.87,0,4,86,90,86
9468,2/4/2012,1,1,2,9,0,6,0,1,0.24,0.2424,0.81,0.1343,16,141,157,141
9469,2/4/2012,1,1,2,10,0,6,0,1,0.24,0.2576,0.87,0.1045,31,193,224,193
9470,2/4/2012,1,1,2,11,0,6,0,1,0.3,0.3333,0.7,0,46,224,270,224
9471,2/4/2012,1,1,2,12,0,6,0,2,0.3,0.3182,0.7,0.0896,40,260,300,260
9472,2/4/2012,1,1,2,13,0,6,0,2,0.3,0.2879,0.7,0.194,58,244,302,244
9473,2/4/2012,1,1,2,14,0,6,0,2,0.32,0.303,0.66,0.2239,47,229,276,229
9474,2/4/2012,1,1,2,15,0,6,0,2,0.32,0.303,0.66,0.2239,61,244,305,244
9475,2/4/2012,1,1,2,16,0,6,0,2,0.34,0.3333,0.61,0.1642,20,123,143,123
9476,2/4/2012,1,1,2,17,0,6,0,3,0.3,0.2879,0.7,0.194,13,54,67,54
9477,2/4/2012,1,1,2,18,0,6,0,3,0.28,0.2727,0.75,0.1642,6,58,64,58
9478,2/4/2012,1,1,2,19,0,6,0,3,0.26,0.2727,0.87,0.1343,5,75,80,75
9479,2/4/2012,1,1,2,20,0,6,0,3,0.24,0.2273,0.93,0.194,4,73,77,73
9480,2/4/2012,1,1,2,21,0,6,0,3,0.24,0.2424,0.93,0.1343,4,74,78,74
9481,2/4/2012,1,1,2,22,0,6,0,2,0.24,0.2576,0.87,0.0896,4,91,95,91
9482,2/4/2012,1,1,2,23,0,6,0,2,0.24,0.2424,0.87,0.1343,4,66,70,66
9483,2/5/2012,1,1,2,0,0,0,0,2,0.24,0.2424,0.87,0.1343,3,58,61,58
9484,2/5/2012,1,1,2,1,0,0,0,2,0.24,0.2576,0.93,0.1045,5,46,51,46
9485,2/5/2012,1,1,2,2,0,0,0,2,0.24,0.2576,0.93,0.1045,4,59,63,59
9486,2/5/2012,1,1,2,3,0,0,0,3,0.24,0.2576,0.87,0.0896,4,13,17,13
9487,2/5/2012,1,1,2,4,0,0,0,2,0.24,0.2424,0.87,0.1343,0,9,9,9
9488,2/5/2012,1,1,2,5,0,0,0,3,0.26,0.2576,0.81,0.194,0,4,4,4
9489,2/5/2012,1,1,2,6,0,0,0,2,0.26,0.2424,0.7,0.2537,0,4,4,4
9490,2/5/2012,1,1,2,7,0,0,0,2,0.24,0.2424,0.75,0.1642,0,16,16,16
9491,2/5/2012,1,1,2,8,0,0,0,2,0.24,0.2424,0.75,0.1642,4,58,62,58
9492,2/5/2012,1,1,2,9,0,0,0,2,0.24,0.2273,0.7,0.2239,9,83,92,83
9493,2/5/2012,1,1,2,10,0,0,0,2,0.26,0.2424,0.65,0.2836,10,138,148,138
9494,2/5/2012,1,1,2,11,0,0,0,2,0.26,0.2576,0.7,0.194,22,160,182,160
9495,2/5/2012,1,1,2,12,0,0,0,2,0.26,0.2576,0.65,0.194,25,223,248,223
9496,2/5/2012,1,1,2,13,0,0,0,2,0.28,0.2727,0.61,0.1642,33,241,274,241
9497,2/5/2012,1,1,2,14,0,0,0,1,0.3,0.303,0.61,0.1642,40,203,243,203
9498,2/5/2012,1,1,2,15,0,0,0,2,0.3,0.2879,0.56,0.2537,55,217,272,217
9499,2/5/2012,1,1,2,16,0,0,0,1,0.3,0.2879,0.56,0.2239,35,261,296,261
9500,2/5/2012,1,1,2,17,0,0,0,1,0.32,0.3182,0.53,0.1642,31,275,306,275
9501,2/5/2012,1,1,2,18,0,0,0,1,0.3,0.2879,0.52,0.2537,10,171,181,171
9502,2/5/2012,1,1,2,19,0,0,0,1,0.3,0.2879,0.52,0.2239,6,63,69,63
9503,2/5/2012,1,1,2,20,0,0,0,1,0.28,0.2727,0.56,0.194,3,47,50,47
9504,2/5/2012,1,1,2,21,0,0,0,1,0.28,0.2879,0.56,0.1045,6,60,66,60
9505,2/5/2012,1,1,2,22,0,0,0,1,0.26,0.2727,0.6,0.1045,9,182,191,182
9506,2/5/2012,1,1,2,23,0,0,0,1,0.24,0.2424,0.7,0.1343,4,38,42,38
9507,2/6/2012,1,1,2,0,0,1,1,1,0.24,0.2424,0.65,0.1343,7,14,21,14
9508,2/6/2012,1,1,2,1,0,1,1,1,0.22,0.2576,0.75,0.0896,0,6,6,6
9509,2/6/2012,1,1,2,2,0,1,1,1,0.22,0.2727,0.75,0,0,3,3,3
9510,2/6/2012,1,1,2,4,0,1,1,1,0.18,0.2121,0.8,0.1045,0,2,2,2
9511,2/6/2012,1,1,2,5,0,1,1,1,0.18,0.2121,0.8,0.1045,0,17,17,17
9512,2/6/2012,1,1,2,6,0,1,1,1,0.16,0.1818,0.86,0.1045,0,72,72,72
9513,2/6/2012,1,1,2,7,0,1,1,1,0.16,0.1818,0.86,0.1045,5,229,234,229
9514,2/6/2012,1,1,2,8,0,1,1,1,0.16,0.1818,0.86,0.1343,10,434,444,434
9515,2/6/2012,1,1,2,9,0,1,1,1,0.18,0.2121,0.8,0.1045,8,269,277,269
9516,2/6/2012,1,1,2,10,0,1,1,1,0.22,0.2424,0.75,0.1045,20,96,116,96
9517,2/6/2012,1,1,2,11,0,1,1,1,0.26,0.2727,0.7,0.1343,12,104,116,104
9518,2/6/2012,1,1,2,12,0,1,1,1,0.32,0.3182,0.61,0.1642,19,131,150,131
9519,2/6/2012,1,1,2,13,0,1,1,1,0.38,0.3939,0.4,0.2239,17,124,141,124
9520,2/6/2012,1,1,2,14,0,1,1,1,0.4,0.4091,0.35,0.1642,14,126,140,126
9521,2/6/2012,1,1,2,15,0,1,1,1,0.42,0.4242,0.32,0.2836,25,146,171,146
9522,2/6/2012,1,1,2,16,0,1,1,1,0.4,0.4091,0.43,0.2537,13,215,228,215
9523,2/6/2012,1,1,2,17,0,1,1,1,0.4,0.4091,0.43,0.2537,13,417,430,417
9524,2/6/2012,1,1,2,18,0,1,1,1,0.38,0.3939,0.43,0.2239,11,426,437,426
9525,2/6/2012,1,1,2,19,0,1,1,1,0.36,0.3333,0.43,0.2537,7,284,291,284
9526,2/6/2012,1,1,2,20,0,1,1,1,0.34,0.3333,0.46,0.1642,7,194,201,194
9527,2/6/2012,1,1,2,21,0,1,1,1,0.32,0.3182,0.57,0.1642,11,143,154,143
9528,2/6/2012,1,1,2,22,0,1,1,1,0.3,0.303,0.65,0.1343,4,83,87,83
9529,2/6/2012,1,1,2,23,0,1,1,1,0.3,0.303,0.65,0.1343,3,43,46,43
9530,2/7/2012,1,1,2,0,0,2,1,1,0.3,0.2879,0.7,0.194,1,22,23,22
9531,2/7/2012,1,1,2,1,0,2,1,1,0.28,0.2879,0.61,0.1343,8,6,14,6
9532,2/7/2012,1,1,2,2,0,2,1,1,0.3,0.3333,0.61,0,0,4,4,4
9533,2/7/2012,1,1,2,3,0,2,1,2,0.3,0.3333,0.7,0,1,1,2,1
9534,2/7/2012,1,1,2,4,0,2,1,2,0.3,0.3333,0.7,0,0,3,3,3
9535,2/7/2012,1,1,2,5,0,2,1,1,0.32,0.3333,0.49,0.0896,0,15,15,15
9536,2/7/2012,1,1,2,6,0,2,1,1,0.32,0.303,0.45,0.2985,2,98,100,98
9537,2/7/2012,1,1,2,7,0,2,1,1,0.32,0.3485,0.45,0,6,293,299,293
9538,2/7/2012,1,1,2,8,0,2,1,1,0.3,0.3182,0.49,0,7,522,529,522
9539,2/7/2012,1,1,2,9,0,2,1,1,0.32,0.3333,0.49,0,11,278,289,278
9540,2/7/2012,1,1,2,10,0,2,1,1,0.34,0.3333,0.46,0.1642,12,104,116,104
9541,2/7/2012,1,1,2,11,0,2,1,1,0.36,0.3485,0.46,0.194,9,120,129,120
9542,2/7/2012,1,1,2,12,0,2,1,1,0.4,0.4091,0.4,0.3284,9,163,172,163
9543,2/7/2012,1,1,2,13,0,2,1,1,0.44,0.4394,0.38,0.2537,15,169,184,169
9544,2/7/2012,1,1,2,14,0,2,1,1,0.44,0.4394,0.38,0.2537,11,127,138,127
9545,2/7/2012,1,1,2,15,0,2,1,1,0.44,0.4394,0.38,0.194,13,133,146,133
9546,2/7/2012,1,1,2,16,0,2,1,1,0.44,0.4394,0.35,0.2537,19,257,276,257
9547,2/7/2012,1,1,2,17,0,2,1,1,0.44,0.4394,0.35,0.194,15,494,509,494
9548,2/7/2012,1,1,2,18,0,2,1,1,0.42,0.4242,0.38,0.194,10,508,518,508
9549,2/7/2012,1,1,2,19,0,2,1,1,0.38,0.3939,0.43,0.2239,11,327,338,327
9550,2/7/2012,1,1,2,20,0,2,1,1,0.36,0.3485,0.5,0.1343,6,206,212,206
9551,2/7/2012,1,1,2,21,0,2,1,1,0.34,0.3485,0.61,0.1045,20,170,190,170
9552,2/7/2012,1,1,2,22,0,2,1,1,0.32,0.3182,0.57,0.194,11,107,118,107
9553,2/7/2012,1,1,2,23,0,2,1,1,0.32,0.3333,0.57,0.1343,2,49,51,49
9554,2/8/2012,1,1,2,0,0,3,1,1,0.3,0.2879,0.56,0.2239,2,21,23,21
9555,2/8/2012,1,1,2,1,0,3,1,1,0.28,0.2727,0.61,0.1642,1,9,10,9
9556,2/8/2012,1,1,2,2,0,3,1,1,0.26,0.303,0.65,0,0,1,1,1
9557,2/8/2012,1,1,2,3,0,3,1,1,0.26,0.303,0.65,0,0,1,1,1
9558,2/8/2012,1,1,2,4,0,3,1,1,0.24,0.2576,0.7,0.0896,0,1,1,1
9559,2/8/2012,1,1,2,5,0,3,1,1,0.24,0.2576,0.7,0.0896,0,20,20,20
9560,2/8/2012,1,1,2,6,0,3,1,2,0.24,0.2879,0.7,0,3,95,98,95
9561,2/8/2012,1,1,2,7,0,3,1,2,0.24,0.2576,0.7,0.1045,5,276,281,276
9562,2/8/2012,1,1,2,8,0,3,1,2,0.24,0.2273,0.7,0.2239,13,495,508,495
9563,2/8/2012,1,1,2,9,0,3,1,2,0.24,0.2576,0.7,0.1642,8,245,253,245
9564,2/8/2012,1,1,2,10,0,3,1,2,0.26,0.2576,0.7,0.2239,1,107,108,107
9565,2/8/2012,1,1,2,11,0,3,1,2,0.26,0.2576,0.65,0.2239,5,97,102,97
9566,2/8/2012,1,1,2,12,0,3,1,2,0.28,0.2576,0.65,0.2836,14,124,138,124
9567,2/8/2012,1,1,2,13,0,3,1,2,0.28,0.2879,0.61,0.1045,15,111,126,111
9568,2/8/2012,1,1,2,14,0,3,1,2,0.3,0.303,0.56,0.1642,8,100,108,100
9569,2/8/2012,1,1,2,15,0,3,1,3,0.3,0.3182,0.61,0.1045,5,49,54,49
9570,2/8/2012,1,1,2,16,0,3,1,3,0.26,0.2727,0.81,0.1045,2,73,75,73
9571,2/8/2012,1,1,2,17,0,3,1,3,0.24,0.2576,0.87,0.1045,8,147,155,147
9572,2/8/2012,1,1,2,18,0,3,1,3,0.24,0.2576,0.87,0.1045,4,163,167,163
9573,2/8/2012,1,1,2,19,0,3,1,3,0.24,0.2576,0.87,0.1045,3,158,161,158
9574,2/8/2012,1,1,2,20,0,3,1,3,0.24,0.2424,0.87,0.1343,3,122,125,122
9575,2/8/2012,1,1,2,21,0,3,1,3,0.24,0.2273,0.87,0.194,3,126,129,126
9576,2/8/2012,1,1,2,22,0,3,1,2,0.24,0.2424,0.87,0.1343,3,95,98,95
9577,2/8/2012,1,1,2,23,0,3,1,2,0.24,0.2424,0.87,0.1642,3,57,60,57
9578,2/9/2012,1,1,2,0,0,4,1,2,0.24,0.2424,0.87,0.1642,3,23,26,23
9579,2/9/2012,1,1,2,1,0,4,1,2,0.24,0.2424,0.87,0.1343,2,10,12,10
9580,2/9/2012,1,1,2,2,0,4,1,1,0.22,0.2273,0.8,0.1343,0,2,2,2
9581,2/9/2012,1,1,2,3,0,4,1,1,0.22,0.2121,0.8,0.2836,0,4,4,4
9582,2/9/2012,1,1,2,4,0,4,1,2,0.22,0.197,0.75,0.4478,0,1,1,1
9583,2/9/2012,1,1,2,5,0,4,1,1,0.2,0.1818,0.75,0.2836,0,18,18,18
9584,2/9/2012,1,1,2,6,0,4,1,1,0.2,0.1818,0.75,0.2836,1,75,76,75
9585,2/9/2012,1,1,2,7,0,4,1,1,0.2,0.197,0.69,0.2537,4,263,267,263
9586,2/9/2012,1,1,2,8,0,4,1,1,0.2,0.197,0.64,0.2537,11,473,484,473
9587,2/9/2012,1,1,2,9,0,4,1,1,0.2,0.197,0.59,0.2239,9,229,238,229
9588,2/9/2012,1,1,2,10,0,4,1,1,0.22,0.2121,0.51,0.2239,7,90,97,90
9589,2/9/2012,1,1,2,11,0,4,1,1,0.24,0.2273,0.52,0.2239,4,95,99,95
9590,2/9/2012,1,1,2,12,0,4,1,1,0.26,0.2273,0.48,0.3284,10,148,158,148
9591,2/9/2012,1,1,2,13,0,4,1,1,0.3,0.2727,0.42,0.3284,10,144,154,144
9592,2/9/2012,1,1,2,14,0,4,1,1,0.32,0.303,0.39,0.2985,18,126,144,126
9593,2/9/2012,1,1,2,15,0,4,1,1,0.32,0.303,0.36,0.2985,14,120,134,120
9594,2/9/2012,1,1,2,16,0,4,1,1,0.34,0.3333,0.36,0,15,223,238,223
9595,2/9/2012,1,1,2,17,0,4,1,1,0.34,0.3333,0.34,0.1343,12,387,399,387
9596,2/9/2012,1,1,2,18,0,4,1,1,0.34,0.3333,0.31,0.1642,13,404,417,404
9597,2/9/2012,1,1,2,19,0,4,1,1,0.32,0.3333,0.33,0.1045,8,287,295,287
9598,2/9/2012,1,1,2,20,0,4,1,1,0.32,0.3485,0.36,0,2,197,199,197
9599,2/9/2012,1,1,2,21,0,4,1,1,0.3,0.3182,0.52,0.0896,8,169,177,169
9600,2/9/2012,1,1,2,22,0,4,1,2,0.3,0.3333,0.56,0,3,104,107,104
9601,2/9/2012,1,1,2,23,0,4,1,2,0.3,0.3333,0.52,0,9,75,84,75
9602,2/10/2012,1,1,2,0,0,5,1,2,0.28,0.303,0.65,0.0896,4,39,43,39
9603,2/10/2012,1,1,2,1,0,5,1,2,0.28,0.303,0.61,0.0896,2,11,13,11
9604,2/10/2012,1,1,2,2,0,5,1,1,0.26,0.2879,0.52,0.0896,7,9,16,9
9605,2/10/2012,1,1,2,3,0,5,1,1,0.26,0.2879,0.56,0.0896,0,5,5,5
9606,2/10/2012,1,1,2,4,0,5,1,1,0.26,0.2879,0.56,0.0896,0,2,2,2
9607,2/10/2012,1,1,2,5,0,5,1,1,0.24,0.2273,0.52,0.2239,0,17,17,17
9608,2/10/2012,1,1,2,6,0,5,1,1,0.2,0.197,0.59,0.194,3,61,64,61
9609,2/10/2012,1,1,2,7,0,5,1,1,0.2,0.2121,0.59,0.1642,5,225,230,225
9610,2/10/2012,1,1,2,8,0,5,1,1,0.2,0.2121,0.59,0.1642,1,447,448,447
9611,2/10/2012,1,1,2,9,0,5,1,1,0.22,0.2273,0.55,0.1642,10,265,275,265
9612,2/10/2012,1,1,2,10,0,5,1,2,0.26,0.2727,0.48,0.1343,5,119,124,119
9613,2/10/2012,1,1,2,11,0,5,1,2,0.28,0.2879,0.45,0.1045,19,134,153,134
9614,2/10/2012,1,1,2,12,0,5,1,2,0.3,0.303,0.42,0.1343,8,168,176,168
9615,2/10/2012,1,1,2,13,0,5,1,2,0.3,0.3182,0.42,0.0896,22,170,192,170
9616,2/10/2012,1,1,2,14,0,5,1,2,0.32,0.3333,0.39,0.0896,8,138,146,138
9617,2/10/2012,1,1,2,15,0,5,1,2,0.32,0.3333,0.45,0.1343,27,164,191,164
9618,2/10/2012,1,1,2,16,0,5,1,2,0.34,0.3182,0.42,0.2537,28,240,268,240
9619,2/10/2012,1,1,2,17,0,5,1,2,0.34,0.3333,0.42,0.194,15,381,396,381
9620,2/10/2012,1,1,2,18,0,5,1,3,0.3,0.303,0.61,0.1343,14,345,359,345
9621,2/10/2012,1,1,2,19,0,5,1,2,0.32,0.3485,0.57,0,16,246,262,246
9622,2/10/2012,1,1,2,20,0,5,1,2,0.32,0.3485,0.57,0,7,144,151,144
9623,2/10/2012,1,1,2,21,0,5,1,2,0.32,0.3333,0.66,0.0896,14,108,122,108
9624,2/10/2012,1,1,2,22,0,5,1,2,0.32,0.3485,0.66,0,11,102,113,102
9625,2/10/2012,1,1,2,23,0,5,1,2,0.3,0.3182,0.7,0.0896,1,64,65,64
9626,2/11/2012,1,1,2,0,0,6,0,2,0.3,0.303,0.7,0.1343,3,50,53,50
9627,2/11/2012,1,1,2,1,0,6,0,3,0.28,0.2879,0.81,0.1343,2,43,45,43
9628,2/11/2012,1,1,2,2,0,6,0,3,0.26,0.2576,0.81,0.194,2,24,26,24
9629,2/11/2012,1,1,2,3,0,6,0,3,0.24,0.2273,0.87,0.2239,0,9,9,9
9630,2/11/2012,1,1,2,4,0,6,0,3,0.24,0.2273,0.87,0.2239,0,4,4,4
9631,2/11/2012,1,1,2,5,0,6,0,3,0.22,0.2273,0.93,0.1642,0,2,2,2
9632,2/11/2012,1,1,2,6,0,6,0,3,0.22,0.2273,0.93,0.1343,1,8,9,8
9633,2/11/2012,1,1,2,7,0,6,0,3,0.22,0.2273,0.93,0.1343,0,19,19,19
9634,2/11/2012,1,1,2,8,0,6,0,3,0.22,0.2273,0.93,0.1343,1,77,78,77
9635,2/11/2012,1,1,2,9,0,6,0,3,0.22,0.2424,0.93,0.1045,5,85,90,85
9636,2/11/2012,1,1,2,10,0,6,0,3,0.22,0.2424,0.93,0.1045,23,143,166,143
9637,2/11/2012,1,1,2,11,0,6,0,2,0.24,0.2576,0.81,0.1045,26,157,183,157
9638,2/11/2012,1,1,2,12,0,6,0,2,0.26,0.2576,0.81,0.1642,25,196,221,196
9639,2/11/2012,1,1,2,13,0,6,0,2,0.26,0.2424,0.81,0.2836,18,217,235,217
9640,2/11/2012,1,1,2,14,0,6,0,2,0.26,0.2424,0.81,0.2537,38,205,243,205
9641,2/11/2012,1,1,2,15,0,6,0,2,0.3,0.2727,0.61,0.2985,12,112,124,112
9642,2/11/2012,1,1,2,16,0,6,0,3,0.22,0.197,0.75,0.4179,12,134,146,134
9643,2/11/2012,1,1,2,17,0,6,0,3,0.22,0.1818,0.69,0.4627,13,131,144,131
9644,2/11/2012,1,1,2,18,0,6,0,2,0.22,0.1818,0.47,0.6567,3,105,108,105
9645,2/11/2012,1,1,2,19,0,6,0,2,0.2,0.1515,0.4,0.5522,2,85,87,85
9646,2/11/2012,1,1,2,20,0,6,0,2,0.16,0.1212,0.43,0.5522,1,62,63,62
9647,2/11/2012,1,1,2,21,0,6,0,1,0.14,0.0758,0.43,0.6418,5,43,48,43
9648,2/11/2012,1,1,2,22,0,6,0,2,0.14,0.1061,0.39,0.3881,0,46,46,46
9649,2/11/2012,1,1,2,23,0,6,0,3,0.12,0.0758,0.5,0.4925,0,20,20,20
9650,2/12/2012,1,1,2,0,0,0,0,3,0.1,0.0758,0.68,0.3881,0,21,21,21
9651,2/12/2012,1,1,2,1,0,0,0,3,0.08,0.0455,0.79,0.4627,0,24,24,24
9652,2/12/2012,1,1,2,2,0,0,0,2,0.1,0.0606,0.58,0.5821,1,26,27,26
9653,2/12/2012,1,1,2,3,0,0,0,2,0.1,0.0455,0.46,0.6866,0,14,14,14
9654,2/12/2012,1,1,2,4,0,0,0,2,0.1,0.0455,0.46,0.7164,0,1,1,1
9655,2/12/2012,1,1,2,5,0,0,0,1,0.1,0.0758,0.49,0.3881,0,3,3,3
9656,2/12/2012,1,1,2,6,0,0,0,1,0.1,0.0758,0.49,0.3881,0,2,2,2
9657,2/12/2012,1,1,2,7,0,0,0,1,0.08,0.0909,0.53,0.194,0,18,18,18
9658,2/12/2012,1,1,2,8,0,0,0,1,0.08,0.0758,0.53,0.2537,0,26,26,26
9659,2/12/2012,1,1,2,9,0,0,0,1,0.1,0.0909,0.49,0.2985,3,60,63,60
9660,2/12/2012,1,1,2,10,0,0,0,1,0.12,0.1061,0.42,0.3582,8,83,91,83
9661,2/12/2012,1,1,2,11,0,0,0,1,0.12,0.1061,0.42,0.2985,3,121,124,121
9662,2/12/2012,1,1,2,12,0,0,0,1,0.14,0.0758,0.39,0.6418,7,133,140,133
9663,2/12/2012,1,1,2,13,0,0,0,1,0.16,0.1212,0.4,0.4478,10,128,138,128
9664,2/12/2012,1,1,2,14,0,0,0,1,0.16,0.1212,0.4,0.5224,9,102,111,102
9665,2/12/2012,1,1,2,15,0,0,0,1,0.16,0.1212,0.4,0.5522,5,150,155,150
9666,2/12/2012,1,1,2,16,0,0,0,1,0.2,0.1667,0.34,0.4627,16,148,164,148
9667,2/12/2012,1,1,2,17,0,0,0,1,0.18,0.1515,0.37,0.4179,4,83,87,83
9668,2/12/2012,1,1,2,18,0,0,0,1,0.16,0.1212,0.4,0.4627,4,92,96,92
9669,2/12/2012,1,1,2,19,0,0,0,1,0.16,0.1364,0.4,0.2836,2,78,80,78
9670,2/12/2012,1,1,2,20,0,0,0,1,0.14,0.1212,0.42,0.3284,1,56,57,56
9671,2/12/2012,1,1,2,21,0,0,0,1,0.14,0.1212,0.43,0.2985,0,36,36,36
9672,2/12/2012,1,1,2,22,0,0,0,1,0.14,0.1515,0.43,0.1642,0,28,28,28
9673,2/12/2012,1,1,2,23,0,0,0,1,0.14,0.1364,0.43,0.2239,0,23,23,23
9674,2/13/2012,1,1,2,0,0,1,1,1,0.14,0.1364,0.46,0.2239,0,9,9,9
9675,2/13/2012,1,1,2,1,0,1,1,1,0.12,0.1212,0.5,0.2239,0,6,6,6
9676,2/13/2012,1,1,2,2,0,1,1,1,0.14,0.1364,0.46,0.194,0,4,4,4
9677,2/13/2012,1,1,2,3,0,1,1,1,0.12,0.1515,0.54,0.1045,0,1,1,1
9678,2/13/2012,1,1,2,4,0,1,1,1,0.12,0.1667,0.54,0.0896,0,2,2,2
9679,2/13/2012,1,1,2,5,0,1,1,1,0.1,0.1212,0.58,0.1343,0,17,17,17
9680,2/13/2012,1,1,2,6,0,1,1,1,0.1,0.1061,0.54,0.2239,1,71,72,71
9681,2/13/2012,1,1,2,7,0,1,1,1,0.1,0.1061,0.54,0.194,1,194,195,194
9682,2/13/2012,1,1,2,8,0,1,1,1,0.1,0.1212,0.54,0.1343,4,413,417,413
9683,2/13/2012,1,1,2,9,0,1,1,1,0.12,0.1364,0.5,0.194,7,198,205,198
9684,2/13/2012,1,1,2,10,0,1,1,1,0.14,0.1515,0.5,0.1343,1,70,71,70
9685,2/13/2012,1,1,2,11,0,1,1,1,0.22,0.2273,0.37,0.194,5,85,90,85
9686,2/13/2012,1,1,2,12,0,1,1,1,0.28,0.2576,0.28,0.3284,7,111,118,111
9687,2/13/2012,1,1,2,13,0,1,1,1,0.32,0.303,0.22,0.2239,11,129,140,129
9688,2/13/2012,1,1,2,14,0,1,1,1,0.34,0.3485,0.23,0.1045,10,125,135,125
9689,2/13/2012,1,1,2,15,0,1,1,1,0.36,0.3485,0.27,0.1343,10,145,155,145
9690,2/13/2012,1,1,2,16,0,1,1,1,0.36,0.3485,0.23,0.194,5,206,211,206
9691,2/13/2012,1,1,2,17,0,1,1,1,0.36,0.3485,0.23,0.194,8,399,407,399
9692,2/13/2012,1,1,2,18,0,1,1,1,0.34,0.3182,0.25,0.2537,6,399,405,399
9693,2/13/2012,1,1,2,19,0,1,1,1,0.34,0.3333,0.25,0.1343,7,256,263,256
9694,2/13/2012,1,1,2,20,0,1,1,1,0.3,0.303,0.42,0.1642,4,210,214,210
9695,2/13/2012,1,1,2,21,0,1,1,1,0.28,0.2879,0.45,0.1343,2,145,147,145
9696,2/13/2012,1,1,2,22,0,1,1,1,0.26,0.2727,0.56,0.1045,3,99,102,99
9697,2/13/2012,1,1,2,23,0,1,1,1,0.28,0.3182,0.41,0,2,34,36,34
9698,2/14/2012,1,1,2,0,0,2,1,2,0.26,0.303,0.6,0,0,14,14,14
9699,2/14/2012,1,1,2,1,0,2,1,2,0.26,0.303,0.56,0,0,6,6,6
9700,2/14/2012,1,1,2,2,0,2,1,2,0.28,0.3182,0.41,0,0,3,3,3
9701,2/14/2012,1,1,2,3,0,2,1,2,0.26,0.303,0.52,0,0,3,3,3
9702,2/14/2012,1,1,2,4,0,2,1,2,0.26,0.2727,0.65,0.1045,0,2,2,2
9703,2/14/2012,1,1,2,5,0,2,1,2,0.26,0.2727,0.65,0.1045,2,20,22,20
9704,2/14/2012,1,1,2,6,0,2,1,2,0.26,0.303,0.56,0,1,89,90,89
9705,2/14/2012,1,1,2,7,0,2,1,2,0.24,0.2576,0.6,0.0896,4,276,280,276
9706,2/14/2012,1,1,2,8,0,2,1,2,0.24,0.2879,0.7,0,3,510,513,510
9707,2/14/2012,1,1,2,9,0,2,1,2,0.26,0.2879,0.56,0.0896,6,256,262,256
9708,2/14/2012,1,1,2,10,0,2,1,2,0.26,0.2727,0.6,0.1343,8,90,98,90
9709,2/14/2012,1,1,2,11,0,2,1,2,0.3,0.303,0.45,0.1642,5,107,112,107
9710,2/14/2012,1,1,2,12,0,2,1,2,0.3,0.2879,0.52,0.2239,10,162,172,162
9711,2/14/2012,1,1,2,13,0,2,1,2,0.36,0.3333,0.4,0.2537,6,167,173,167
9712,2/14/2012,1,1,2,14,0,2,1,1,0.4,0.4091,0.4,0.2239,13,111,124,111
9713,2/14/2012,1,1,2,15,0,2,1,2,0.42,0.4242,0.38,0.4478,7,138,145,138
9714,2/14/2012,1,1,2,16,0,2,1,1,0.42,0.4242,0.35,0.2985,15,251,266,251
9715,2/14/2012,1,1,2,17,0,2,1,1,0.42,0.4242,0.38,0.3582,19,504,523,504
9716,2/14/2012,1,1,2,18,0,2,1,2,0.38,0.3939,0.46,0.2985,8,398,406,398
9717,2/14/2012,1,1,2,19,0,2,1,2,0.36,0.3485,0.5,0.1642,11,270,281,270
9718,2/14/2012,1,1,2,20,0,2,1,2,0.38,0.3939,0.46,0.1343,6,178,184,178
9719,2/14/2012,1,1,2,21,0,2,1,2,0.36,0.3636,0.5,0.1045,4,105,109,105
9720,2/14/2012,1,1,2,22,0,2,1,2,0.36,0.3636,0.5,0.1045,5,72,77,72
9721,2/14/2012,1,1,2,23,0,2,1,2,0.36,0.3636,0.5,0.0896,2,55,57,55
9722,2/15/2012,1,1,2,0,0,3,1,1,0.32,0.3485,0.57,0,0,22,22,22
9723,2/15/2012,1,1,2,1,0,3,1,1,0.34,0.3636,0.53,0,0,5,5,5
9724,2/15/2012,1,1,2,2,0,3,1,1,0.3,0.3333,0.61,0,0,4,4,4
9725,2/15/2012,1,1,2,3,0,3,1,1,0.28,0.3182,0.75,0,0,3,3,3
9726,2/15/2012,1,1,2,4,0,3,1,1,0.28,0.2879,0.7,0.1045,0,1,1,1
9727,2/15/2012,1,1,2,5,0,3,1,1,0.28,0.2879,0.7,0.1045,0,25,25,25
9728,2/15/2012,1,1,2,6,0,3,1,1,0.3,0.303,0.61,0.1343,3,92,95,92
9729,2/15/2012,1,1,2,7,0,3,1,2,0.3,0.2879,0.65,0.194,3,318,321,318
9730,2/15/2012,1,1,2,8,0,3,1,1,0.32,0.2879,0.61,0.3582,7,508,515,508
9731,2/15/2012,1,1,2,9,0,3,1,1,0.32,0.303,0.61,0.3284,5,226,231,226
9732,2/15/2012,1,1,2,10,0,3,1,1,0.34,0.303,0.57,0.2985,12,108,120,108
9733,2/15/2012,1,1,2,11,0,3,1,1,0.36,0.3333,0.53,0.2836,13,125,138,125
9734,2/15/2012,1,1,2,12,0,3,1,1,0.38,0.3939,0.46,0.3881,11,152,163,152
9735,2/15/2012,1,1,2,13,0,3,1,1,0.4,0.4091,0.43,0.2836,11,159,170,159
9736,2/15/2012,1,1,2,14,0,3,1,1,0.42,0.4242,0.41,0.3582,6,128,134,128
9737,2/15/2012,1,1,2,15,0,3,1,1,0.42,0.4242,0.41,0.2239,7,164,171,164
9738,2/15/2012,1,1,2,16,0,3,1,1,0.42,0.4242,0.38,0.194,9,222,231,222
9739,2/15/2012,1,1,2,17,0,3,1,1,0.42,0.4242,0.38,0.194,17,470,487,470
9740,2/15/2012,1,1,2,18,0,3,1,1,0.4,0.4091,0.4,0.2239,9,459,468,459
9741,2/15/2012,1,1,2,19,0,3,1,1,0.38,0.3939,0.43,0.1642,9,302,311,302
9742,2/15/2012,1,1,2,20,0,3,1,1,0.36,0.3485,0.46,0.1642,4,207,211,207
9743,2/15/2012,1,1,2,21,0,3,1,1,0.34,0.3333,0.53,0.1642,8,170,178,170
9744,2/15/2012,1,1,2,22,0,3,1,1,0.34,0.3485,0.49,0.1045,3,104,107,104
9745,2/15/2012,1,1,2,23,0,3,1,1,0.34,0.3485,0.53,0.0896,4,54,58,54
9746,2/16/2012,1,1,2,0,0,4,1,2,0.3,0.303,0.7,0.1343,1,22,23,22
9747,2/16/2012,1,1,2,1,0,4,1,2,0.3,0.3333,0.7,0,0,5,5,5
9748,2/16/2012,1,1,2,2,0,4,1,2,0.3,0.3182,0.7,0.0896,1,6,7,6
9749,2/16/2012,1,1,2,3,0,4,1,2,0.3,0.3333,0.61,0,0,1,1,1
9750,2/16/2012,1,1,2,4,0,4,1,3,0.3,0.3182,0.7,0.0896,0,3,3,3
9751,2/16/2012,1,1,2,5,0,4,1,2,0.3,0.3333,0.7,0,0,20,20,20
9752,2/16/2012,1,1,2,6,0,4,1,2,0.3,0.3182,0.7,0.0896,4,83,87,83
9753,2/16/2012,1,1,2,7,0,4,1,2,0.3,0.303,0.7,0.1343,3,285,288,285
9754,2/16/2012,1,1,2,8,0,4,1,2,0.3,0.3182,0.7,0.0896,9,489,498,489
9755,2/16/2012,1,1,2,9,0,4,1,2,0.3,0.303,0.7,0.1642,3,199,202,199
9756,2/16/2012,1,1,2,10,0,4,1,3,0.32,0.3333,0.7,0.1343,2,42,44,42
9757,2/16/2012,1,1,2,11,0,4,1,3,0.32,0.3333,0.7,0.1045,2,69,71,69
9758,2/16/2012,1,1,2,12,0,4,1,3,0.32,0.3333,0.76,0.0896,1,44,45,44
9759,2/16/2012,1,1,2,13,0,4,1,3,0.34,0.3182,0.71,0.2537,2,62,64,62
9760,2/16/2012,1,1,2,14,0,4,1,3,0.32,0.3182,0.81,0.194,1,30,31,30
9761,2/16/2012,1,1,2,15,0,4,1,3,0.34,0.3636,0.76,0,3,50,53,50
9762,2/16/2012,1,1,2,16,0,4,1,3,0.34,0.3636,0.81,0,8,110,118,110
9763,2/16/2012,1,1,2,17,0,4,1,3,0.34,0.3636,0.87,0,8,281,289,281
9764,2/16/2012,1,1,2,18,0,4,1,3,0.34,0.3333,0.87,0.1343,8,345,353,345
9765,2/16/2012,1,1,2,19,0,4,1,2,0.32,0.3182,0.87,0.1642,4,254,258,254
9766,2/16/2012,1,1,2,20,0,4,1,2,0.32,0.3333,0.87,0.1343,5,211,216,211
9767,2/16/2012,1,1,2,21,0,4,1,2,0.34,0.3485,0.81,0.1045,3,142,145,142
9768,2/16/2012,1,1,2,22,0,4,1,2,0.32,0.3485,0.81,0,3,108,111,108
9769,2/16/2012,1,1,2,23,0,4,1,1,0.32,0.3333,0.81,0.0896,3,70,73,70
9770,2/17/2012,1,1,2,0,0,5,1,2,0.3,0.3333,0.87,0,2,32,34,32
9771,2/17/2012,1,1,2,1,0,5,1,2,0.3,0.3333,0.93,0,2,16,18,16
9772,2/17/2012,1,1,2,2,0,5,1,2,0.3,0.3182,0.93,0.1045,1,11,12,11
9773,2/17/2012,1,1,2,3,0,5,1,2,0.28,0.2879,0.93,0.1045,0,1,1,1
9774,2/17/2012,1,1,2,4,0,5,1,2,0.28,0.2727,0.93,0.194,0,1,1,1
9775,2/17/2012,1,1,2,5,0,5,1,2,0.28,0.2727,0.93,0.1642,0,16,16,16
9776,2/17/2012,1,1,2,6,0,5,1,2,0.28,0.2879,0.96,0.1343,1,70,71,70
9777,2/17/2012,1,1,2,7,0,5,1,2,0.28,0.2879,0.93,0.1045,4,222,226,222
9778,2/17/2012,1,1,2,8,0,5,1,2,0.26,0.303,1,0,4,516,520,516
9779,2/17/2012,1,1,2,9,0,5,1,2,0.26,0.303,1,0,8,275,283,275
9780,2/17/2012,1,1,2,10,0,5,1,1,0.34,0.3182,0.71,0.2836,13,103,116,103
9781,2/17/2012,1,1,2,11,0,5,1,1,0.36,0.3333,0.62,0.4179,9,133,142,133
9782,2/17/2012,1,1,2,12,0,5,1,1,0.38,0.3939,0.46,0.3881,21,177,198,177
9783,2/17/2012,1,1,2,13,0,5,1,1,0.4,0.4091,0.43,0.3582,34,171,205,171
9784,2/17/2012,1,1,2,14,0,5,1,1,0.4,0.4091,0.37,0.3582,33,137,170,137
9785,2/17/2012,1,1,2,15,0,5,1,1,0.42,0.4242,0.35,0.4179,41,180,221,180
9786,2/17/2012,1,1,2,16,0,5,1,1,0.42,0.4242,0.32,0.2985,56,251,307,251
9787,2/17/2012,1,1,2,17,0,5,1,1,0.42,0.4242,0.32,0.3284,36,429,465,429
9788,2/17/2012,1,1,2,18,0,5,1,1,0.4,0.4091,0.35,0.2537,15,362,377,362
9789,2/17/2012,1,1,2,19,0,5,1,1,0.38,0.3939,0.37,0.2239,16,266,282,266
9790,2/17/2012,1,1,2,20,0,5,1,1,0.4,0.4091,0.35,0.194,13,158,171,158
9791,2/17/2012,1,1,2,21,0,5,1,1,0.38,0.3939,0.37,0.194,15,114,129,114
9792,2/17/2012,1,1,2,22,0,5,1,1,0.36,0.3485,0.4,0.2239,15,92,107,92
9793,2/17/2012,1,1,2,23,0,5,1,1,0.36,0.3485,0.4,0.194,10,72,82,72
9794,2/18/2012,1,1,2,0,0,6,0,1,0.34,0.3333,0.42,0.1642,5,81,86,81
9795,2/18/2012,1,1,2,1,0,6,0,1,0.32,0.3182,0.49,0.1642,7,38,45,38
9796,2/18/2012,1,1,2,2,0,6,0,1,0.3,0.2879,0.61,0.2537,6,39,45,39
9797,2/18/2012,1,1,2,3,0,6,0,1,0.28,0.2879,0.65,0.1045,3,15,18,15
9798,2/18/2012,1,1,2,4,0,6,0,1,0.26,0.303,0.7,0,3,4,7,4
9799,2/18/2012,1,1,2,5,0,6,0,1,0.24,0.2576,0.7,0.0896,0,1,1,1
9800,2/18/2012,1,1,2,6,0,6,0,1,0.24,0.2879,0.7,0,1,8,9,8
9801,2/18/2012,1,1,2,7,0,6,0,1,0.24,0.2879,0.7,0,8,33,41,33
9802,2/18/2012,1,1,2,8,0,6,0,1,0.22,0.2727,0.87,0,10,92,102,92
9803,2/18/2012,1,1,2,9,0,6,0,1,0.22,0.2424,0.8,0.1045,22,116,138,116
9804,2/18/2012,1,1,2,10,0,6,0,1,0.26,0.2727,0.81,0.1045,48,157,205,157
9805,2/18/2012,1,1,2,11,0,6,0,1,0.32,0.3333,0.57,0.1343,102,184,286,184
9806,2/18/2012,1,1,2,12,0,6,0,1,0.36,0.3485,0.43,0.194,128,241,369,241
9807,2/18/2012,1,1,2,13,0,6,0,1,0.4,0.4091,0.43,0.2836,165,219,384,219
9808,2/18/2012,1,1,2,14,0,6,0,1,0.44,0.4394,0.35,0.3582,183,244,427,244
9809,2/18/2012,1,1,2,15,0,6,0,1,0.42,0.4242,0.41,0.2537,229,270,499,270
9810,2/18/2012,1,1,2,16,0,6,0,1,0.44,0.4394,0.44,0.3284,186,218,404,218
9811,2/18/2012,1,1,2,17,0,6,0,1,0.48,0.4697,0.36,0.2836,142,222,364,222
9812,2/18/2012,1,1,2,18,0,6,0,1,0.46,0.4545,0.38,0.2985,70,176,246,176
9813,2/18/2012,1,1,2,19,0,6,0,1,0.44,0.4394,0.44,0.1642,38,150,188,150
9814,2/18/2012,1,1,2,20,0,6,0,1,0.44,0.4394,0.44,0.1642,25,123,148,123
9815,2/18/2012,1,1,2,21,0,6,0,1,0.44,0.4394,0.33,0.2985,25,89,114,89
9816,2/18/2012,1,1,2,22,0,6,0,1,0.4,0.4091,0.4,0.4478,17,101,118,101
9817,2/18/2012,1,1,2,23,0,6,0,2,0.36,0.3333,0.4,0.3881,12,62,74,62
9818,2/19/2012,1,1,2,0,0,0,0,2,0.34,0.303,0.39,0.3582,9,65,74,65
9819,2/19/2012,1,1,2,1,0,0,0,2,0.32,0.303,0.39,0.2537,10,62,72,62
9820,2/19/2012,1,1,2,2,0,0,0,2,0.3,0.2879,0.36,0.2836,3,45,48,45
9821,2/19/2012,1,1,2,3,0,0,0,2,0.3,0.2879,0.36,0.2239,3,12,15,12
9822,2/19/2012,1,1,2,4,0,0,0,2,0.28,0.2576,0.41,0.3881,0,3,3,3
9823,2/19/2012,1,1,2,5,0,0,0,2,0.26,0.2273,0.48,0.2985,1,1,2,1
9824,2/19/2012,1,1,2,6,0,0,0,1,0.24,0.2121,0.52,0.3284,0,5,5,5
9825,2/19/2012,1,1,2,7,0,0,0,2,0.24,0.2121,0.52,0.2836,2,12,14,12
9826,2/19/2012,1,1,2,8,0,0,0,2,0.24,0.2273,0.56,0.194,8,48,56,48
9827,2/19/2012,1,1,2,9,0,0,0,2,0.24,0.2273,0.56,0.2537,20,73,93,73
9828,2/19/2012,1,1,2,10,0,0,0,2,0.26,0.2424,0.52,0.2537,49,142,191,142
9829,2/19/2012,1,1,2,11,0,0,0,2,0.26,0.2273,0.56,0.3284,82,144,226,144
9830,2/19/2012,1,1,2,12,0,0,0,2,0.28,0.2727,0.52,0.2537,71,184,255,184
9831,2/19/2012,1,1,2,13,0,0,0,1,0.3,0.303,0.49,0.1642,64,197,261,197
9832,2/19/2012,1,1,2,14,0,0,0,2,0.32,0.3182,0.45,0.194,48,189,237,189
9833,2/19/2012,1,1,2,15,0,0,0,2,0.3,0.2879,0.49,0.194,85,168,253,168
9834,2/19/2012,1,1,2,16,0,0,0,2,0.32,0.303,0.45,0.2836,62,150,212,150
9835,2/19/2012,1,1,2,17,0,0,0,2,0.3,0.2879,0.49,0.2537,22,135,157,135
9836,2/19/2012,1,1,2,18,0,0,0,2,0.3,0.2727,0.49,0.3284,23,144,167,144
9837,2/19/2012,1,1,2,19,0,0,0,2,0.3,0.2879,0.52,0.2537,18,101,119,101
9838,2/19/2012,1,1,2,20,0,0,0,2,0.3,0.2879,0.52,0.2836,22,81,103,81
9839,2/19/2012,1,1,2,21,0,0,0,3,0.26,0.2576,0.65,0.1642,3,33,36,33
9840,2/19/2012,1,1,2,22,0,0,0,3,0.24,0.2576,0.75,0.0896,8,47,55,47
9841,2/19/2012,1,1,2,23,0,0,0,2,0.22,0.2273,0.93,0.1642,5,30,35,30
9842,2/20/2012,1,1,2,0,1,1,0,2,0.24,0.2576,0.87,0.0896,5,36,41,36
9843,2/20/2012,1,1,2,1,1,1,0,2,0.24,0.2576,0.87,0.0896,3,12,15,12
9844,2/20/2012,1,1,2,2,1,1,0,2,0.24,0.2576,0.87,0.0896,1,19,20,19
9845,2/20/2012,1,1,2,3,1,1,0,2,0.24,0.2273,0.81,0.194,0,8,8,8
9846,2/20/2012,1,1,2,5,1,1,0,2,0.24,0.2121,0.6,0.3582,0,6,6,6
9847,2/20/2012,1,1,2,6,1,1,0,1,0.24,0.197,0.52,0.4179,1,9,10,9
9848,2/20/2012,1,1,2,7,1,1,0,2,0.22,0.197,0.55,0.3284,2,42,44,42
9849,2/20/2012,1,1,2,8,1,1,0,1,0.2,0.1818,0.59,0.3582,9,111,120,111
9850,2/20/2012,1,1,2,9,1,1,0,1,0.2,0.1818,0.59,0.3582,12,98,110,98
9851,2/20/2012,1,1,2,10,1,1,0,1,0.22,0.197,0.55,0.4478,30,113,143,113
9852,2/20/2012,1,1,2,11,1,1,0,1,0.26,0.2273,0.48,0.3582,45,163,208,163
9853,2/20/2012,1,1,2,12,1,1,0,1,0.28,0.2727,0.45,0.2239,65,216,281,216
9854,2/20/2012,1,1,2,13,1,1,0,1,0.3,0.2879,0.42,0.2836,66,246,312,246
9855,2/20/2012,1,1,2,14,1,1,0,1,0.32,0.3182,0.36,0.194,57,206,263,206
9856,2/20/2012,1,1,2,15,1,1,0,1,0.34,0.3182,0.34,0.2239,54,235,289,235
9857,2/20/2012,1,1,2,16,1,1,0,1,0.36,0.3788,0.29,0.1045,64,216,280,216
9858,2/20/2012,1,1,2,17,1,1,0,1,0.38,0.3939,0.27,0.2537,27,226,253,226
9859,2/20/2012,1,1,2,18,1,1,0,1,0.34,0.3182,0.34,0.2239,27,215,242,215
9860,2/20/2012,1,1,2,19,1,1,0,1,0.34,0.3182,0.34,0.2239,8,164,172,164
9861,2/20/2012,1,1,2,20,1,1,0,1,0.34,0.3333,0.34,0.194,9,117,126,117
9862,2/20/2012,1,1,2,21,1,1,0,1,0.3,0.303,0.39,0.1642,8,90,98,90
9863,2/20/2012,1,1,2,22,1,1,0,1,0.3,0.3182,0.45,0.0896,9,53,62,53
9864,2/20/2012,1,1,2,23,1,1,0,1,0.3,0.3333,0.39,0,0,26,26,26
9865,2/21/2012,1,1,2,0,0,2,1,1,0.26,0.303,0.65,0,1,11,12,11
9866,2/21/2012,1,1,2,1,0,2,1,1,0.26,0.303,0.56,0,0,7,7,7
9867,2/21/2012,1,1,2,2,0,2,1,1,0.24,0.2879,0.6,0,0,3,3,3
9868,2/21/2012,1,1,2,4,0,2,1,1,0.22,0.2727,0.64,0,0,2,2,2
9869,2/21/2012,1,1,2,5,0,2,1,1,0.2,0.2576,0.69,0,0,15,15,15
9870,2/21/2012,1,1,2,6,0,2,1,1,0.2,0.2576,0.75,0,3,83,86,83
9871,2/21/2012,1,1,2,7,0,2,1,1,0.22,0.2727,0.64,0,6,273,279,273
9872,2/21/2012,1,1,2,8,0,2,1,1,0.2,0.2273,0.69,0.0896,5,459,464,459
9873,2/21/2012,1,1,2,9,0,2,1,1,0.2,0.2273,0.75,0.1045,6,211,217,211
9874,2/21/2012,1,1,2,10,0,2,1,1,0.24,0.2273,0.7,0.194,8,77,85,77
9875,2/21/2012,1,1,2,11,0,2,1,2,0.26,0.2424,0.7,0.2836,5,81,86,81
9876,2/21/2012,1,1,2,12,0,2,1,2,0.3,0.2727,0.56,0.3881,16,147,163,147
9877,2/21/2012,1,1,2,13,0,2,1,1,0.34,0.303,0.49,0.4179,8,123,131,123
9878,2/21/2012,1,1,2,14,0,2,1,2,0.32,0.2879,0.53,0.3881,16,108,124,108
9879,2/21/2012,1,1,2,15,0,2,1,1,0.34,0.303,0.49,0.4179,23,137,160,137
9880,2/21/2012,1,1,2,16,0,2,1,1,0.36,0.3333,0.46,0.4179,14,240,254,240
9881,2/21/2012,1,1,2,17,0,2,1,1,0.38,0.3939,0.4,0.4478,21,411,432,411
9882,2/21/2012,1,1,2,18,0,2,1,1,0.38,0.3939,0.4,0.4478,11,414,425,414
9883,2/21/2012,1,1,2,19,0,2,1,1,0.36,0.3333,0.46,0.2985,5,299,304,299
9884,2/21/2012,1,1,2,20,0,2,1,1,0.34,0.3182,0.53,0.2537,4,223,227,223
9885,2/21/2012,1,1,2,21,0,2,1,1,0.34,0.3333,0.61,0.1642,7,147,154,147
9886,2/21/2012,1,1,2,22,0,2,1,2,0.34,0.3333,0.71,0.194,3,97,100,97
9887,2/21/2012,1,1,2,23,0,2,1,1,0.32,0.303,0.66,0.2239,1,46,47,46
9888,2/22/2012,1,1,2,0,0,3,1,1,0.32,0.303,0.66,0.2239,5,19,24,19
9889,2/22/2012,1,1,2,1,0,3,1,1,0.32,0.3333,0.7,0.1343,3,4,7,4
9890,2/22/2012,1,1,2,2,0,3,1,1,0.34,0.3182,0.66,0.2836,1,5,6,5
9891,2/22/2012,1,1,2,3,0,3,1,2,0.34,0.3182,0.71,0.2239,1,3,4,3
9892,2/22/2012,1,1,2,4,0,3,1,1,0.34,0.3333,0.71,0.1642,0,2,2,2
9893,2/22/2012,1,1,2,5,0,3,1,1,0.32,0.3333,0.7,0.1045,1,29,30,29
9894,2/22/2012,1,1,2,6,0,3,1,1,0.32,0.3182,0.76,0.1642,5,85,90,85
9895,2/22/2012,1,1,2,7,0,3,1,1,0.32,0.3333,0.76,0.0896,10,292,302,292
9896,2/22/2012,1,1,2,8,0,3,1,1,0.3,0.3182,0.75,0.0896,9,567,576,567
9897,2/22/2012,1,1,2,9,0,3,1,1,0.32,0.3333,0.7,0.0896,11,241,252,241
9898,2/22/2012,1,1,2,10,0,3,1,1,0.34,0.3485,0.71,0.0896,17,122,139,122
9899,2/22/2012,1,1,2,11,0,3,1,1,0.36,0.3485,0.66,0.1642,22,149,171,149
9900,2/22/2012,1,1,2,12,0,3,1,1,0.4,0.4091,0.62,0.2836,21,186,207,186
9901,2/22/2012,1,1,2,13,0,3,1,1,0.42,0.4242,0.54,0.2985,15,175,190,175
9902,2/22/2012,1,1,2,14,0,3,1,1,0.44,0.4394,0.54,0.3284,35,142,177,142
9903,2/22/2012,1,1,2,15,0,3,1,1,0.5,0.4848,0.31,0.4179,34,161,195,161
9904,2/22/2012,1,1,2,16,0,3,1,1,0.52,0.5,0.29,0.4627,30,268,298,268
9905,2/22/2012,1,1,2,17,0,3,1,1,0.52,0.5,0.32,0.3881,43,486,529,486
9906,2/22/2012,1,1,2,18,0,3,1,2,0.48,0.4697,0.41,0.3284,42,483,525,483
9907,2/22/2012,1,1,2,19,0,3,1,2,0.46,0.4545,0.44,0.2836,22,305,327,305
9908,2/22/2012,1,1,2,20,0,3,1,2,0.44,0.4394,0.47,0.194,25,249,274,249
9909,2/22/2012,1,1,2,21,0,3,1,2,0.48,0.4697,0.33,0.2836,19,220,239,220
9910,2/22/2012,1,1,2,22,0,3,1,2,0.44,0.4394,0.47,0.2537,18,129,147,129
9911,2/22/2012,1,1,2,23,0,3,1,2,0.46,0.4545,0.41,0.2836,5,57,62,57
9912,2/23/2012,1,1,2,0,0,4,1,2,0.44,0.4394,0.47,0.2537,12,30,42,30
9913,2/23/2012,1,1,2,1,0,4,1,2,0.44,0.4394,0.58,0.2836,3,12,15,12
9914,2/23/2012,1,1,2,2,0,4,1,2,0.44,0.4394,0.62,0.2239,5,4,9,4
9915,2/23/2012,1,1,2,3,0,4,1,3,0.44,0.4394,0.67,0.194,2,4,6,4
9916,2/23/2012,1,1,2,4,0,4,1,1,0.4,0.4091,0.76,0.2239,0,1,1,1
9917,2/23/2012,1,1,2,5,0,4,1,1,0.4,0.4091,0.76,0.2239,2,30,32,30
9918,2/23/2012,1,1,2,6,0,4,1,1,0.36,0.3485,0.87,0.194,3,88,91,88
9919,2/23/2012,1,1,2,7,0,4,1,1,0.36,0.3485,0.81,0.2239,9,317,326,317
9920,2/23/2012,1,1,2,8,0,4,1,1,0.34,0.3333,0.87,0.194,11,549,560,549
9921,2/23/2012,1,1,2,9,0,4,1,1,0.36,0.3333,0.81,0.2537,14,228,242,228
9922,2/23/2012,1,1,2,10,0,4,1,1,0.42,0.4242,0.67,0.194,41,107,148,107
9923,2/23/2012,1,1,2,11,0,4,1,1,0.48,0.4697,0.48,0.2836,54,128,182,128
9924,2/23/2012,1,1,2,12,0,4,1,1,0.5,0.4848,0.42,0.2537,25,199,224,199
9925,2/23/2012,1,1,2,13,0,4,1,1,0.52,0.5,0.39,0.194,30,188,218,188
9926,2/23/2012,1,1,2,14,0,4,1,1,0.54,0.5152,0.37,0.2537,36,156,192,156
9927,2/23/2012,1,1,2,15,0,4,1,1,0.54,0.5152,0.33,0.1343,46,171,217,171
9928,2/23/2012,1,1,2,16,0,4,1,1,0.56,0.5303,0.32,0,45,298,343,298
9929,2/23/2012,1,1,2,17,0,4,1,1,0.54,0.5152,0.32,0.1642,49,561,610,561
9930,2/23/2012,1,1,2,18,0,4,1,1,0.54,0.5152,0.37,0.1343,36,486,522,486
9931,2/23/2012,1,1,2,19,0,4,1,1,0.5,0.4848,0.39,0.0896,20,349,369,349
9932,2/23/2012,1,1,2,20,0,4,1,1,0.46,0.4545,0.44,0.1343,23,246,269,246
9933,2/23/2012,1,1,2,21,0,4,1,1,0.44,0.4394,0.51,0.2239,17,205,222,205
9934,2/23/2012,1,1,2,22,0,4,1,1,0.44,0.4394,0.54,0.2537,19,118,137,118
9935,2/23/2012,1,1,2,23,0,4,1,1,0.44,0.4394,0.54,0,14,71,85,71
9936,2/24/2012,1,1,2,0,0,5,1,2,0.44,0.4394,0.58,0.0896,12,34,46,34
9937,2/24/2012,1,1,2,1,0,5,1,1,0.44,0.4394,0.62,0.194,3,15,18,15
9938,2/24/2012,1,1,2,2,0,5,1,3,0.42,0.4242,0.77,0.2836,1,4,5,4
9939,2/24/2012,1,1,2,3,0,5,1,1,0.42,0.4242,0.82,0.1343,0,5,5,5
9940,2/24/2012,1,1,2,4,0,5,1,1,0.4,0.4091,0.87,0.1343,0,2,2,2
9941,2/24/2012,1,1,2,5,0,5,1,2,0.4,0.4091,0.87,0.194,1,25,26,25
9942,2/24/2012,1,1,2,6,0,5,1,2,0.4,0.4091,0.87,0.1642,2,80,82,80
9943,2/24/2012,1,1,2,7,0,5,1,2,0.4,0.4091,0.76,0.2239,7,265,272,265
9944,2/24/2012,1,1,2,8,0,5,1,2,0.38,0.3939,0.76,0.3284,17,452,469,452
9945,2/24/2012,1,1,2,9,0,5,1,3,0.36,0.3333,0.81,0.2537,15,229,244,229
9946,2/24/2012,1,1,2,10,0,5,1,3,0.36,0.3485,0.81,0.1642,22,119,141,119
9947,2/24/2012,1,1,2,11,0,5,1,2,0.36,0.3636,0.81,0.1045,27,136,163,136
9948,2/24/2012,1,1,2,12,0,5,1,2,0.4,0.4091,0.76,0.1343,27,201,228,201
9949,2/24/2012,1,1,2,13,0,5,1,2,0.42,0.4242,0.71,0.1045,30,153,183,153
9950,2/24/2012,1,1,2,14,0,5,1,2,0.46,0.4545,0.67,0.1045,5,26,31,26
9951,2/24/2012,1,1,2,15,0,5,1,3,0.4,0.4091,0.87,0.194,11,83,94,83
9952,2/24/2012,1,1,2,16,0,5,1,3,0.4,0.4091,0.87,0.194,12,166,178,166
9953,2/24/2012,1,1,2,17,0,5,1,3,0.42,0.4242,0.94,0.1045,14,242,256,242
9954,2/24/2012,1,1,2,18,0,5,1,2,0.42,0.4242,0.94,0,11,289,300,289
9955,2/24/2012,1,1,2,19,0,5,1,2,0.44,0.4394,0.88,0.1045,6,227,233,227
9956,2/24/2012,1,1,2,20,0,5,1,1,0.44,0.4394,0.62,0.4179,8,159,167,159
9957,2/24/2012,1,1,2,21,0,5,1,1,0.42,0.4242,0.35,0.806,1,151,152,151
9958,2/24/2012,1,1,2,22,0,5,1,1,0.4,0.4091,0.37,0.5821,4,102,106,102
9959,2/24/2012,1,1,2,23,0,5,1,1,0.38,0.3939,0.37,0.6866,10,76,86,76
9960,2/25/2012,1,1,2,0,0,6,0,1,0.36,0.3333,0.43,0.3881,5,56,61,56
9961,2/25/2012,1,1,2,1,0,6,0,1,0.34,0.303,0.42,0.3582,4,42,46,42
9962,2/25/2012,1,1,2,2,0,6,0,1,0.32,0.303,0.45,0.2537,1,37,38,37
9963,2/25/2012,1,1,2,3,0,6,0,1,0.3,0.2727,0.45,0.2985,0,7,7,7
9964,2/25/2012,1,1,2,4,0,6,0,1,0.3,0.2727,0.42,0.3284,0,2,2,2
9965,2/25/2012,1,1,2,5,0,6,0,2,0.3,0.2727,0.42,0.2985,0,3,3,3
9966,2/25/2012,1,1,2,6,0,6,0,2,0.3,0.2727,0.42,0.2985,1,12,13,12
9967,2/25/2012,1,1,2,7,0,6,0,1,0.28,0.2424,0.45,0.4478,3,20,23,20
9968,2/25/2012,1,1,2,8,0,6,0,1,0.26,0.2273,0.48,0.2985,3,90,93,90
9969,2/25/2012,1,1,2,9,0,6,0,3,0.22,0.197,0.75,0.3284,15,107,122,107
9970,2/25/2012,1,1,2,10,0,6,0,1,0.26,0.2273,0.6,0.3582,24,159,183,159
9971,2/25/2012,1,1,2,11,0,6,0,1,0.3,0.2576,0.39,0.6119,23,187,210,187
9972,2/25/2012,1,1,2,12,0,6,0,1,0.32,0.2727,0.29,0.6567,41,217,258,217
9973,2/25/2012,1,1,2,13,0,6,0,1,0.32,0.2879,0.31,0.4925,48,178,226,178
9974,2/25/2012,1,1,2,14,0,6,0,1,0.32,0.2727,0.29,0.5522,35,181,216,181
9975,2/25/2012,1,1,2,15,0,6,0,1,0.32,0.2879,0.29,0.4179,21,211,232,211
9976,2/25/2012,1,1,2,16,0,6,0,1,0.32,0.2727,0.26,0.5821,32,163,195,163
9977,2/25/2012,1,1,2,17,0,6,0,1,0.3,0.2727,0.33,0.3582,16,143,159,143
9978,2/25/2012,1,1,2,18,0,6,0,1,0.3,0.2576,0.28,0.5821,7,126,133,126
9979,2/25/2012,1,1,2,19,0,6,0,1,0.26,0.2121,0.33,0.4478,12,137,149,137
9980,2/25/2012,1,1,2,20,0,6,0,1,0.26,0.2121,0.3,0.5522,10,95,105,95
9981,2/25/2012,1,1,2,21,0,6,0,1,0.24,0.2121,0.35,0.3284,5,80,85,80
9982,2/25/2012,1,1,2,22,0,6,0,1,0.24,0.197,0.38,0.4627,4,78,82,78
9983,2/25/2012,1,1,2,23,0,6,0,1,0.24,0.197,0.41,0.4179,7,84,91,84
9984,2/26/2012,1,1,2,0,0,0,0,1,0.24,0.2121,0.41,0.3582,7,63,70,63
9985,2/26/2012,1,1,2,1,0,0,0,1,0.24,0.2121,0.44,0.3284,5,50,55,50
9986,2/26/2012,1,1,2,2,0,0,0,1,0.24,0.2121,0.44,0.3284,5,37,42,37
9987,2/26/2012,1,1,2,3,0,0,0,1,0.24,0.2273,0.41,0.194,0,21,21,21
9988,2/26/2012,1,1,2,4,0,0,0,1,0.24,0.2273,0.41,0.194,1,5,6,5
9989,2/26/2012,1,1,2,5,0,0,0,1,0.22,0.2121,0.44,0.2239,0,5,5,5
9990,2/26/2012,1,1,2,6,0,0,0,1,0.22,0.197,0.44,0.3284,0,2,2,2
9991,2/26/2012,1,1,2,7,0,0,0,1,0.2,0.1818,0.51,0.2985,2,20,22,20
9992,2/26/2012,1,1,2,8,0,0,0,1,0.2,0.197,0.51,0.2537,2,57,59,57
9993,2/26/2012,1,1,2,9,0,0,0,1,0.22,0.2121,0.47,0.2239,11,76,87,76
9994,2/26/2012,1,1,2,10,0,0,0,1,0.26,0.2576,0.41,0.1642,27,161,188,161
9995,2/26/2012,1,1,2,11,0,0,0,1,0.28,0.2576,0.41,0.2836,43,184,227,184
9996,2/26/2012,1,1,2,12,0,0,0,1,0.3,0.303,0.39,0.1343,49,256,305,256
9997,2/26/2012,1,1,2,13,0,0,0,1,0.32,0.3333,0.36,0,58,267,325,267
9998,2/26/2012,1,1,2,14,0,0,0,1,0.34,0.3485,0.31,0,68,263,331,263
9999,2/26/2012,1,1,2,15,0,0,0,1,0.36,0.3485,0.29,0,72,281,353,281
10000,2/26/2012,1,1,2,16,0,0,0,1,0.36,0.3333,0.32,0.2537,64,275,339,275
10001,2/26/2012,1,1,2,17,0,0,0,1,0.36,0.3485,0.32,0.2239,46,241,287,241
10002,2/26/2012,1,1,2,18,0,0,0,1,0.34,0.3182,0.36,0.2836,17,199,216,199
10003,2/26/2012,1,1,2,19,0,0,0,1,0.34,0.3333,0.34,0.1642,13,130,143,130
10004,2/26/2012,1,1,2,20,0,0,0,1,0.32,0.3182,0.42,0.1642,9,79,88,79
10005,2/26/2012,1,1,2,21,0,0,0,1,0.3,0.303,0.45,0.1343,8,75,83,75
10006,2/26/2012,1,1,2,22,0,0,0,1,0.3,0.2879,0.42,0.2239,3,68,71,68
10007,2/26/2012,1,1,2,23,0,0,0,1,0.26,0.2576,0.56,0.1642,5,59,64,59
10008,2/27/2012,1,1,2,0,0,1,1,1,0.26,0.2424,0.6,0.2537,2,27,29,27
10009,2/27/2012,1,1,2,1,0,1,1,1,0.26,0.2576,0.65,0.2239,0,6,6,6
10010,2/27/2012,1,1,2,2,0,1,1,1,0.26,0.2273,0.7,0.2985,0,4,4,4
10011,2/27/2012,1,1,2,3,0,1,1,1,0.24,0.2424,0.75,0.1642,0,2,2,2
10012,2/27/2012,1,1,2,4,0,1,1,1,0.22,0.2273,0.8,0.1343,0,1,1,1
10013,2/27/2012,1,1,2,5,0,1,1,1,0.22,0.2273,0.8,0.1343,0,16,16,16
10014,2/27/2012,1,1,2,6,0,1,1,1,0.24,0.2273,0.7,0.2537,1,89,90,89
10015,2/27/2012,1,1,2,7,0,1,1,1,0.24,0.2273,0.6,0.2239,2,278,280,278
10016,2/27/2012,1,1,2,8,0,1,1,1,0.24,0.2424,0.6,0,14,514,528,514
10017,2/27/2012,1,1,2,9,0,1,1,1,0.26,0.2576,0.6,0.194,11,219,230,219
10018,2/27/2012,1,1,2,10,0,1,1,1,0.32,0.303,0.45,0.2537,16,88,104,88
10019,2/27/2012,1,1,2,11,0,1,1,1,0.36,0.3333,0.43,0.2537,11,92,103,92
10020,2/27/2012,1,1,2,12,0,1,1,1,0.4,0.4091,0.37,0.2985,13,164,177,164
10021,2/27/2012,1,1,2,13,0,1,1,1,0.4,0.4091,0.43,0.2836,23,159,182,159
10022,2/27/2012,1,1,2,14,0,1,1,1,0.46,0.4545,0.36,0.2836,24,134,158,134
10023,2/27/2012,1,1,2,15,0,1,1,1,0.52,0.5,0.25,0.4179,24,150,174,150
10024,2/27/2012,1,1,2,16,0,1,1,1,0.54,0.5152,0.26,0.4478,20,266,286,266
10025,2/27/2012,1,1,2,17,0,1,1,1,0.54,0.5152,0.24,0.4478,26,503,529,503
10026,2/27/2012,1,1,2,18,0,1,1,1,0.52,0.5,0.27,0.4179,10,517,527,517
10027,2/27/2012,1,1,2,19,0,1,1,1,0.5,0.4848,0.29,0.3881,16,318,334,318
10028,2/27/2012,1,1,2,20,0,1,1,1,0.48,0.4697,0.33,0.3582,11,208,219,208
10029,2/27/2012,1,1,2,21,0,1,1,1,0.46,0.4545,0.36,0.2836,14,181,195,181
10030,2/27/2012,1,1,2,22,0,1,1,1,0.44,0.4394,0.44,0.2537,9,83,92,83
10031,2/27/2012,1,1,2,23,0,1,1,1,0.42,0.4242,0.5,0.1642,6,50,56,50
10032,2/28/2012,1,1,2,0,0,2,1,1,0.42,0.4242,0.54,0.1343,0,10,10,10
10033,2/28/2012,1,1,2,1,0,2,1,1,0.38,0.3939,0.62,0.1642,0,6,6,6
10034,2/28/2012,1,1,2,2,0,2,1,1,0.4,0.4091,0.54,0.1045,1,2,3,2
10035,2/28/2012,1,1,2,3,0,2,1,1,0.4,0.4091,0.32,0.3582,0,6,6,6
10036,2/28/2012,1,1,2,4,0,2,1,1,0.32,0.2879,0.42,0.3582,0,2,2,2
10037,2/28/2012,1,1,2,5,0,2,1,1,0.32,0.2879,0.42,0.3582,1,20,21,20
10038,2/28/2012,1,1,2,6,0,2,1,1,0.3,0.2727,0.45,0.3284,1,100,101,100
10039,2/28/2012,1,1,2,7,0,2,1,1,0.28,0.2576,0.45,0.2985,12,313,325,313
10040,2/28/2012,1,1,2,8,0,2,1,1,0.26,0.2424,0.48,0.2836,16,543,559,543
10041,2/28/2012,1,1,2,9,0,2,1,1,0.28,0.2576,0.45,0.3582,7,225,232,225
10042,2/28/2012,1,1,2,10,0,2,1,1,0.3,0.2727,0.42,0.2985,14,118,132,118
10043,2/28/2012,1,1,2,11,0,2,1,1,0.34,0.3182,0.36,0.2537,8,155,163,155
10044,2/28/2012,1,1,2,12,0,2,1,1,0.36,0.3485,0.34,0.1343,19,164,183,164
10045,2/28/2012,1,1,2,13,0,2,1,1,0.36,0.3636,0.32,0.1045,16,174,190,174
10046,2/28/2012,1,1,2,14,0,2,1,1,0.4,0.4091,0.28,0.1045,13,121,134,121
10047,2/28/2012,1,1,2,15,0,2,1,1,0.42,0.4242,0.26,0.0896,17,149,166,149
10048,2/28/2012,1,1,2,16,0,2,1,1,0.42,0.4242,0.28,0.0896,17,270,287,270
10049,2/28/2012,1,1,2,17,0,2,1,1,0.42,0.4242,0.26,0.0896,33,497,530,497
10050,2/28/2012,1,1,2,18,0,2,1,1,0.42,0.4242,0.28,0.1642,17,432,449,432
10051,2/28/2012,1,1,2,19,0,2,1,1,0.42,0.4242,0.26,0,15,291,306,291
10052,2/28/2012,1,1,2,20,0,2,1,1,0.4,0.4091,0.3,0.1343,2,202,204,202
10053,2/28/2012,1,1,2,21,0,2,1,1,0.34,0.3485,0.46,0.1045,10,178,188,178
10054,2/28/2012,1,1,2,22,0,2,1,1,0.34,0.3485,0.46,0.1045,6,95,101,95
10055,2/28/2012,1,1,2,23,0,2,1,1,0.32,0.303,0.53,0.2239,4,61,65,61
10056,2/29/2012,1,1,2,0,0,3,1,1,0.32,0.3333,0.53,0.1045,2,30,32,30
10057,2/29/2012,1,1,2,1,0,3,1,1,0.32,0.3333,0.49,0.1045,0,6,6,6
10058,2/29/2012,1,1,2,2,0,3,1,1,0.3,0.2879,0.56,0.2239,0,4,4,4
10059,2/29/2012,1,1,2,3,0,3,1,1,0.28,0.303,0.7,0.0896,0,2,2,2
10060,2/29/2012,1,1,2,5,0,3,1,1,0.26,0.2879,0.75,0.0896,0,29,29,29
10061,2/29/2012,1,1,2,6,0,3,1,2,0.28,0.303,0.75,0.0896,4,100,104,100
10062,2/29/2012,1,1,2,7,0,3,1,2,0.26,0.2727,0.81,0.1343,11,242,253,242
10063,2/29/2012,1,1,2,8,0,3,1,2,0.28,0.2879,0.75,0.1045,2,114,116,114
10064,2/29/2012,1,1,2,9,0,3,1,3,0.3,0.303,0.81,0.1642,5,33,38,33
10065,2/29/2012,1,1,2,10,0,3,1,3,0.3,0.303,0.81,0.1642,0,10,10,10
10066,2/29/2012,1,1,2,11,0,3,1,3,0.3,0.2879,0.87,0.194,1,9,10,9
10067,2/29/2012,1,1,2,12,0,3,1,3,0.32,0.303,0.93,0.3284,1,69,70,69
10068,2/29/2012,1,1,2,13,0,3,1,2,0.36,0.3333,0.93,0.3582,4,72,76,72
10069,2/29/2012,1,1,2,14,0,3,1,2,0.36,0.3333,0.93,0.3582,2,54,56,54
10070,2/29/2012,1,1,2,15,0,3,1,2,0.4,0.4091,0.82,0.2836,3,87,90,87
10071,2/29/2012,1,1,2,16,0,3,1,3,0.4,0.4091,0.82,0.2239,5,162,167,162
10072,2/29/2012,1,1,2,17,0,3,1,2,0.4,0.4091,0.87,0.1642,7,246,253,246
10073,2/29/2012,1,1,2,18,0,3,1,3,0.4,0.4091,0.87,0,11,181,192,181
10074,2/29/2012,1,1,2,19,0,3,1,2,0.4,0.4091,0.87,0.1045,0,102,102,102
10075,2/29/2012,1,1,2,20,0,3,1,3,0.42,0.4242,0.88,0.1642,2,95,97,95
10076,2/29/2012,1,1,2,21,0,3,1,3,0.42,0.4242,0.88,0.1642,0,39,39,39
10077,2/29/2012,1,1,2,22,0,3,1,3,0.42,0.4242,0.94,0.2537,2,53,55,53
10078,2/29/2012,1,1,2,23,0,3,1,3,0.42,0.4242,0.94,0.2537,3,30,33,30
10079,3/1/2012,1,1,3,0,0,4,1,2,0.42,0.4242,0.94,0,1,10,11,10
10080,3/1/2012,1,1,3,1,0,4,1,3,0.46,0.4545,0.94,0.1045,0,12,12,12
10081,3/1/2012,1,1,3,2,0,4,1,2,0.46,0.4545,0.94,0.2836,0,6,6,6
10082,3/1/2012,1,1,3,3,0,4,1,1,0.46,0.4545,0.94,0.2239,0,3,3,3
10083,3/1/2012,1,1,3,4,0,4,1,1,0.48,0.4697,0.88,0.194,0,5,5,5
10084,3/1/2012,1,1,3,5,0,4,1,1,0.48,0.4697,0.88,0.1642,0,18,18,18
10085,3/1/2012,1,1,3,6,0,4,1,2,0.42,0.4242,0.94,0,2,107,109,107
10086,3/1/2012,1,1,3,7,0,4,1,2,0.44,0.4394,0.94,0.1343,8,296,304,296
10087,3/1/2012,1,1,3,8,0,4,1,1,0.42,0.4242,0.94,0.1343,15,579,594,579
10088,3/1/2012,1,1,3,9,0,4,1,1,0.46,0.4545,0.77,0.2537,5,281,286,281
10089,3/1/2012,1,1,3,10,0,4,1,1,0.52,0.5,0.55,0.1642,11,122,133,122
10090,3/1/2012,1,1,3,11,0,4,1,1,0.56,0.5303,0.43,0.194,19,149,168,149
10091,3/1/2012,1,1,3,12,0,4,1,1,0.56,0.5303,0.37,0.2239,16,204,220,204
10092,3/1/2012,1,1,3,13,0,4,1,1,0.58,0.5455,0.32,0.2537,24,187,211,187
10093,3/1/2012,1,1,3,14,0,4,1,1,0.58,0.5455,0.35,0.2239,37,174,211,174
10094,3/1/2012,1,1,3,15,0,4,1,1,0.6,0.6212,0.31,0.2537,31,192,223,192
10095,3/1/2012,1,1,3,16,0,4,1,1,0.58,0.5455,0.32,0.2985,38,323,361,323
10096,3/1/2012,1,1,3,17,0,4,1,1,0.56,0.5303,0.35,0.2985,49,551,600,551
10097,3/1/2012,1,1,3,18,0,4,1,1,0.54,0.5152,0.34,0.3582,27,498,525,498
10098,3/1/2012,1,1,3,19,0,4,1,1,0.48,0.4697,0.41,0.3284,11,317,328,317
10099,3/1/2012,1,1,3,20,0,4,1,1,0.44,0.4394,0.44,0.4179,12,242,254,242
10100,3/1/2012,1,1,3,21,0,4,1,1,0.42,0.4242,0.47,0.4627,7,190,197,190
10101,3/1/2012,1,1,3,22,0,4,1,1,0.38,0.3939,0.5,0.2537,3,123,126,123
10102,3/1/2012,1,1,3,23,0,4,1,1,0.36,0.3485,0.5,0.2239,9,76,85,76
10103,3/2/2012,1,1,3,0,0,5,1,1,0.34,0.3333,0.53,0.1642,1,45,46,45
10104,3/2/2012,1,1,3,1,0,5,1,1,0.34,0.3182,0.49,0.2239,2,18,20,18
10105,3/2/2012,1,1,3,2,0,5,1,1,0.34,0.3182,0.53,0.2836,2,4,6,4
10106,3/2/2012,1,1,3,3,0,5,1,1,0.32,0.3182,0.57,0.194,0,3,3,3
10107,3/2/2012,1,1,3,4,0,5,1,1,0.32,0.3485,0.61,0,0,2,2,2
10108,3/2/2012,1,1,3,5,0,5,1,1,0.3,0.3333,0.7,0,0,24,24,24
10109,3/2/2012,1,1,3,6,0,5,1,1,0.3,0.3333,0.7,0,4,88,92,88
10110,3/2/2012,1,1,3,7,0,5,1,1,0.3,0.3333,0.7,0,4,258,262,258
10111,3/2/2012,1,1,3,8,0,5,1,1,0.28,0.303,0.75,0.0896,16,533,549,533
10112,3/2/2012,1,1,3,9,0,5,1,1,0.3,0.3333,0.81,0,15,299,314,299
10113,3/2/2012,1,1,3,10,0,5,1,1,0.36,0.3485,0.5,0.1642,14,118,132,118
10114,3/2/2012,1,1,3,11,0,5,1,1,0.38,0.3939,0.46,0.194,40,154,194,154
10115,3/2/2012,1,1,3,12,0,5,1,1,0.4,0.4091,0.43,0.1642,40,194,234,194
10116,3/2/2012,1,1,3,13,0,5,1,1,0.42,0.4242,0.44,0.2239,31,191,222,191
10117,3/2/2012,1,1,3,14,0,5,1,2,0.44,0.4394,0.44,0.2836,29,176,205,176
10118,3/2/2012,1,1,3,15,0,5,1,2,0.42,0.4242,0.5,0.2985,5,73,78,73
10119,3/2/2012,1,1,3,16,0,5,1,3,0.4,0.4091,0.58,0.2985,1,49,50,49
10120,3/2/2012,1,1,3,17,0,5,1,3,0.36,0.3485,0.81,0.2239,5,123,128,123
10121,3/2/2012,1,1,3,18,0,5,1,3,0.36,0.3485,0.87,0.194,6,154,160,154
10122,3/2/2012,1,1,3,19,0,5,1,3,0.36,0.3485,0.87,0.194,12,162,174,162
10123,3/2/2012,1,1,3,20,0,5,1,2,0.36,0.3485,0.87,0.194,7,93,100,93
10124,3/2/2012,1,1,3,21,0,5,1,3,0.36,0.3636,0.87,0.0896,2,99,101,99
10125,3/2/2012,1,1,3,22,0,5,1,2,0.36,0.3788,0.87,0,6,69,75,69
10126,3/2/2012,1,1,3,23,0,5,1,2,0.36,0.3788,0.87,0,4,19,23,19
10127,3/3/2012,1,1,3,0,0,6,0,3,0.36,0.3636,0.93,0.0896,1,21,22,21
10128,3/3/2012,1,1,3,1,0,6,0,3,0.36,0.3788,0.93,0,0,44,44,44
10129,3/3/2012,1,1,3,2,0,6,0,3,0.36,0.3636,0.93,0.0896,4,34,38,34
10130,3/3/2012,1,1,3,3,0,6,0,2,0.36,0.3485,0.93,0.1642,1,20,21,20
10131,3/3/2012,1,1,3,4,0,6,0,2,0.36,0.3485,0.93,0.194,0,2,2,2
10132,3/3/2012,1,1,3,5,0,6,0,2,0.36,0.3636,0.93,0.0896,1,1,2,1
10133,3/3/2012,1,1,3,6,0,6,0,2,0.36,0.3636,0.93,0.0896,1,6,7,6
10134,3/3/2012,1,1,3,7,0,6,0,2,0.36,0.3485,0.93,0.1343,2,14,16,14
10135,3/3/2012,1,1,3,8,0,6,0,3,0.36,0.3788,0.93,0,2,46,48,46
10136,3/3/2012,1,1,3,9,0,6,0,3,0.38,0.3939,0.87,0.0896,7,87,94,87
10137,3/3/2012,1,1,3,10,0,6,0,2,0.4,0.4091,0.87,0,31,137,168,137
10138,3/3/2012,1,1,3,11,0,6,0,2,0.4,0.4091,0.87,0.0896,33,181,214,181
10139,3/3/2012,1,1,3,12,0,6,0,2,0.42,0.4242,0.67,0.2537,47,252,299,252
10140,3/3/2012,1,1,3,13,0,6,0,1,0.44,0.4394,0.51,0.2836,87,252,339,252
10141,3/3/2012,1,1,3,14,0,6,0,2,0.46,0.4545,0.44,0.3582,151,279,430,279
10142,3/3/2012,1,1,3,15,0,6,0,1,0.48,0.4697,0.29,0.2985,145,254,399,254
10143,3/3/2012,1,1,3,16,0,6,0,1,0.5,0.4848,0.27,0.2985,167,300,467,300
10144,3/3/2012,1,1,3,17,0,6,0,1,0.5,0.4848,0.23,0.3284,106,279,385,279
10145,3/3/2012,1,1,3,18,0,6,0,1,0.5,0.4848,0.25,0.2537,53,250,303,250
10146,3/3/2012,1,1,3,19,0,6,0,1,0.46,0.4545,0.33,0.1642,34,191,225,191
10147,3/3/2012,1,1,3,20,0,6,0,1,0.44,0.4394,0.3,0.1343,28,121,149,121
10148,3/3/2012,1,1,3,21,0,6,0,1,0.46,0.4545,0.19,0.3284,24,130,154,130
10149,3/3/2012,1,1,3,22,0,6,0,1,0.44,0.4394,0.21,0.1343,19,115,134,115
10150,3/3/2012,1,1,3,23,0,6,0,1,0.42,0.4242,0.24,0,12,94,106,94
10151,3/4/2012,1,1,3,0,0,0,0,2,0.4,0.4091,0.3,0.3582,5,67,72,67
10152,3/4/2012,1,1,3,1,0,0,0,2,0.38,0.3939,0.34,0.194,16,60,76,60
10153,3/4/2012,1,1,3,2,0,0,0,2,0.36,0.3485,0.4,0.1642,14,66,80,66
10154,3/4/2012,1,1,3,3,0,0,0,2,0.36,0.3485,0.43,0.1343,5,21,26,21
10155,3/4/2012,1,1,3,4,0,0,0,2,0.34,0.3333,0.46,0.194,3,11,14,11
10156,3/4/2012,1,1,3,5,0,0,0,2,0.34,0.3182,0.46,0.2239,0,5,5,5
10157,3/4/2012,1,1,3,6,0,0,0,2,0.3,0.2727,0.52,0.2985,0,5,5,5
10158,3/4/2012,1,1,3,7,0,0,0,2,0.3,0.2727,0.52,0.2985,2,21,23,21
10159,3/4/2012,1,1,3,8,0,0,0,1,0.3,0.2727,0.52,0.3284,12,54,66,54
10160,3/4/2012,1,1,3,9,0,0,0,1,0.3,0.2727,0.49,0.4478,14,104,118,104
10161,3/4/2012,1,1,3,10,0,0,0,1,0.3,0.2727,0.49,0.3284,31,161,192,161
10162,3/4/2012,1,1,3,11,0,0,0,1,0.32,0.2879,0.45,0.3881,64,192,256,192
10163,3/4/2012,1,1,3,12,0,0,0,1,0.34,0.303,0.42,0.3582,71,256,327,256
10164,3/4/2012,1,1,3,13,0,0,0,1,0.36,0.3333,0.37,0.3582,108,256,364,256
10165,3/4/2012,1,1,3,14,0,0,0,1,0.36,0.3333,0.34,0.3582,106,226,332,226
10166,3/4/2012,1,1,3,15,0,0,0,1,0.36,0.3182,0.32,0.5224,82,252,334,252
10167,3/4/2012,1,1,3,16,0,0,0,1,0.36,0.3182,0.29,0.4925,68,231,299,231
10168,3/4/2012,1,1,3,17,0,0,0,1,0.34,0.2879,0.31,0.5522,49,214,263,214
10169,3/4/2012,1,1,3,18,0,0,0,1,0.32,0.2727,0.33,0.6119,20,164,184,164
10170,3/4/2012,1,1,3,19,0,0,0,1,0.3,0.2576,0.36,0.4925,12,120,132,120
10171,3/4/2012,1,1,3,20,0,0,0,1,0.28,0.2727,0.38,0.2537,8,80,88,80
10172,3/4/2012,1,1,3,21,0,0,0,1,0.28,0.2727,0.36,0.2239,9,70,79,70
10173,3/4/2012,1,1,3,22,0,0,0,1,0.26,0.2424,0.41,0.2537,9,53,62,53
10174,3/4/2012,1,1,3,23,0,0,0,1,0.26,0.2576,0.41,0.194,2,24,26,24
10175,3/5/2012,1,1,3,0,0,1,1,1,0.24,0.2273,0.44,0.194,2,15,17,15
10176,3/5/2012,1,1,3,1,0,1,1,1,0.24,0.2424,0.48,0.1343,3,3,6,3
10177,3/5/2012,1,1,3,2,0,1,1,1,0.24,0.2424,0.48,0.1343,1,3,4,3
10178,3/5/2012,1,1,3,3,0,1,1,1,0.22,0.2273,0.51,0.1642,0,1,1,1
10179,3/5/2012,1,1,3,4,0,1,1,1,0.2,0.2273,0.55,0.0896,0,1,1,1
10180,3/5/2012,1,1,3,5,0,1,1,1,0.2,0.2273,0.55,0.0896,1,17,18,17
10181,3/5/2012,1,1,3,6,0,1,1,1,0.18,0.197,0.59,0.1343,2,89,91,89
10182,3/5/2012,1,1,3,7,0,1,1,1,0.18,0.197,0.59,0.1343,7,253,260,253
10183,3/5/2012,1,1,3,8,0,1,1,1,0.2,0.2273,0.59,0.1045,13,415,428,415
10184,3/5/2012,1,1,3,9,0,1,1,2,0.22,0.2576,0.6,0.0896,11,186,197,186
10185,3/5/2012,1,1,3,10,0,1,1,2,0.24,0.2576,0.6,0,12,74,86,74
10186,3/5/2012,1,1,3,11,0,1,1,2,0.26,0.2727,0.56,0.1343,17,86,103,86
10187,3/5/2012,1,1,3,12,0,1,1,2,0.26,0.303,0.52,0,15,122,137,122
10188,3/5/2012,1,1,3,13,0,1,1,2,0.26,0.2576,0.55,0.2985,11,109,120,109
10189,3/5/2012,1,1,3,14,0,1,1,2,0.28,0.2576,0.57,0.3582,13,115,128,115
10190,3/5/2012,1,1,3,15,0,1,1,2,0.3,0.2879,0.53,0.194,20,110,130,110
10191,3/5/2012,1,1,3,16,0,1,1,1,0.3,0.2727,0.45,0.2985,30,180,210,180
10192,3/5/2012,1,1,3,17,0,1,1,3,0.3,0.2727,0.45,0.2985,11,376,387,376
10193,3/5/2012,1,1,3,18,0,1,1,3,0.28,0.2273,0.55,0.6567,12,363,375,363
10194,3/5/2012,1,1,3,19,0,1,1,1,0.26,0.2576,0.53,0.2239,6,220,226,220
10195,3/5/2012,1,1,3,20,0,1,1,1,0.26,0.2273,0.37,0.4627,8,171,179,171
10196,3/5/2012,1,1,3,21,0,1,1,1,0.26,0.2273,0.37,0.3881,4,116,120,116
10197,3/5/2012,1,1,3,22,0,1,1,1,0.24,0.2121,0.35,0.3284,2,76,78,76
10198,3/5/2012,1,1,3,23,0,1,1,1,0.22,0.1818,0.37,0.5821,2,29,31,29
10199,3/6/2012,1,1,3,0,0,2,1,1,0.22,0.2121,0.37,0.2985,0,8,8,8
10200,3/6/2012,1,1,3,1,0,2,1,1,0.2,0.197,0.44,0.2537,0,6,6,6
10201,3/6/2012,1,1,3,2,0,2,1,1,0.2,0.197,0.44,0.2239,0,4,4,4
10202,3/6/2012,1,1,3,3,0,2,1,1,0.18,0.1667,0.51,0.2836,0,1,1,1
10203,3/6/2012,1,1,3,4,0,2,1,1,0.18,0.1667,0.51,0.2985,0,3,3,3
10204,3/6/2012,1,1,3,5,0,2,1,1,0.18,0.1818,0.51,0.2239,0,25,25,25
10205,3/6/2012,1,1,3,6,0,2,1,1,0.18,0.2121,0.51,0.1045,3,99,102,99
10206,3/6/2012,1,1,3,7,0,2,1,1,0.16,0.1818,0.55,0.1343,5,270,275,270
10207,3/6/2012,1,1,3,8,0,2,1,1,0.16,0.1818,0.59,0.1045,14,487,501,487
10208,3/6/2012,1,1,3,9,0,2,1,1,0.22,0.2727,0.47,0,11,222,233,222
10209,3/6/2012,1,1,3,10,0,2,1,1,0.24,0.2576,0.44,0,16,113,129,113
10210,3/6/2012,1,1,3,11,0,2,1,1,0.26,0.2576,0.41,0.1642,20,110,130,110
10211,3/6/2012,1,1,3,12,0,2,1,1,0.26,0.2727,0.41,0.1045,9,129,138,129
10212,3/6/2012,1,1,3,13,0,2,1,1,0.3,0.303,0.39,0.1343,16,148,164,148
10213,3/6/2012,1,1,3,14,0,2,1,1,0.32,0.303,0.36,0.2239,20,116,136,116
10214,3/6/2012,1,1,3,15,0,2,1,1,0.34,0.303,0.36,0.2985,24,142,166,142
10215,3/6/2012,1,1,3,16,0,2,1,1,0.36,0.3333,0.32,0.2836,22,228,250,228
10216,3/6/2012,1,1,3,17,0,2,1,1,0.36,0.3333,0.34,0.2836,21,425,446,425
10217,3/6/2012,1,1,3,18,0,2,1,1,0.34,0.303,0.42,0.3284,15,442,457,442
10218,3/6/2012,1,1,3,19,0,2,1,1,0.34,0.303,0.46,0.2985,9,278,287,278
10219,3/6/2012,1,1,3,20,0,2,1,1,0.32,0.3182,0.49,0.194,3,184,187,184
10220,3/6/2012,1,1,3,21,0,2,1,1,0.32,0.3182,0.49,0.194,5,143,148,143
10221,3/6/2012,1,1,3,22,0,2,1,1,0.28,0.2727,0.56,0.1642,5,101,106,101
10222,3/6/2012,1,1,3,23,0,2,1,1,0.28,0.2727,0.61,0.2239,3,51,54,51
10223,3/7/2012,1,1,3,0,0,3,1,1,0.28,0.2576,0.65,0.2836,3,12,15,12
10224,3/7/2012,1,1,3,1,0,3,1,1,0.3,0.2727,0.61,0.2985,1,4,5,4
10225,3/7/2012,1,1,3,2,0,3,1,1,0.3,0.2879,0.56,0.2836,0,4,4,4
10226,3/7/2012,1,1,3,3,0,3,1,1,0.3,0.2727,0.56,0.3582,1,2,3,2
10227,3/7/2012,1,1,3,4,0,3,1,1,0.28,0.2576,0.61,0.3284,0,3,3,3
10228,3/7/2012,1,1,3,5,0,3,1,1,0.28,0.2576,0.56,0.2985,0,18,18,18
10229,3/7/2012,1,1,3,6,0,3,1,1,0.28,0.2576,0.61,0.3881,4,104,108,104
10230,3/7/2012,1,1,3,7,0,3,1,1,0.26,0.2273,0.65,0.3881,12,332,344,332
10231,3/7/2012,1,1,3,8,0,3,1,1,0.28,0.2576,0.61,0.2985,12,554,566,554
10232,3/7/2012,1,1,3,9,0,3,1,1,0.3,0.2727,0.61,0.3284,12,252,264,252
10233,3/7/2012,1,1,3,10,0,3,1,1,0.36,0.3333,0.5,0.2985,20,127,147,127
10234,3/7/2012,1,1,3,11,0,3,1,1,0.42,0.4242,0.38,0.2985,33,128,161,128
10235,3/7/2012,1,1,3,12,0,3,1,1,0.44,0.4394,0.38,0.3881,40,175,215,175
10236,3/7/2012,1,1,3,13,0,3,1,1,0.5,0.4848,0.34,0.4179,26,179,205,179
10237,3/7/2012,1,1,3,14,0,3,1,1,0.52,0.5,0.36,0.3284,38,137,175,137
10238,3/7/2012,1,1,3,15,0,3,1,1,0.54,0.5152,0.37,0.4478,44,165,209,165
10239,3/7/2012,1,1,3,16,0,3,1,1,0.56,0.5303,0.37,0.4179,34,254,288,254
10240,3/7/2012,1,1,3,17,0,3,1,1,0.56,0.5303,0.43,0.4925,58,554,612,554
10241,3/7/2012,1,1,3,18,0,3,1,1,0.56,0.5303,0.4,0.4627,35,509,544,509
10242,3/7/2012,1,1,3,19,0,3,1,1,0.54,0.5152,0.42,0.3582,16,345,361,345
10243,3/7/2012,1,1,3,20,0,3,1,1,0.5,0.4848,0.51,0.2537,18,242,260,242
10244,3/7/2012,1,1,3,21,0,3,1,1,0.44,0.4394,0.62,0.2537,11,177,188,177
10245,3/7/2012,1,1,3,22,0,3,1,1,0.46,0.4545,0.59,0.2985,10,149,159,149
10246,3/7/2012,1,1,3,23,0,3,1,1,0.44,0.4394,0.62,0.3284,4,58,62,58
10247,3/8/2012,1,1,3,0,0,4,1,1,0.44,0.4394,0.62,0.3284,11,35,46,35
10248,3/8/2012,1,1,3,1,0,4,1,1,0.46,0.4545,0.63,0.3284,4,17,21,17
10249,3/8/2012,1,1,3,2,0,4,1,1,0.46,0.4545,0.63,0.3881,6,5,11,5
10250,3/8/2012,1,1,3,3,0,4,1,1,0.46,0.4545,0.63,0.3881,0,3,3,3
10251,3/8/2012,1,1,3,4,0,4,1,1,0.44,0.4394,0.72,0.2836,0,2,2,2
10252,3/8/2012,1,1,3,5,0,4,1,1,0.42,0.4242,0.77,0.2239,1,28,29,28
10253,3/8/2012,1,1,3,6,0,4,1,1,0.42,0.4242,0.77,0.2537,4,105,109,105
10254,3/8/2012,1,1,3,7,0,4,1,1,0.42,0.4242,0.77,0.3582,8,326,334,326
10255,3/8/2012,1,1,3,8,0,4,1,1,0.44,0.4394,0.77,0.3881,12,573,585,573
10256,3/8/2012,1,1,3,9,0,4,1,1,0.46,0.4545,0.72,0.4627,19,282,301,282
10257,3/8/2012,1,1,3,10,0,4,1,1,0.5,0.4848,0.68,0.4627,19,119,138,119
10258,3/8/2012,1,1,3,11,0,4,1,2,0.54,0.5152,0.6,0.4627,48,156,204,156
10259,3/8/2012,1,1,3,12,0,4,1,2,0.56,0.5303,0.6,0.4478,27,224,251,224
10260,3/8/2012,1,1,3,13,0,4,1,2,0.6,0.6212,0.49,0.6418,35,198,233,198
10261,3/8/2012,1,1,3,14,0,4,1,2,0.62,0.6212,0.43,0.6418,48,155,203,155
10262,3/8/2012,1,1,3,15,0,4,1,1,0.64,0.6212,0.38,0.6866,24,161,185,161
10263,3/8/2012,1,1,3,16,0,4,1,2,0.62,0.6212,0.41,0.6418,37,305,342,305
10264,3/8/2012,1,1,3,17,0,4,1,1,0.62,0.6212,0.38,0.6567,52,545,597,545
10265,3/8/2012,1,1,3,18,0,4,1,2,0.62,0.6212,0.38,0.5522,45,545,590,545
10266,3/8/2012,1,1,3,19,0,4,1,2,0.6,0.6212,0.4,0.4478,21,395,416,395
10267,3/8/2012,1,1,3,20,0,4,1,2,0.6,0.6212,0.43,0.3881,20,282,302,282
10268,3/8/2012,1,1,3,21,0,4,1,1,0.6,0.6212,0.43,0.3881,27,206,233,206
10269,3/8/2012,1,1,3,22,0,4,1,1,0.56,0.5303,0.49,0.3284,12,141,153,141
10270,3/8/2012,1,1,3,23,0,4,1,2,0.56,0.5303,0.49,0.4478,6,88,94,88
10271,3/9/2012,1,1,3,0,0,5,1,2,0.58,0.5455,0.49,0.4627,3,51,54,51
10272,3/9/2012,1,1,3,1,0,5,1,3,0.56,0.5303,0.52,0.4925,4,22,26,22
10273,3/9/2012,1,1,3,2,0,5,1,3,0.48,0.4697,0.77,0.4179,2,9,11,9
10274,3/9/2012,1,1,3,3,0,5,1,1,0.46,0.4545,0.77,0.5224,0,7,7,7
10275,3/9/2012,1,1,3,4,0,5,1,3,0.4,0.4091,0.66,0.2836,0,1,1,1
10276,3/9/2012,1,1,3,5,0,5,1,3,0.4,0.4091,0.66,0.2836,2,27,29,27
10277,3/9/2012,1,1,3,6,0,5,1,2,0.4,0.4091,0.5,0.3582,2,83,85,83
10278,3/9/2012,1,1,3,7,0,5,1,2,0.38,0.3939,0.4,0.2985,6,262,268,262
10279,3/9/2012,1,1,3,8,0,5,1,2,0.34,0.2879,0.42,0.5224,17,484,501,484
10280,3/9/2012,1,1,3,9,0,5,1,2,0.34,0.2879,0.42,0.5224,17,267,284,267
10281,3/9/2012,1,1,3,10,0,5,1,2,0.34,0.2879,0.36,0.4925,14,145,159,145
10282,3/9/2012,1,1,3,11,0,5,1,2,0.36,0.3333,0.34,0.3582,17,170,187,170
10283,3/9/2012,1,1,3,12,0,5,1,1,0.36,0.3333,0.34,0.4179,27,174,201,174
10284,3/9/2012,1,1,3,13,0,5,1,2,0.38,0.3939,0.29,0.3881,49,175,224,175
10285,3/9/2012,1,1,3,14,0,5,1,1,0.42,0.4242,0.28,0.4627,49,129,178,129
10286,3/9/2012,1,1,3,15,0,5,1,1,0.46,0.4545,0.24,0.2537,50,188,238,188
10287,3/9/2012,1,1,3,16,0,5,1,1,0.48,0.4697,0.23,0.4179,51,292,343,292
10288,3/9/2012,1,1,3,17,0,5,1,1,0.46,0.4545,0.24,0.3881,68,498,566,498
10289,3/9/2012,1,1,3,18,0,5,1,1,0.44,0.4394,0.26,0.5224,30,440,470,440
10290,3/9/2012,1,1,3,19,0,5,1,1,0.42,0.4242,0.28,0.6119,12,232,244,232
10291,3/9/2012,1,1,3,20,0,5,1,1,0.38,0.3939,0.32,0.3582,3,156,159,156
10292,3/9/2012,1,1,3,21,0,5,1,1,0.36,0.3333,0.34,0.3284,8,133,141,133
10293,3/9/2012,1,1,3,22,0,5,1,1,0.34,0.2879,0.31,0.4925,7,100,107,100
10294,3/9/2012,1,1,3,23,0,5,1,1,0.32,0.303,0.33,0.2985,9,77,86,77
10295,3/10/2012,1,1,3,0,0,6,0,1,0.3,0.2727,0.36,0.3582,9,68,77,68
10296,3/10/2012,1,1,3,1,0,6,0,1,0.3,0.2879,0.36,0.2537,1,50,51,50
10297,3/10/2012,1,1,3,2,0,6,0,1,0.26,0.2424,0.41,0.2537,12,30,42,30
10298,3/10/2012,1,1,3,3,0,6,0,1,0.26,0.2273,0.41,0.2985,0,16,16,16
10299,3/10/2012,1,1,3,4,0,6,0,1,0.24,0.2121,0.41,0.3582,1,3,4,3
10300,3/10/2012,1,1,3,5,0,6,0,1,0.22,0.2121,0.42,0.2836,3,7,10,7
10301,3/10/2012,1,1,3,6,0,6,0,1,0.22,0.2121,0.44,0.2836,1,11,12,11
10302,3/10/2012,1,1,3,7,0,6,0,1,0.22,0.2121,0.44,0.2537,4,36,40,36
10303,3/10/2012,1,1,3,8,0,6,0,1,0.22,0.2121,0.44,0.2985,15,96,111,96
10304,3/10/2012,1,1,3,9,0,6,0,1,0.24,0.2121,0.41,0.3284,21,127,148,127
10305,3/10/2012,1,1,3,10,0,6,0,1,0.26,0.2273,0.35,0.4179,47,176,223,176
10306,3/10/2012,1,1,3,11,0,6,0,1,0.3,0.2727,0.33,0.3284,56,218,274,218
10307,3/10/2012,1,1,3,12,0,6,0,1,0.3,0.2727,0.33,0.3284,88,241,329,241
10308,3/10/2012,1,1,3,13,0,6,0,1,0.32,0.303,0.29,0.2836,89,268,357,268
10309,3/10/2012,1,1,3,14,0,6,0,1,0.34,0.3182,0.27,0.2836,117,262,379,262
10310,3/10/2012,1,1,3,15,0,6,0,1,0.34,0.3636,0.25,0,132,274,406,274
10311,3/10/2012,1,1,3,16,0,6,0,1,0.36,0.3636,0.23,0,115,275,390,275
10312,3/10/2012,1,1,3,17,0,6,0,1,0.36,0.3788,0.23,0,104,250,354,250
10313,3/10/2012,1,1,3,18,0,6,0,1,0.36,0.3636,0.21,0.0896,67,230,297,230
10314,3/10/2012,1,1,3,19,0,6,0,1,0.34,0.3636,0.25,0,25,159,184,159
10315,3/10/2012,1,1,3,20,0,6,0,1,0.32,0.3333,0.33,0.1343,20,101,121,101
10316,3/10/2012,1,1,3,21,0,6,0,1,0.3,0.2879,0.39,0.2239,16,94,110,94
10317,3/10/2012,1,1,3,22,0,6,0,1,0.26,0.2576,0.44,0.1642,19,81,100,81
10318,3/10/2012,1,1,3,23,0,6,0,1,0.26,0.2576,0.41,0.194,6,77,83,77
10319,3/11/2012,1,1,3,0,0,0,0,1,0.26,0.2879,0.44,0.0896,7,62,69,62
10320,3/11/2012,1,1,3,1,0,0,0,1,0.24,0.2424,0.52,0.1642,4,57,61,57
10321,3/11/2012,1,1,3,3,0,0,0,1,0.24,0.2424,0.6,0.1343,15,51,66,51
10322,3/11/2012,1,1,3,4,0,0,0,1,0.24,0.2424,0.6,0.1343,7,15,22,15
10323,3/11/2012,1,1,3,5,0,0,0,1,0.24,0.2424,0.6,0.1642,2,5,7,5
10324,3/11/2012,1,1,3,6,0,0,0,1,0.24,0.2424,0.7,0.1642,2,8,10,8
10325,3/11/2012,1,1,3,7,0,0,0,1,0.22,0.2273,0.69,0.1343,2,15,17,15
10326,3/11/2012,1,1,3,8,0,0,0,1,0.22,0.2273,0.69,0.1343,4,68,72,68
10327,3/11/2012,1,1,3,9,0,0,0,1,0.26,0.2576,0.6,0.2239,20,70,90,70
10328,3/11/2012,1,1,3,10,0,0,0,1,0.32,0.303,0.49,0.2836,71,147,218,147
10329,3/11/2012,1,1,3,11,0,0,0,1,0.36,0.3333,0.43,0.2836,90,209,299,209
10330,3/11/2012,1,1,3,12,0,0,0,1,0.4,0.4091,0.37,0.2985,146,264,410,264
10331,3/11/2012,1,1,3,13,0,0,0,1,0.42,0.4242,0.41,0.2985,176,288,464,288
10332,3/11/2012,1,1,3,14,0,0,0,1,0.46,0.4545,0.31,0.2836,212,289,501,289
10333,3/11/2012,1,1,3,15,0,0,0,1,0.5,0.4848,0.29,0.2985,201,286,487,286
10334,3/11/2012,1,1,3,16,0,0,0,1,0.5,0.4848,0.31,0.3582,208,301,509,301
10335,3/11/2012,1,1,3,17,0,0,0,1,0.52,0.5,0.27,0.2985,199,299,498,299
10336,3/11/2012,1,1,3,18,0,0,0,1,0.52,0.5,0.29,0.2836,133,256,389,256
10337,3/11/2012,1,1,3,19,0,0,0,1,0.5,0.4848,0.31,0.2836,55,203,258,203
10338,3/11/2012,1,1,3,20,0,0,0,1,0.44,0.4394,0.47,0.2239,42,129,171,129
10339,3/11/2012,1,1,3,21,0,0,0,1,0.42,0.4242,0.54,0.2239,37,110,147,110
10340,3/11/2012,1,1,3,22,0,0,0,1,0.4,0.4091,0.54,0.194,13,81,94,81
10341,3/11/2012,1,1,3,23,0,0,0,1,0.4,0.4091,0.5,0.1642,12,40,52,40
10342,3/12/2012,1,1,3,0,0,1,1,1,0.38,0.3939,0.54,0.194,4,20,24,20
10343,3/12/2012,1,1,3,1,0,1,1,1,0.38,0.3939,0.5,0.1343,1,9,10,9
10344,3/12/2012,1,1,3,2,0,1,1,1,0.38,0.3939,0.54,0.1045,4,5,9,5
10345,3/12/2012,1,1,3,3,0,1,1,1,0.36,0.3485,0.5,0.1343,0,2,2,2
10346,3/12/2012,1,1,3,4,0,1,1,1,0.34,0.3333,0.61,0.194,0,3,3,3
10347,3/12/2012,1,1,3,5,0,1,1,1,0.34,0.3333,0.61,0.194,1,15,16,15
10348,3/12/2012,1,1,3,6,0,1,1,1,0.34,0.3485,0.57,0.1045,2,86,88,86
10349,3/12/2012,1,1,3,7,0,1,1,1,0.34,0.3485,0.53,0.1045,9,259,268,259
10350,3/12/2012,1,1,3,8,0,1,1,1,0.34,0.3333,0.61,0.1343,17,547,564,547
10351,3/12/2012,1,1,3,9,0,1,1,1,0.38,0.3939,0.54,0.1642,21,260,281,260
10352,3/12/2012,1,1,3,10,0,1,1,1,0.4,0.4091,0.5,0.2239,39,98,137,98
10353,3/12/2012,1,1,3,11,0,1,1,1,0.44,0.4394,0.44,0.2239,39,111,150,111
10354,3/12/2012,1,1,3,12,0,1,1,1,0.48,0.4697,0.39,0.2239,59,162,221,162
10355,3/12/2012,1,1,3,13,0,1,1,2,0.54,0.5152,0.32,0.2537,74,176,250,176
10356,3/12/2012,1,1,3,14,0,1,1,2,0.58,0.5455,0.32,0.2836,76,145,221,145
10357,3/12/2012,1,1,3,15,0,1,1,1,0.56,0.5303,0.4,0.1343,74,159,233,159
10358,3/12/2012,1,1,3,16,0,1,1,1,0.62,0.6212,0.35,0.4478,77,255,332,255
10359,3/12/2012,1,1,3,17,0,1,1,2,0.62,0.6212,0.38,0.4179,87,557,644,557
10360,3/12/2012,1,1,3,18,0,1,1,2,0.6,0.6212,0.43,0.194,89,623,712,623
10361,3/12/2012,1,1,3,19,0,1,1,2,0.56,0.5303,0.49,0.2239,67,379,446,379
10362,3/12/2012,1,1,3,20,0,1,1,2,0.56,0.5303,0.49,0.2239,49,237,286,237
10363,3/12/2012,1,1,3,21,0,1,1,2,0.54,0.5152,0.56,0.2239,22,183,205,183
10364,3/12/2012,1,1,3,22,0,1,1,2,0.56,0.5303,0.56,0.2239,17,116,133,116
10365,3/12/2012,1,1,3,23,0,1,1,1,0.56,0.5303,0.56,0.2239,10,53,63,53
10366,3/13/2012,1,1,3,0,0,2,1,2,0.56,0.5303,0.52,0.194,5,21,26,21
10367,3/13/2012,1,1,3,1,0,2,1,2,0.52,0.5,0.59,0.2239,2,14,16,14
10368,3/13/2012,1,1,3,2,0,2,1,3,0.52,0.5,0.72,0.2985,0,1,1,1
10369,3/13/2012,1,1,3,3,0,2,1,3,0.52,0.5,0.72,0.2985,0,2,2,2
10370,3/13/2012,1,1,3,4,0,2,1,2,0.46,0.4545,0.82,0.194,0,1,1,1
10371,3/13/2012,1,1,3,5,0,2,1,2,0.46,0.4545,0.82,0.194,0,24,24,24
10372,3/13/2012,1,1,3,6,0,2,1,3,0.46,0.4545,0.82,0.194,5,108,113,108
10373,3/13/2012,1,1,3,7,0,2,1,2,0.46,0.4545,0.82,0.2836,16,292,308,292
10374,3/13/2012,1,1,3,8,0,2,1,1,0.46,0.4545,0.82,0.2836,22,571,593,571
10375,3/13/2012,1,1,3,9,0,2,1,1,0.48,0.4697,0.82,0.2836,18,324,342,324
10376,3/13/2012,1,1,3,10,0,2,1,1,0.52,0.5,0.77,0.2239,28,115,143,115
10377,3/13/2012,1,1,3,11,0,2,1,1,0.54,0.5152,0.73,0.2836,64,155,219,155
10378,3/13/2012,1,1,3,12,0,2,1,1,0.6,0.6061,0.6,0.2836,47,197,244,197
10379,3/13/2012,1,1,3,13,0,2,1,1,0.6,0.6061,0.6,0.3881,53,180,233,180
10380,3/13/2012,1,1,3,14,0,2,1,1,0.64,0.6212,0.53,0.3284,52,160,212,160
10381,3/13/2012,1,1,3,15,0,2,1,1,0.7,0.6364,0.39,0.2239,68,196,264,196
10382,3/13/2012,1,1,3,16,0,2,1,1,0.72,0.6515,0.34,0.3881,53,312,365,312
10383,3/13/2012,1,1,3,17,0,2,1,1,0.7,0.6364,0.37,0.1045,62,614,676,614
10384,3/13/2012,1,1,3,18,0,2,1,1,0.7,0.6364,0.34,0.2985,96,638,734,638
10385,3/13/2012,1,1,3,19,0,2,1,1,0.64,0.6212,0.47,0.2239,50,429,479,429
10386,3/13/2012,1,1,3,20,0,2,1,1,0.6,0.6212,0.49,0.1642,45,306,351,306
10387,3/13/2012,1,1,3,21,0,2,1,1,0.58,0.5455,0.56,0.1045,44,200,244,200
10388,3/13/2012,1,1,3,22,0,2,1,1,0.56,0.5303,0.6,0.0896,24,146,170,146
10389,3/13/2012,1,1,3,23,0,2,1,1,0.56,0.5303,0.56,0.1343,8,79,87,79
10390,3/14/2012,1,1,3,0,0,3,1,1,0.54,0.5152,0.6,0.1045,5,34,39,34
10391,3/14/2012,1,1,3,1,0,3,1,1,0.52,0.5,0.63,0.0896,2,25,27,25
10392,3/14/2012,1,1,3,2,0,3,1,1,0.5,0.4848,0.68,0.194,0,2,2,2
10393,3/14/2012,1,1,3,3,0,3,1,1,0.48,0.4697,0.72,0.194,1,3,4,3
10394,3/14/2012,1,1,3,4,0,3,1,1,0.48,0.4697,0.67,0.0896,1,4,5,4
10395,3/14/2012,1,1,3,5,0,3,1,1,0.44,0.4394,0.82,0.1343,2,25,27,25
10396,3/14/2012,1,1,3,6,0,3,1,1,0.44,0.4394,0.82,0.0896,1,120,121,120
10397,3/14/2012,1,1,3,7,0,3,1,1,0.44,0.4394,0.82,0.1045,20,348,368,348
10398,3/14/2012,1,1,3,8,0,3,1,1,0.44,0.4394,0.82,0,34,628,662,628
10399,3/14/2012,1,1,3,9,0,3,1,1,0.52,0.5,0.68,0,26,325,351,325
10400,3/14/2012,1,1,3,10,0,3,1,1,0.56,0.5303,0.56,0.1045,38,150,188,150
10401,3/14/2012,1,1,3,11,0,3,1,2,0.62,0.6212,0.41,0.1642,65,155,220,155
10402,3/14/2012,1,1,3,12,0,3,1,2,0.64,0.6212,0.29,0,55,212,267,212
10403,3/14/2012,1,1,3,13,0,3,1,1,0.66,0.6212,0.27,0.2239,57,197,254,197
10404,3/14/2012,1,1,3,14,0,3,1,1,0.7,0.6364,0.23,0.3284,61,163,224,163
10405,3/14/2012,1,1,3,15,0,3,1,1,0.7,0.6364,0.24,0,86,197,283,197
10406,3/14/2012,1,1,3,16,0,3,1,1,0.72,0.6364,0.25,0.194,78,278,356,278
10407,3/14/2012,1,1,3,17,0,3,1,1,0.7,0.6364,0.28,0.0896,140,642,782,642
10408,3/14/2012,1,1,3,18,0,3,1,1,0.7,0.6364,0.32,0,102,647,749,647
10409,3/14/2012,1,1,3,19,0,3,1,1,0.64,0.6212,0.33,0.1642,70,402,472,402
10410,3/14/2012,1,1,3,20,0,3,1,1,0.62,0.6212,0.35,0.1045,44,286,330,286
10411,3/14/2012,1,1,3,21,0,3,1,1,0.6,0.6212,0.4,0.0896,47,241,288,241
10412,3/14/2012,1,1,3,22,0,3,1,1,0.52,0.5,0.55,0.1343,43,159,202,159
10413,3/14/2012,1,1,3,23,0,3,1,1,0.56,0.5303,0.43,0.1642,19,72,91,72
10414,3/15/2012,1,1,3,0,0,4,1,1,0.54,0.5152,0.49,0.1343,14,46,60,46
10415,3/15/2012,1,1,3,1,0,4,1,1,0.5,0.4848,0.59,0.1045,15,8,23,8
10416,3/15/2012,1,1,3,2,0,4,1,1,0.5,0.4848,0.59,0,14,5,19,5
10417,3/15/2012,1,1,3,3,0,4,1,1,0.5,0.4848,0.63,0,0,7,7,7
10418,3/15/2012,1,1,3,4,0,4,1,1,0.44,0.4394,0.77,0.1045,11,3,14,3
10419,3/15/2012,1,1,3,5,0,4,1,1,0.46,0.4545,0.67,0,2,24,26,24
10420,3/15/2012,1,1,3,6,0,4,1,1,0.44,0.4394,0.72,0.0896,4,113,117,113
10421,3/15/2012,1,1,3,7,0,4,1,1,0.44,0.4394,0.72,0.0896,14,367,381,367
10422,3/15/2012,1,1,3,8,0,4,1,1,0.44,0.4394,0.77,0.1045,21,602,623,602
10423,3/15/2012,1,1,3,9,0,4,1,1,0.48,0.4697,0.77,0.0896,30,285,315,285
10424,3/15/2012,1,1,3,10,0,4,1,1,0.52,0.5,0.68,0.1045,34,130,164,130
10425,3/15/2012,1,1,3,11,0,4,1,1,0.56,0.5303,0.6,0.1343,60,151,211,151
10426,3/15/2012,1,1,3,12,0,4,1,2,0.62,0.6212,0.5,0.1343,59,206,265,206
10427,3/15/2012,1,1,3,13,0,4,1,2,0.66,0.6212,0.41,0.0896,62,211,273,211
10428,3/15/2012,1,1,3,14,0,4,1,2,0.72,0.6515,0.3,0.1045,81,177,258,177
10429,3/15/2012,1,1,3,15,0,4,1,1,0.72,0.6515,0.32,0.2239,100,187,287,187
10430,3/15/2012,1,1,3,16,0,4,1,1,0.72,0.6515,0.37,0.3881,95,331,426,331
10431,3/15/2012,1,1,3,17,0,4,1,1,0.7,0.6364,0.39,0.2537,79,634,713,634
10432,3/15/2012,1,1,3,18,0,4,1,1,0.66,0.6212,0.44,0.2836,98,648,746,648
10433,3/15/2012,1,1,3,19,0,4,1,2,0.64,0.6212,0.5,0.194,72,353,425,353
10434,3/15/2012,1,1,3,20,0,4,1,2,0.58,0.5455,0.6,0.3582,60,270,330,270
10435,3/15/2012,1,1,3,21,0,4,1,1,0.54,0.5152,0.68,0.2836,36,207,243,207
10436,3/15/2012,1,1,3,22,0,4,1,1,0.52,0.5,0.68,0.1343,32,137,169,137
10437,3/15/2012,1,1,3,23,0,4,1,1,0.48,0.4697,0.72,0.194,12,85,97,85
10438,3/16/2012,1,1,3,0,0,5,1,1,0.44,0.4394,0.77,0.2537,8,49,57,49
10439,3/16/2012,1,1,3,1,0,5,1,2,0.42,0.4242,0.82,0.3284,4,22,26,22
10440,3/16/2012,1,1,3,2,0,5,1,2,0.42,0.4242,0.82,0.194,0,4,4,4
10441,3/16/2012,1,1,3,3,0,5,1,2,0.4,0.4091,0.87,0.2836,0,3,3,3
10442,3/16/2012,1,1,3,4,0,5,1,2,0.4,0.4091,0.87,0.2537,0,3,3,3
10443,3/16/2012,1,1,3,5,0,5,1,2,0.4,0.4091,0.87,0.2239,2,30,32,30
10444,3/16/2012,1,1,3,6,0,5,1,2,0.4,0.4091,0.87,0.1642,3,96,99,96
10445,3/16/2012,1,1,3,7,0,5,1,2,0.4,0.4091,0.87,0.194,13,265,278,265
10446,3/16/2012,1,1,3,8,0,5,1,2,0.4,0.4091,0.87,0.2239,28,534,562,534
10447,3/16/2012,1,1,3,9,0,5,1,2,0.42,0.4242,0.82,0,35,277,312,277
10448,3/16/2012,1,1,3,10,0,5,1,2,0.4,0.4091,0.87,0.0896,44,136,180,136
10449,3/16/2012,1,1,3,11,0,5,1,2,0.44,0.4394,0.77,0,40,167,207,167
10450,3/16/2012,1,1,3,12,0,5,1,2,0.44,0.4394,0.82,0.1343,72,222,294,222
10451,3/16/2012,1,1,3,13,0,5,1,2,0.46,0.4545,0.77,0.0896,52,208,260,208
10452,3/16/2012,1,1,3,14,0,5,1,2,0.48,0.4697,0.72,0,56,146,202,146
10453,3/16/2012,1,1,3,15,0,5,1,3,0.46,0.4545,0.82,0.1045,19,88,107,88
10454,3/16/2012,1,1,3,16,0,5,1,3,0.48,0.4697,0.77,0,18,111,129,111
10455,3/16/2012,1,1,3,17,0,5,1,3,0.48,0.4697,0.82,0.0896,23,235,258,235
10456,3/16/2012,1,1,3,18,0,5,1,3,0.48,0.4697,0.82,0.0896,31,377,408,377
10457,3/16/2012,1,1,3,19,0,5,1,2,0.46,0.4545,0.88,0,23,273,296,273
10458,3/16/2012,1,1,3,20,0,5,1,1,0.46,0.4545,0.88,0,31,204,235,204
10459,3/16/2012,1,1,3,21,0,5,1,2,0.44,0.4394,0.94,0,8,144,152,144
10460,3/16/2012,1,1,3,22,0,5,1,2,0.44,0.4394,0.94,0,16,132,148,132
10461,3/16/2012,1,1,3,23,0,5,1,2,0.44,0.4394,0.94,0,22,104,126,104
10462,3/17/2012,1,1,3,0,0,6,0,2,0.44,0.4394,0.94,0.0896,13,87,100,87
10463,3/17/2012,1,1,3,1,0,6,0,2,0.44,0.4394,0.94,0,12,57,69,57
10464,3/17/2012,1,1,3,2,0,6,0,2,0.44,0.4394,0.88,0,10,32,42,32
10465,3/17/2012,1,1,3,3,0,6,0,2,0.44,0.4394,0.88,0,2,24,26,24
10466,3/17/2012,1,1,3,4,0,6,0,2,0.42,0.4242,0.94,0,0,2,2,2
10467,3/17/2012,1,1,3,5,0,6,0,2,0.42,0.4242,0.94,0.0896,5,3,8,3
10468,3/17/2012,1,1,3,6,0,6,0,2,0.42,0.4242,0.94,0.194,1,29,30,29
10469,3/17/2012,1,1,3,7,0,6,0,2,0.4,0.4091,1,0.1343,29,57,86,57
10470,3/17/2012,1,1,3,8,0,6,0,2,0.42,0.4242,0.94,0.1045,63,155,218,155
10471,3/17/2012,1,1,3,9,0,6,0,2,0.44,0.4394,0.88,0.0896,104,217,321,217
10472,3/17/2012,1,1,3,10,0,6,0,2,0.5,0.4848,0.77,0.0896,140,303,443,303
10473,3/17/2012,1,1,3,11,0,6,0,2,0.52,0.5,0.77,0.1343,226,359,585,359
10474,3/17/2012,1,1,3,12,0,6,0,1,0.56,0.5303,0.68,0.1642,286,365,651,365
10475,3/17/2012,1,1,3,13,0,6,0,1,0.6,0.6061,0.6,0.1045,286,400,686,400
10476,3/17/2012,1,1,3,14,0,6,0,1,0.62,0.6212,0.53,0.0896,352,338,690,338
10477,3/17/2012,1,1,3,15,0,6,0,1,0.64,0.6212,0.53,0.1343,357,322,679,322
10478,3/17/2012,1,1,3,16,0,6,0,1,0.64,0.6212,0.5,0,367,318,685,318
10479,3/17/2012,1,1,3,17,0,6,0,1,0.64,0.6212,0.5,0.1343,291,357,648,357
10480,3/17/2012,1,1,3,18,0,6,0,1,0.62,0.6212,0.57,0.2985,221,339,560,339
10481,3/17/2012,1,1,3,19,0,6,0,1,0.58,0.5455,0.64,0.2836,155,262,417,262
10482,3/17/2012,1,1,3,20,0,6,0,1,0.56,0.5303,0.64,0.194,89,182,271,182
10483,3/17/2012,1,1,3,21,0,6,0,1,0.54,0.5152,0.68,0.1642,54,169,223,169
10484,3/17/2012,1,1,3,22,0,6,0,1,0.54,0.5152,0.68,0,58,153,211,153
10485,3/17/2012,1,1,3,23,0,6,0,1,0.5,0.4848,0.77,0.1642,34,151,185,151
10486,3/18/2012,1,1,3,0,0,0,0,1,0.46,0.4545,0.88,0.194,27,80,107,80
10487,3/18/2012,1,1,3,1,0,0,0,1,0.46,0.4545,0.82,0.1343,25,88,113,88
10488,3/18/2012,1,1,3,2,0,0,0,2,0.46,0.4545,0.82,0.1045,15,41,56,41
10489,3/18/2012,1,1,3,3,0,0,0,2,0.44,0.4394,0.88,0.1343,3,15,18,15
10490,3/18/2012,1,1,3,4,0,0,0,2,0.42,0.4242,0.94,0.1642,6,8,14,8
10491,3/18/2012,1,1,3,5,0,0,0,2,0.4,0.4091,0.94,0.1045,0,6,6,6
10492,3/18/2012,1,1,3,6,0,0,0,2,0.4,0.4091,0.94,0.1045,2,9,11,9
10493,3/18/2012,1,1,3,7,0,0,0,3,0.42,0.4242,0.88,0.1642,17,25,42,25
10494,3/18/2012,1,1,3,8,0,0,0,2,0.42,0.4242,0.88,0.1045,25,71,96,71
10495,3/18/2012,1,1,3,9,0,0,0,2,0.42,0.4242,0.88,0.0896,65,113,178,113
10496,3/18/2012,1,1,3,10,0,0,0,2,0.42,0.4242,0.88,0.1045,139,212,351,212
10497,3/18/2012,1,1,3,11,0,0,0,2,0.44,0.4394,0.82,0.1642,129,239,368,239
10498,3/18/2012,1,1,3,12,0,0,0,2,0.44,0.4394,0.88,0.1343,222,281,503,281
10499,3/18/2012,1,1,3,13,0,0,0,2,0.46,0.4545,0.82,0.1642,198,346,544,346
10500,3/18/2012,1,1,3,14,0,0,0,2,0.5,0.4848,0.77,0.0896,218,303,521,303
10501,3/18/2012,1,1,3,15,0,0,0,1,0.54,0.5152,0.68,0.0896,240,314,554,314
10502,3/18/2012,1,1,3,16,0,0,0,1,0.54,0.5152,0.73,0.0896,229,312,541,312
10503,3/18/2012,1,1,3,17,0,0,0,1,0.56,0.5303,0.64,0.0896,233,308,541,308
10504,3/18/2012,1,1,3,18,0,0,0,1,0.56,0.5303,0.64,0.1642,165,294,459,294
10505,3/18/2012,1,1,3,19,0,0,0,1,0.56,0.5303,0.64,0.1642,118,234,352,234
10506,3/18/2012,1,1,3,20,0,0,0,1,0.52,0.5,0.77,0.1343,59,139,198,139
10507,3/18/2012,1,1,3,21,0,0,0,1,0.52,0.5,0.72,0.0896,44,129,173,129
10508,3/18/2012,1,1,3,22,0,0,0,1,0.5,0.4848,0.77,0.1045,21,79,100,79
10509,3/18/2012,1,1,3,23,0,0,0,1,0.48,0.4697,0.82,0.1642,7,39,46,39
10510,3/19/2012,1,1,3,0,0,1,1,1,0.48,0.4697,0.82,0.1045,4,19,23,19
10511,3/19/2012,1,1,3,1,0,1,1,1,0.46,0.4545,0.88,0.1045,0,15,15,15
10512,3/19/2012,1,1,3,2,0,1,1,1,0.46,0.4545,0.88,0.1642,1,7,8,7
10513,3/19/2012,1,1,3,3,0,1,1,1,0.46,0.4545,0.88,0.0896,0,2,2,2
10514,3/19/2012,1,1,3,4,0,1,1,1,0.44,0.4394,0.94,0,0,3,3,3
10515,3/19/2012,1,1,3,5,0,1,1,1,0.44,0.4394,0.94,0,0,31,31,31
10516,3/19/2012,1,1,3,6,0,1,1,1,0.46,0.4545,0.88,0.1343,2,118,120,118
10517,3/19/2012,1,1,3,7,0,1,1,1,0.46,0.4545,0.88,0.194,25,329,354,329
10518,3/19/2012,1,1,3,8,0,1,1,1,0.46,0.4545,0.88,0.1045,16,563,579,563
10519,3/19/2012,1,1,3,9,0,1,1,1,0.5,0.4848,0.72,0.1642,55,276,331,276
10520,3/19/2012,1,1,3,10,0,1,1,1,0.52,0.5,0.72,0.1343,56,128,184,128
10521,3/19/2012,1,1,3,11,0,1,1,1,0.56,0.5303,0.68,0.1642,56,145,201,145
10522,3/19/2012,1,1,3,12,0,1,1,1,0.6,0.6061,0.64,0.2537,71,211,282,211
10523,3/19/2012,1,1,3,13,0,1,1,1,0.62,0.6061,0.61,0.2537,69,194,263,194
10524,3/19/2012,1,1,3,14,0,1,1,2,0.64,0.6212,0.57,0.194,60,200,260,200
10525,3/19/2012,1,1,3,15,0,1,1,1,0.64,0.6212,0.57,0.2239,97,189,286,189
10526,3/19/2012,1,1,3,16,0,1,1,1,0.66,0.6212,0.5,0.2239,65,320,385,320
10527,3/19/2012,1,1,3,17,0,1,1,1,0.64,0.6212,0.53,0.2239,106,615,721,615
10528,3/19/2012,1,1,3,18,0,1,1,1,0.64,0.6212,0.57,0.2537,120,681,801,681
10529,3/19/2012,1,1,3,19,0,1,1,1,0.62,0.6061,0.61,0.2239,86,463,549,463
10530,3/19/2012,1,1,3,20,0,1,1,1,0.6,0.6061,0.64,0.2239,34,296,330,296
10531,3/19/2012,1,1,3,21,0,1,1,1,0.6,0.6061,0.64,0.1642,33,190,223,190
10532,3/19/2012,1,1,3,22,0,1,1,2,0.56,0.5303,0.73,0.1642,17,131,148,131
10533,3/19/2012,1,1,3,23,0,1,1,2,0.56,0.5303,0.78,0.1343,9,45,54,45
10534,3/20/2012,1,1,3,0,0,2,1,2,0.56,0.5303,0.78,0.0896,5,24,29,24
10535,3/20/2012,1,1,3,1,0,2,1,1,0.54,0.5152,0.88,0,6,9,15,9
10536,3/20/2012,1,1,3,2,0,2,1,1,0.54,0.5152,0.88,0.0896,2,8,10,8
10537,3/20/2012,1,1,3,3,0,2,1,2,0.54,0.5152,0.88,0,0,3,3,3
10538,3/20/2012,1,1,3,4,0,2,1,2,0.52,0.5,0.88,0.1343,0,6,6,6
10539,3/20/2012,1,1,3,5,0,2,1,2,0.52,0.5,0.94,0,0,20,20,20
10540,3/20/2012,1,1,3,6,0,2,1,2,0.52,0.5,0.94,0.1642,6,94,100,94
10541,3/20/2012,1,1,3,7,0,2,1,3,0.52,0.5,0.94,0.2239,3,167,170,167
10542,3/20/2012,1,1,3,8,0,2,1,2,0.52,0.5,0.88,0.1045,28,488,516,488
10543,3/20/2012,1,1,3,9,0,2,1,2,0.54,0.5152,0.88,0.1642,41,284,325,284
10544,3/20/2012,1,1,3,10,0,2,1,1,0.54,0.5152,0.88,0.194,44,119,163,119
10545,3/20/2012,1,1,3,11,0,2,1,1,0.58,0.5455,0.83,0.1343,74,156,230,156
10546,3/20/2012,1,1,3,12,0,2,1,1,0.6,0.5758,0.78,0.2537,56,205,261,205
10547,3/20/2012,1,1,3,13,0,2,1,1,0.6,0.5758,0.78,0.194,77,207,284,207
10548,3/20/2012,1,1,3,14,0,2,1,2,0.6,0.5909,0.73,0.1642,66,182,248,182
10549,3/20/2012,1,1,3,15,0,2,1,2,0.62,0.6061,0.69,0.1045,67,177,244,177
10550,3/20/2012,1,1,3,16,0,2,1,1,0.62,0.6061,0.66,0.2239,99,332,431,332
10551,3/20/2012,1,1,3,17,0,2,1,1,0.6,0.5909,0.73,0.194,108,642,750,642
10552,3/20/2012,1,1,3,18,0,2,1,1,0.6,0.5909,0.69,0.2537,136,665,801,665
10553,3/20/2012,1,1,3,19,0,2,1,1,0.58,0.5455,0.73,0.1343,75,480,555,480
10554,3/20/2012,1,1,3,20,0,2,1,1,0.58,0.5455,0.68,0.0896,78,299,377,299
10555,3/20/2012,1,1,3,21,0,2,1,1,0.56,0.5303,0.73,0,38,239,277,239
10556,3/20/2012,1,1,3,22,0,2,1,1,0.54,0.5152,0.77,0,32,156,188,156
10557,3/20/2012,1,1,3,23,0,2,1,1,0.52,0.5,0.83,0,10,80,90,80
10558,3/21/2012,2,1,3,0,0,3,1,1,0.52,0.5,0.88,0,4,29,33,29
10559,3/21/2012,2,1,3,1,0,3,1,1,0.52,0.5,0.83,0.0896,4,22,26,22
10560,3/21/2012,2,1,3,2,0,3,1,1,0.5,0.4848,0.88,0.1343,2,8,10,8
10561,3/21/2012,2,1,3,3,0,3,1,2,0.5,0.4848,0.88,0.194,1,7,8,7
10562,3/21/2012,2,1,3,4,0,3,1,2,0.5,0.4848,0.88,0.1343,0,4,4,4
10563,3/21/2012,2,1,3,5,0,3,1,2,0.5,0.4848,0.88,0.1343,4,35,39,35
10564,3/21/2012,2,1,3,6,0,3,1,2,0.48,0.4697,0.94,0.2239,10,139,149,139
10565,3/21/2012,2,1,3,7,0,3,1,3,0.48,0.4697,0.94,0.194,34,338,372,338
10566,3/21/2012,2,1,3,8,0,3,1,3,0.48,0.4697,0.94,0.1045,33,502,535,502
10567,3/21/2012,2,1,3,9,0,3,1,2,0.5,0.4848,0.88,0.1642,38,255,293,255
10568,3/21/2012,2,1,3,10,0,3,1,2,0.52,0.5,0.83,0.1642,30,124,154,124
10569,3/21/2012,2,1,3,11,0,3,1,2,0.52,0.5,0.83,0.1642,38,154,192,154
10570,3/21/2012,2,1,3,12,0,3,1,2,0.54,0.5152,0.77,0,58,171,229,171
10571,3/21/2012,2,1,3,13,0,3,1,2,0.54,0.5152,0.83,0,81,222,303,222
10572,3/21/2012,2,1,3,14,0,3,1,2,0.56,0.5303,0.78,0,74,151,225,151
10573,3/21/2012,2,1,3,15,0,3,1,2,0.56,0.5303,0.78,0,68,175,243,175
10574,3/21/2012,2,1,3,16,0,3,1,1,0.58,0.5455,0.73,0,91,287,378,287
10575,3/21/2012,2,1,3,17,0,3,1,1,0.6,0.5909,0.69,0.0896,113,616,729,616
10576,3/21/2012,2,1,3,18,0,3,1,1,0.6,0.5909,0.69,0,152,627,779,627
10577,3/21/2012,2,1,3,19,0,3,1,1,0.6,0.6061,0.64,0,86,496,582,496
10578,3/21/2012,2,1,3,20,0,3,1,1,0.56,0.5303,0.78,0.0896,76,298,374,298
10579,3/21/2012,2,1,3,21,0,3,1,1,0.54,0.5152,0.83,0.1045,47,204,251,204
10580,3/21/2012,2,1,3,22,0,3,1,1,0.52,0.5,0.83,0.1642,41,156,197,156
10581,3/21/2012,2,1,3,23,0,3,1,1,0.54,0.5152,0.77,0,37,88,125,88
10582,3/22/2012,2,1,3,0,0,4,1,1,0.52,0.5,0.83,0.0896,9,32,41,32
10583,3/22/2012,2,1,3,1,0,4,1,1,0.52,0.5,0.83,0.0896,14,16,30,16
10584,3/22/2012,2,1,3,2,0,4,1,1,0.52,0.5,0.83,0.0896,1,5,6,5
10585,3/22/2012,2,1,3,3,0,4,1,1,0.52,0.5,0.83,0.0896,0,7,7,7
10586,3/22/2012,2,1,3,4,0,4,1,2,0.48,0.4697,1,0.0896,0,6,6,6
10587,3/22/2012,2,1,3,5,0,4,1,2,0.48,0.4697,1,0.0896,2,32,34,32
10588,3/22/2012,2,1,3,6,0,4,1,2,0.48,0.4697,1,0.0896,10,126,136,126
10589,3/22/2012,2,1,3,7,0,4,1,2,0.48,0.4697,1,0.0896,29,332,361,332
10590,3/22/2012,2,1,3,8,0,4,1,2,0.5,0.4848,0.94,0.0896,51,598,649,598
10591,3/22/2012,2,1,3,9,0,4,1,2,0.5,0.4848,0.94,0.0896,41,277,318,277
10592,3/22/2012,2,1,3,10,0,4,1,2,0.5,0.4848,1,0.0896,32,110,142,110
10593,3/22/2012,2,1,3,11,0,4,1,2,0.52,0.5,0.94,0,53,166,219,166
10594,3/22/2012,2,1,3,12,0,4,1,2,0.54,0.5152,0.88,0.194,48,224,272,224
10595,3/22/2012,2,1,3,13,0,4,1,1,0.58,0.5455,0.78,0.0896,83,215,298,215
10596,3/22/2012,2,1,3,14,0,4,1,1,0.6,0.5909,0.73,0.1045,96,161,257,161
10597,3/22/2012,2,1,3,15,0,4,1,1,0.62,0.6061,0.69,0.194,102,202,304,202
10598,3/22/2012,2,1,3,16,0,4,1,1,0.64,0.6061,0.65,0.194,125,300,425,300
10599,3/22/2012,2,1,3,17,0,4,1,1,0.66,0.6212,0.65,0.1642,154,656,810,656
10600,3/22/2012,2,1,3,18,0,4,1,1,0.66,0.6212,0.65,0.1642,147,654,801,654
10601,3/22/2012,2,1,3,19,0,4,1,1,0.66,0.6212,0.61,0,117,469,586,469
10602,3/22/2012,2,1,3,20,0,4,1,1,0.62,0.5909,0.73,0.2836,64,360,424,360
10603,3/22/2012,2,1,3,21,0,4,1,1,0.58,0.5455,0.78,0.1642,66,308,374,308
10604,3/22/2012,2,1,3,22,0,4,1,1,0.56,0.5303,0.83,0.194,56,164,220,164
10605,3/22/2012,2,1,3,23,0,4,1,1,0.56,0.5303,0.83,0.0896,34,117,151,117
10606,3/23/2012,2,1,3,0,0,5,1,1,0.56,0.5303,0.83,0,30,65,95,65
10607,3/23/2012,2,1,3,1,0,5,1,1,0.54,0.5152,0.88,0,18,32,50,32
10608,3/23/2012,2,1,3,2,0,5,1,1,0.54,0.5152,0.88,0.0896,12,20,32,20
10609,3/23/2012,2,1,3,3,0,5,1,1,0.52,0.5,0.88,0.1045,4,6,10,6
10610,3/23/2012,2,1,3,4,0,5,1,2,0.5,0.4848,0.94,0.1045,0,3,3,3
10611,3/23/2012,2,1,3,5,0,5,1,2,0.5,0.4848,0.94,0,5,29,34,29
10612,3/23/2012,2,1,3,6,0,5,1,2,0.5,0.4848,0.88,0,6,110,116,110
10613,3/23/2012,2,1,3,7,0,5,1,2,0.5,0.4848,0.93,0.1343,28,318,346,318
10614,3/23/2012,2,1,3,8,0,5,1,2,0.5,0.4848,0.94,0.1343,47,615,662,615
10615,3/23/2012,2,1,3,9,0,5,1,2,0.52,0.5,0.9,0.0896,75,305,380,305
10616,3/23/2012,2,1,3,10,0,5,1,2,0.56,0.5303,0.88,0.1045,125,150,275,150
10617,3/23/2012,2,1,3,11,0,5,1,2,0.62,0.5909,0.73,0.1045,131,187,318,187
10618,3/23/2012,2,1,3,12,0,5,1,2,0.66,0.6212,0.61,0.2239,199,272,471,272
10619,3/23/2012,2,1,3,13,0,5,1,2,0.7,0.6515,0.48,0,172,256,428,256
10620,3/23/2012,2,1,3,14,0,5,1,2,0.72,0.6515,0.42,0.1045,208,224,432,224
10621,3/23/2012,2,1,3,15,0,5,1,2,0.72,0.6515,0.42,0.1343,191,281,472,281
10622,3/23/2012,2,1,3,16,0,5,1,2,0.72,0.6515,0.42,0.1642,219,370,589,370
10623,3/23/2012,2,1,3,17,0,5,1,2,0.72,0.6515,0.42,0.1642,264,693,957,693
10624,3/23/2012,2,1,3,18,0,5,1,1,0.7,0.6364,0.45,0.1642,237,593,830,593
10625,3/23/2012,2,1,3,19,0,5,1,1,0.66,0.6212,0.5,0.194,213,473,686,473
10626,3/23/2012,2,1,3,20,0,5,1,1,0.66,0.6212,0.47,0.1343,117,328,445,328
10627,3/23/2012,2,1,3,21,0,5,1,1,0.62,0.6212,0.53,0.1045,64,220,284,220
10628,3/23/2012,2,1,3,22,0,5,1,1,0.6,0.6061,0.64,0.2836,53,218,271,218
10629,3/23/2012,2,1,3,23,0,5,1,1,0.6,0.5909,0.69,0.2537,51,125,176,125
10630,3/24/2012,2,1,3,0,0,6,0,1,0.58,0.5455,0.68,0,45,111,156,111
10631,3/24/2012,2,1,3,1,0,6,0,1,0.56,0.5303,0.73,0.0896,20,108,128,108
10632,3/24/2012,2,1,3,2,0,6,0,1,0.54,0.5152,0.77,0.1045,14,55,69,55
10633,3/24/2012,2,1,3,3,0,6,0,1,0.54,0.5152,0.77,0.1045,10,22,32,22
10634,3/24/2012,2,1,3,4,0,6,0,1,0.52,0.5,0.83,0.0896,1,6,7,6
10635,3/24/2012,2,1,3,5,0,6,0,2,0.52,0.5,0.83,0.1642,0,4,4,4
10636,3/24/2012,2,1,3,6,0,6,0,2,0.52,0.5,0.83,0.1642,4,24,28,24
10637,3/24/2012,2,1,3,7,0,6,0,2,0.5,0.4848,0.88,0.1343,25,45,70,45
10638,3/24/2012,2,1,3,8,0,6,0,2,0.5,0.4848,0.94,0.194,41,113,154,113
10639,3/24/2012,2,1,3,9,0,6,0,2,0.52,0.5,0.83,0.1343,96,153,249,153
10640,3/24/2012,2,1,3,10,0,6,0,2,0.52,0.5,0.88,0.194,148,197,345,197
10641,3/24/2012,2,1,3,11,0,6,0,2,0.5,0.4848,0.94,0.194,98,175,273,175
10642,3/24/2012,2,1,3,12,0,6,0,3,0.52,0.5,0.94,0.2239,61,122,183,122
10643,3/24/2012,2,1,3,13,0,6,0,3,0.52,0.5,0.94,0.2537,62,134,196,134
10644,3/24/2012,2,1,3,14,0,6,0,3,0.52,0.5,0.88,0.3582,63,160,223,160
10645,3/24/2012,2,1,3,15,0,6,0,3,0.5,0.4848,0.94,0.4179,118,172,290,172
10646,3/24/2012,2,1,3,16,0,6,0,3,0.5,0.4848,0.94,0.2985,49,128,177,128
10647,3/24/2012,2,1,3,17,0,6,0,3,0.5,0.4848,0.88,0.2239,47,68,115,68
10648,3/24/2012,2,1,3,18,0,6,0,3,0.46,0.4545,0.94,0.2239,27,110,137,110
10649,3/24/2012,2,1,3,19,0,6,0,3,0.46,0.4545,0.94,0.1343,28,105,133,105
10650,3/24/2012,2,1,3,20,0,6,0,3,0.44,0.4394,1,0.194,31,80,111,80
10651,3/24/2012,2,1,3,21,0,6,0,3,0.44,0.4394,1,0.194,16,88,104,88
10652,3/24/2012,2,1,3,22,0,6,0,3,0.44,0.4394,1,0.2537,12,71,83,71
10653,3/24/2012,2,1,3,23,0,6,0,2,0.44,0.4394,0.94,0.2836,17,88,105,88
10654,3/25/2012,2,1,3,0,0,0,0,2,0.44,0.4394,0.94,0.2836,18,62,80,62
10655,3/25/2012,2,1,3,1,0,0,0,2,0.42,0.4242,1,0.2537,24,65,89,65
10656,3/25/2012,2,1,3,2,0,0,0,3,0.42,0.4242,1,0.2985,6,29,35,29
10657,3/25/2012,2,1,3,3,0,0,0,3,0.42,0.4242,0.94,0.2985,8,10,18,10
10658,3/25/2012,2,1,3,4,0,0,0,2,0.42,0.4242,0.94,0.3284,1,7,8,7
10659,3/25/2012,2,1,3,5,0,0,0,2,0.4,0.4091,1,0.2537,0,6,6,6
10660,3/25/2012,2,1,3,6,0,0,0,2,0.4,0.4091,1,0.2537,5,13,18,13
10661,3/25/2012,2,1,3,7,0,0,0,2,0.4,0.4091,0.94,0.3284,14,25,39,25
10662,3/25/2012,2,1,3,8,0,0,0,2,0.4,0.4091,0.94,0.3284,21,68,89,68
10663,3/25/2012,2,1,3,9,0,0,0,2,0.4,0.4091,0.94,0.2537,26,92,118,92
10664,3/25/2012,2,1,3,10,0,0,0,2,0.4,0.4091,0.87,0.3284,78,172,250,172
10665,3/25/2012,2,1,3,11,0,0,0,2,0.4,0.4091,0.94,0.2537,106,217,323,217
10666,3/25/2012,2,1,3,12,0,0,0,2,0.4,0.4091,0.94,0.2239,122,238,360,238
10667,3/25/2012,2,1,3,13,0,0,0,2,0.42,0.4242,0.88,0.1642,110,257,367,257
10668,3/25/2012,2,1,3,14,0,0,0,2,0.44,0.4394,0.88,0.1642,123,291,414,291
10669,3/25/2012,2,1,3,15,0,0,0,2,0.44,0.4394,0.88,0.194,139,282,421,282
10670,3/25/2012,2,1,3,16,0,0,0,1,0.48,0.4697,0.77,0,153,339,492,339
10671,3/25/2012,2,1,3,17,0,0,0,1,0.5,0.4848,0.72,0.0896,146,273,419,273
10672,3/25/2012,2,1,3,18,0,0,0,1,0.5,0.4848,0.72,0.0896,202,289,491,289
10673,3/25/2012,2,1,3,19,0,0,0,1,0.5,0.4848,0.72,0.2537,114,261,375,261
10674,3/25/2012,2,1,3,20,0,0,0,1,0.48,0.4697,0.77,0.2239,63,196,259,196
10675,3/25/2012,2,1,3,21,0,0,0,1,0.48,0.4697,0.77,0.1642,25,124,149,124
10676,3/25/2012,2,1,3,22,0,0,0,1,0.46,0.4545,0.82,0.1343,19,92,111,92
10677,3/25/2012,2,1,3,23,0,0,0,1,0.48,0.4697,0.82,0.1343,9,56,65,56
10678,3/26/2012,2,1,3,0,0,1,1,2,0.48,0.4697,0.82,0.1642,10,23,33,23
10679,3/26/2012,2,1,3,1,0,1,1,1,0.48,0.4697,0.82,0.2537,18,10,28,10
10680,3/26/2012,2,1,3,2,0,1,1,1,0.46,0.4545,0.88,0.2239,14,6,20,6
10681,3/26/2012,2,1,3,3,0,1,1,1,0.46,0.4545,0.82,0.194,0,1,1,1
10682,3/26/2012,2,1,3,4,0,1,1,1,0.44,0.4394,0.82,0.1642,0,4,4,4
10683,3/26/2012,2,1,3,5,0,1,1,1,0.44,0.4394,0.77,0.1642,0,36,36,36
10684,3/26/2012,2,1,3,6,0,1,1,1,0.42,0.4242,0.82,0.194,7,110,117,110
10685,3/26/2012,2,1,3,7,0,1,1,1,0.44,0.4394,0.72,0.194,15,355,370,355
10686,3/26/2012,2,1,3,8,0,1,1,1,0.44,0.4394,0.62,0.2239,32,625,657,625
10687,3/26/2012,2,1,3,9,0,1,1,1,0.46,0.4545,0.47,0.2836,37,245,282,245
10688,3/26/2012,2,1,3,10,0,1,1,1,0.5,0.4848,0.36,0.5821,55,98,153,98
10689,3/26/2012,2,1,3,11,0,1,1,1,0.48,0.4697,0.31,0.5821,47,131,178,131
10690,3/26/2012,2,1,3,12,0,1,1,1,0.48,0.4697,0.33,0.5224,63,216,279,216
10691,3/26/2012,2,1,3,13,0,1,1,1,0.48,0.4697,0.29,0.6866,79,222,301,222
10692,3/26/2012,2,1,3,14,0,1,1,1,0.48,0.4697,0.33,0.4478,58,159,217,159
10693,3/26/2012,2,1,3,15,0,1,1,1,0.48,0.4697,0.29,0.6119,66,157,223,157
10694,3/26/2012,2,1,3,16,0,1,1,1,0.48,0.4697,0.25,0.6418,60,245,305,245
10695,3/26/2012,2,1,3,17,0,1,1,1,0.46,0.4545,0.24,0.4478,65,599,664,599
10696,3/26/2012,2,1,3,18,0,1,1,1,0.44,0.4394,0.26,0.4478,90,594,684,594
10697,3/26/2012,2,1,3,19,0,1,1,1,0.42,0.4242,0.24,0.3582,41,417,458,417
10698,3/26/2012,2,1,3,20,0,1,1,1,0.4,0.4091,0.26,0.5224,12,209,221,209
10699,3/26/2012,2,1,3,21,0,1,1,1,0.38,0.3939,0.25,0.4925,11,175,186,175
10700,3/26/2012,2,1,3,22,0,1,1,1,0.36,0.3333,0.25,0.3582,13,80,93,80
10701,3/26/2012,2,1,3,23,0,1,1,1,0.34,0.2879,0.25,0.5224,2,46,48,46
10702,3/27/2012,2,1,3,0,0,2,1,1,0.32,0.2879,0.26,0.5224,1,9,10,9
10703,3/27/2012,2,1,3,1,0,2,1,1,0.3,0.2727,0.26,0.4627,1,4,5,4
10704,3/27/2012,2,1,3,2,0,2,1,1,0.26,0.2273,0.3,0.2985,1,6,7,6
10705,3/27/2012,2,1,3,3,0,2,1,1,0.26,0.2273,0.3,0.3284,0,4,4,4
10706,3/27/2012,2,1,3,4,0,2,1,1,0.24,0.2121,0.32,0.3582,0,3,3,3
10707,3/27/2012,2,1,3,5,0,2,1,1,0.22,0.2121,0.37,0.2836,1,16,17,16
10708,3/27/2012,2,1,3,6,0,2,1,1,0.22,0.2273,0.37,0.194,5,96,101,96
10709,3/27/2012,2,1,3,7,0,2,1,1,0.22,0.2273,0.37,0.194,9,277,286,277
10710,3/27/2012,2,1,3,8,0,2,1,1,0.22,0.2121,0.37,0.2985,14,567,581,567
10711,3/27/2012,2,1,3,9,0,2,1,1,0.24,0.2273,0.38,0.194,8,259,267,259
10712,3/27/2012,2,1,3,10,0,2,1,1,0.26,0.2576,0.35,0.2239,20,118,138,118
10713,3/27/2012,2,1,3,11,0,2,1,1,0.3,0.303,0.31,0.1642,34,141,175,141
10714,3/27/2012,2,1,3,12,0,2,1,1,0.32,0.3182,0.31,0.1642,34,186,220,186
10715,3/27/2012,2,1,3,13,0,2,1,1,0.36,0.3485,0.27,0,46,165,211,165
10716,3/27/2012,2,1,3,14,0,2,1,1,0.4,0.4091,0.24,0.1343,37,147,184,147
10717,3/27/2012,2,1,3,15,0,2,1,1,0.42,0.4242,0.2,0,42,158,200,158
10718,3/27/2012,2,1,3,16,0,2,1,1,0.42,0.4242,0.2,0,38,267,305,267
10719,3/27/2012,2,1,3,17,0,2,1,1,0.44,0.4394,0.16,0,72,542,614,542
10720,3/27/2012,2,1,3,18,0,2,1,1,0.42,0.4242,0.17,0.0896,67,577,644,577
10721,3/27/2012,2,1,3,19,0,2,1,1,0.42,0.4242,0.17,0,40,377,417,377
10722,3/27/2012,2,1,3,20,0,2,1,1,0.42,0.4242,0.17,0.0896,28,266,294,266
10723,3/27/2012,2,1,3,21,0,2,1,1,0.36,0.3485,0.37,0.1642,21,200,221,200
10724,3/27/2012,2,1,3,22,0,2,1,1,0.36,0.3485,0.37,0.1343,7,127,134,127
10725,3/27/2012,2,1,3,23,0,2,1,1,0.36,0.3485,0.37,0.194,5,59,64,59
10726,3/28/2012,2,1,3,0,0,3,1,1,0.36,0.3333,0.4,0.2836,1,29,30,29
10727,3/28/2012,2,1,3,1,0,3,1,1,0.36,0.3333,0.46,0.2985,0,8,8,8
10728,3/28/2012,2,1,3,2,0,3,1,1,0.34,0.303,0.49,0.2985,0,3,3,3
10729,3/28/2012,2,1,3,3,0,3,1,1,0.34,0.303,0.42,0.3284,1,4,5,4
10730,3/28/2012,2,1,3,4,0,3,1,1,0.36,0.3333,0.43,0.2985,1,0,1,0
10731,3/28/2012,2,1,3,5,0,3,1,1,0.36,0.3333,0.43,0.2985,2,38,40,38
10732,3/28/2012,2,1,3,6,0,3,1,1,0.36,0.3333,0.46,0.3582,4,111,115,111
10733,3/28/2012,2,1,3,7,0,3,1,1,0.36,0.3333,0.46,0.3284,10,348,358,348
10734,3/28/2012,2,1,3,8,0,3,1,1,0.38,0.3939,0.46,0.3582,19,639,658,639
10735,3/28/2012,2,1,3,9,0,3,1,1,0.4,0.4091,0.43,0.4478,16,298,314,298
10736,3/28/2012,2,1,3,10,0,3,1,1,0.46,0.4545,0.41,0.4179,33,140,173,140
10737,3/28/2012,2,1,3,11,0,3,1,1,0.5,0.4848,0.42,0.3881,54,168,222,168
10738,3/28/2012,2,1,3,12,0,3,1,2,0.54,0.5152,0.39,0.3582,50,218,268,218
10739,3/28/2012,2,1,3,13,0,3,1,1,0.56,0.5303,0.43,0.3284,60,213,273,213
10740,3/28/2012,2,1,3,14,0,3,1,1,0.62,0.6212,0.38,0.3582,52,169,221,169
10741,3/28/2012,2,1,3,15,0,3,1,2,0.62,0.6212,0.41,0.2985,47,152,199,152
10742,3/28/2012,2,1,3,16,0,3,1,3,0.62,0.6212,0.43,0.0896,51,170,221,170
10743,3/28/2012,2,1,3,17,0,3,1,1,0.6,0.6061,0.6,0.2239,72,532,604,532
10744,3/28/2012,2,1,3,18,0,3,1,1,0.6,0.6061,0.6,0.2239,61,580,641,580
10745,3/28/2012,2,1,3,19,0,3,1,1,0.6,0.6212,0.56,0.194,41,415,456,415
10746,3/28/2012,2,1,3,20,0,3,1,1,0.6,0.6212,0.56,0.2985,38,324,362,324
10747,3/28/2012,2,1,3,21,0,3,1,1,0.58,0.5455,0.6,0.2537,28,233,261,233
10748,3/28/2012,2,1,3,22,0,3,1,1,0.56,0.5303,0.64,0.1343,21,151,172,151
10749,3/28/2012,2,1,3,23,0,3,1,1,0.54,0.5152,0.68,0.1343,12,81,93,81
10750,3/29/2012,2,1,3,0,0,4,1,1,0.54,0.5152,0.68,0.194,10,38,48,38
10751,3/29/2012,2,1,3,1,0,4,1,1,0.56,0.5303,0.6,0.1343,15,18,33,18
10752,3/29/2012,2,1,3,2,0,4,1,1,0.6,0.6061,0.28,0.2985,0,6,6,6
10753,3/29/2012,2,1,3,3,0,4,1,1,0.58,0.5455,0.28,0.2537,1,4,5,4
10754,3/29/2012,2,1,3,4,0,4,1,1,0.52,0.5,0.36,0.2537,1,8,9,8
10755,3/29/2012,2,1,3,5,0,4,1,1,0.5,0.4848,0.45,0.2239,2,30,32,30
10756,3/29/2012,2,1,3,6,0,4,1,1,0.46,0.4545,0.59,0.2537,3,114,117,114
10757,3/29/2012,2,1,3,7,0,4,1,1,0.46,0.4545,0.51,0.3582,14,353,367,353
10758,3/29/2012,2,1,3,8,0,4,1,1,0.46,0.4545,0.47,0.4179,26,628,654,628
10759,3/29/2012,2,1,3,9,0,4,1,1,0.48,0.4697,0.48,0.4179,22,299,321,299
10760,3/29/2012,2,1,3,10,0,4,1,1,0.46,0.4545,0.47,0.4478,42,124,166,124
10761,3/29/2012,2,1,3,11,0,4,1,1,0.5,0.4848,0.45,0.4179,54,166,220,166
10762,3/29/2012,2,1,3,12,0,4,1,1,0.5,0.4848,0.42,0.4925,64,228,292,228
10763,3/29/2012,2,1,3,13,0,4,1,1,0.46,0.4545,0.44,0.3284,50,223,273,223
10764,3/29/2012,2,1,3,14,0,4,1,1,0.5,0.4848,0.42,0.3582,63,175,238,175
10765,3/29/2012,2,1,3,15,0,4,1,1,0.52,0.5,0.39,0.3582,109,198,307,198
10766,3/29/2012,2,1,3,16,0,4,1,1,0.52,0.5,0.36,0.3284,67,321,388,321
10767,3/29/2012,2,1,3,17,0,4,1,1,0.52,0.5,0.38,0.3881,83,620,703,620
10768,3/29/2012,2,1,3,18,0,4,1,1,0.5,0.4848,0.39,0.2985,83,598,681,598
10769,3/29/2012,2,1,3,19,0,4,1,1,0.48,0.4697,0.39,0.2836,47,421,468,421
10770,3/29/2012,2,1,3,20,0,4,1,1,0.46,0.4545,0.38,0.2985,34,301,335,301
10771,3/29/2012,2,1,3,21,0,4,1,1,0.44,0.4394,0.44,0.2836,10,214,224,214
10772,3/29/2012,2,1,3,22,0,4,1,1,0.42,0.4242,0.44,0.2836,17,135,152,135
10773,3/29/2012,2,1,3,23,0,4,1,1,0.42,0.4242,0.47,0.2985,17,77,94,77
10774,3/30/2012,2,1,3,0,0,5,1,1,0.4,0.4091,0.47,0.2985,10,49,59,49
10775,3/30/2012,2,1,3,1,0,5,1,1,0.38,0.3939,0.5,0.2836,6,21,27,21
10776,3/30/2012,2,1,3,2,0,5,1,1,0.36,0.3333,0.53,0.2985,1,6,7,6
10777,3/30/2012,2,1,3,3,0,5,1,1,0.34,0.3333,0.61,0.1343,0,7,7,7
10778,3/30/2012,2,1,3,4,0,5,1,1,0.34,0.3485,0.53,0.0896,1,1,2,1
10779,3/30/2012,2,1,3,5,0,5,1,1,0.32,0.3333,0.61,0.0896,0,26,26,26
10780,3/30/2012,2,1,3,6,0,5,1,1,0.32,0.3333,0.57,0.1343,5,81,86,81
10781,3/30/2012,2,1,3,7,0,5,1,1,0.32,0.3182,0.57,0.1642,9,280,289,280
10782,3/30/2012,2,1,3,8,0,5,1,1,0.32,0.3182,0.66,0.1642,38,555,593,555
10783,3/30/2012,2,1,3,9,0,5,1,1,0.34,0.3333,0.57,0.1642,29,292,321,292
10784,3/30/2012,2,1,3,10,0,5,1,2,0.36,0.3636,0.57,0.1045,50,137,187,137
10785,3/30/2012,2,1,3,11,0,5,1,2,0.36,0.3788,0.53,0,48,153,201,153
10786,3/30/2012,2,1,3,12,0,5,1,2,0.38,0.3939,0.54,0,62,208,270,208
10787,3/30/2012,2,1,3,13,0,5,1,3,0.4,0.4091,0.5,0,44,198,242,198
10788,3/30/2012,2,1,3,14,0,5,1,3,0.4,0.4091,0.54,0,56,173,229,173
10789,3/30/2012,2,1,3,15,0,5,1,3,0.42,0.4242,0.54,0,73,207,280,207
10790,3/30/2012,2,1,3,16,0,5,1,3,0.4,0.4091,0.62,0.2836,75,292,367,292
10791,3/30/2012,2,1,3,17,0,5,1,2,0.4,0.4091,0.62,0.2239,93,513,606,513
10792,3/30/2012,2,1,3,18,0,5,1,1,0.42,0.4242,0.54,0.194,68,492,560,492
10793,3/30/2012,2,1,3,19,0,5,1,1,0.4,0.4091,0.62,0.2239,42,353,395,353
10794,3/30/2012,2,1,3,20,0,5,1,1,0.4,0.4091,0.62,0.1642,17,192,209,192
10795,3/30/2012,2,1,3,21,0,5,1,1,0.38,0.3939,0.66,0.1343,30,190,220,190
10796,3/30/2012,2,1,3,22,0,5,1,1,0.36,0.3485,0.71,0.1642,23,130,153,130
10797,3/30/2012,2,1,3,23,0,5,1,1,0.36,0.3788,0.71,0,16,107,123,107
10798,3/31/2012,2,1,3,0,0,6,0,1,0.38,0.3939,0.82,0.194,12,80,92,80
10799,3/31/2012,2,1,3,1,0,6,0,2,0.4,0.4091,0.76,0.194,17,65,82,65
10800,3/31/2012,2,1,3,2,0,6,0,2,0.42,0.4242,0.77,0.2537,14,55,69,55
10801,3/31/2012,2,1,3,3,0,6,0,1,0.4,0.4091,0.82,0.2537,10,21,31,21
10802,3/31/2012,2,1,3,4,0,6,0,1,0.42,0.4242,0.77,0.4179,4,4,8,4
10803,3/31/2012,2,1,3,5,0,6,0,1,0.4,0.4091,0.82,0.2239,0,5,5,5
10804,3/31/2012,2,1,3,6,0,6,0,2,0.36,0.3485,0.87,0.1642,7,16,23,16
10805,3/31/2012,2,1,3,7,0,6,0,2,0.36,0.3485,0.87,0.1642,5,39,44,39
10806,3/31/2012,2,1,3,8,0,6,0,2,0.36,0.3485,0.87,0.194,19,126,145,126
10807,3/31/2012,2,1,3,9,0,6,0,2,0.4,0.4091,0.76,0.194,62,161,223,161
10808,3/31/2012,2,1,3,10,0,6,0,2,0.4,0.4091,0.76,0.1343,108,205,313,205
10809,3/31/2012,2,1,3,11,0,6,0,1,0.46,0.4545,0.72,0.1343,184,279,463,279
10810,3/31/2012,2,1,3,12,0,6,0,1,0.48,0.4697,0.67,0,263,358,621,358
10811,3/31/2012,2,1,3,13,0,6,0,1,0.54,0.5152,0.6,0.1343,265,373,638,373
10812,3/31/2012,2,1,3,14,0,6,0,2,0.5,0.4848,0.63,0.2537,240,311,551,311
10813,3/31/2012,2,1,3,15,0,6,0,2,0.52,0.5,0.59,0.2836,275,330,605,330
10814,3/31/2012,2,1,3,16,0,6,0,2,0.5,0.4848,0.63,0.2985,243,292,535,292
10815,3/31/2012,2,1,3,17,0,6,0,1,0.48,0.4697,0.67,0.4179,238,305,543,305
10816,3/31/2012,2,1,3,18,0,6,0,2,0.44,0.4394,0.72,0.4627,102,239,341,239
10817,3/31/2012,2,1,3,19,0,6,0,1,0.42,0.4242,0.71,0.4478,93,191,284,191
10818,3/31/2012,2,1,3,20,0,6,0,2,0.4,0.4091,0.71,0.3284,52,156,208,156
10819,3/31/2012,2,1,3,21,0,6,0,2,0.4,0.4091,0.71,0.3284,36,107,143,107
10820,3/31/2012,2,1,3,22,0,6,0,2,0.38,0.3939,0.71,0.2537,40,116,156,116
10821,3/31/2012,2,1,3,23,0,6,0,2,0.36,0.3333,0.76,0.2836,12,100,112,100
10822,4/1/2012,2,1,4,0,0,0,0,2,0.36,0.3333,0.76,0.2537,8,59,67,59
10823,4/1/2012,2,1,4,1,0,0,0,2,0.36,0.3485,0.76,0.1642,13,49,62,49
10824,4/1/2012,2,1,4,2,0,0,0,2,0.36,0.3485,0.76,0.1642,20,61,81,61
10825,4/1/2012,2,1,4,3,0,0,0,2,0.34,0.3333,0.81,0.1343,4,21,25,21
10826,4/1/2012,2,1,4,4,0,0,0,2,0.34,0.3485,0.81,0.0896,3,9,12,9
10827,4/1/2012,2,1,4,5,0,0,0,2,0.34,0.3485,0.81,0.0896,8,10,18,10
10828,4/1/2012,2,1,4,6,0,0,0,2,0.36,0.3485,0.76,0.1343,9,88,97,88
10829,4/1/2012,2,1,4,7,0,0,0,2,0.36,0.3485,0.71,0.1343,29,55,84,55
10830,4/1/2012,2,1,4,8,0,0,0,2,0.36,0.3636,0.76,0.0896,37,88,125,88
10831,4/1/2012,2,1,4,9,0,0,0,2,0.36,0.3485,0.81,0.1343,102,173,275,173
10832,4/1/2012,2,1,4,10,0,0,0,2,0.4,0.4091,0.71,0.1045,132,228,360,228
10833,4/1/2012,2,1,4,11,0,0,0,2,0.4,0.4091,0.71,0.194,180,271,451,271
10834,4/1/2012,2,1,4,12,0,0,0,2,0.42,0.4242,0.67,0.2239,187,258,445,258
10835,4/1/2012,2,1,4,13,0,0,0,2,0.44,0.4394,0.62,0.194,190,274,464,274
10836,4/1/2012,2,1,4,14,0,0,0,2,0.48,0.4697,0.55,0.2239,283,278,561,278
10837,4/1/2012,2,1,4,15,0,0,0,1,0.5,0.4848,0.55,0.2537,295,278,573,278
10838,4/1/2012,2,1,4,16,0,0,0,1,0.52,0.5,0.52,0.2537,236,275,511,275
10839,4/1/2012,2,1,4,17,0,0,0,1,0.52,0.5,0.55,0.2836,232,323,555,323
10840,4/1/2012,2,1,4,18,0,0,0,1,0.52,0.5,0.52,0.2985,153,279,432,279
10841,4/1/2012,2,1,4,19,0,0,0,1,0.52,0.5,0.55,0.2239,110,236,346,236
10842,4/1/2012,2,1,4,20,0,0,0,2,0.5,0.4848,0.59,0.2239,66,166,232,166
10843,4/1/2012,2,1,4,21,0,0,0,2,0.5,0.4848,0.59,0.1642,33,101,134,101
10844,4/1/2012,2,1,4,22,0,0,0,3,0.5,0.4848,0.63,0.1045,7,61,68,61
10845,4/1/2012,2,1,4,23,0,0,0,3,0.46,0.4545,0.72,0,10,53,63,53
10846,4/2/2012,2,1,4,0,0,1,1,3,0.44,0.4394,0.82,0.1045,6,11,17,11
10847,4/2/2012,2,1,4,1,0,1,1,3,0.42,0.4242,0.88,0.0896,0,5,5,5
10848,4/2/2012,2,1,4,2,0,1,1,3,0.44,0.4394,0.94,0.1343,2,3,5,3
10849,4/2/2012,2,1,4,4,0,1,1,1,0.4,0.4091,0.76,0.4925,2,2,4,2
10850,4/2/2012,2,1,4,5,0,1,1,1,0.4,0.4091,0.76,0.4925,2,22,24,22
10851,4/2/2012,2,1,4,6,0,1,1,1,0.36,0.3182,0.71,0.4627,6,104,110,104
10852,4/2/2012,2,1,4,7,0,1,1,1,0.34,0.303,0.66,0.3881,12,294,306,294
10853,4/2/2012,2,1,4,8,0,1,1,1,0.36,0.3333,0.57,0.3284,36,553,589,553
10854,4/2/2012,2,1,4,9,0,1,1,1,0.38,0.3939,0.54,0.3582,52,265,317,265
10855,4/2/2012,2,1,4,10,0,1,1,1,0.4,0.4091,0.5,0.5224,85,119,204,119
10856,4/2/2012,2,1,4,11,0,1,1,1,0.42,0.4242,0.47,0.4478,81,128,209,128
10857,4/2/2012,2,1,4,12,0,1,1,1,0.44,0.4394,0.44,0.4478,100,181,281,181
10858,4/2/2012,2,1,4,13,0,1,1,1,0.46,0.4545,0.36,0.2985,97,184,281,184
10859,4/2/2012,2,1,4,14,0,1,1,1,0.46,0.4545,0.31,0.4179,127,141,268,141
10860,4/2/2012,2,1,4,15,0,1,1,1,0.48,0.4697,0.33,0.4179,132,192,324,192
10861,4/2/2012,2,1,4,16,0,1,1,1,0.5,0.4848,0.34,0.3284,104,291,395,291
10862,4/2/2012,2,1,4,17,0,1,1,1,0.5,0.4848,0.29,0.2836,128,601,729,601
10863,4/2/2012,2,1,4,18,0,1,1,1,0.5,0.4848,0.27,0.2537,75,543,618,543
10864,4/2/2012,2,1,4,19,0,1,1,1,0.5,0.4848,0.27,0.2537,66,428,494,428
10865,4/2/2012,2,1,4,20,0,1,1,1,0.46,0.4545,0.31,0.1642,48,281,329,281
10866,4/2/2012,2,1,4,21,0,1,1,1,0.46,0.4545,0.28,0.1343,24,214,238,214
10867,4/2/2012,2,1,4,22,0,1,1,1,0.42,0.4242,0.44,0.194,17,106,123,106
10868,4/2/2012,2,1,4,23,0,1,1,1,0.44,0.4394,0.35,0.1642,6,60,66,60
10869,4/3/2012,2,1,4,0,0,2,1,1,0.4,0.4091,0.43,0.1343,1,32,33,32
10870,4/3/2012,2,1,4,1,0,2,1,1,0.38,0.3939,0.46,0.2239,0,11,11,11
10871,4/3/2012,2,1,4,2,0,2,1,1,0.36,0.3485,0.53,0.1642,0,5,5,5
10872,4/3/2012,2,1,4,3,0,2,1,1,0.38,0.3939,0.46,0,0,3,3,3
10873,4/3/2012,2,1,4,4,0,2,1,1,0.32,0.3333,0.66,0.0896,0,1,1,1
10874,4/3/2012,2,1,4,5,0,2,1,1,0.32,0.3333,0.66,0.0896,2,25,27,25
10875,4/3/2012,2,1,4,6,0,2,1,1,0.3,0.3182,0.61,0.0896,2,98,100,98
10876,4/3/2012,2,1,4,7,0,2,1,1,0.32,0.3333,0.66,0.0896,14,327,341,327
10877,4/3/2012,2,1,4,8,0,2,1,1,0.34,0.3636,0.57,0,27,577,604,577
10878,4/3/2012,2,1,4,9,0,2,1,1,0.42,0.4242,0.38,0.0896,54,354,408,354
10879,4/3/2012,2,1,4,10,0,2,1,1,0.44,0.4394,0.33,0,77,142,219,142
10880,4/3/2012,2,1,4,11,0,2,1,1,0.48,0.4697,0.23,0,91,167,258,167
10881,4/3/2012,2,1,4,12,0,2,1,1,0.52,0.5,0.25,0,101,230,331,230
10882,4/3/2012,2,1,4,13,0,2,1,1,0.56,0.5303,0.19,0.2537,120,225,345,225
10883,4/3/2012,2,1,4,14,0,2,1,1,0.56,0.5303,0.21,0.2239,120,191,311,191
10884,4/3/2012,2,1,4,15,0,2,1,1,0.6,0.5909,0.2,0.194,109,207,316,207
10885,4/3/2012,2,1,4,16,0,2,1,1,0.62,0.6061,0.21,0.1642,145,340,485,340
10886,4/3/2012,2,1,4,17,0,2,1,1,0.62,0.6061,0.17,0.194,123,634,757,634
10887,4/3/2012,2,1,4,18,0,2,1,1,0.6,0.6061,0.26,0.1642,139,661,800,661
10888,4/3/2012,2,1,4,19,0,2,1,1,0.56,0.5303,0.26,0.1045,98,460,558,460
10889,4/3/2012,2,1,4,20,0,2,1,1,0.56,0.5303,0.24,0.1343,54,325,379,325
10890,4/3/2012,2,1,4,21,0,2,1,1,0.54,0.5152,0.45,0,33,210,243,210
10891,4/3/2012,2,1,4,22,0,2,1,1,0.5,0.4848,0.51,0,25,133,158,133
10892,4/3/2012,2,1,4,23,0,2,1,1,0.5,0.4848,0.59,0,13,66,79,66
10893,4/4/2012,2,1,4,0,0,3,1,1,0.48,0.4697,0.48,0,18,23,41,23
10894,4/4/2012,2,1,4,1,0,3,1,1,0.46,0.4545,0.59,0,0,11,11,11
10895,4/4/2012,2,1,4,2,0,3,1,1,0.46,0.4545,0.51,0,0,5,5,5
10896,4/4/2012,2,1,4,3,0,3,1,1,0.44,0.4394,0.58,0.0896,0,3,3,3
10897,4/4/2012,2,1,4,4,0,3,1,1,0.42,0.4242,0.67,0.0896,0,1,1,1
10898,4/4/2012,2,1,4,5,0,3,1,1,0.42,0.4242,0.67,0.0896,0,27,27,27
10899,4/4/2012,2,1,4,6,0,3,1,2,0.42,0.4242,0.58,0,6,120,126,120
10900,4/4/2012,2,1,4,7,0,3,1,2,0.44,0.4394,0.62,0,12,354,366,354
10901,4/4/2012,2,1,4,8,0,3,1,2,0.44,0.4394,0.72,0.1045,31,653,684,653
10902,4/4/2012,2,1,4,9,0,3,1,2,0.48,0.4697,0.55,0.1343,47,316,363,316
10903,4/4/2012,2,1,4,10,0,3,1,2,0.54,0.5152,0.45,0.1343,68,99,167,99
10904,4/4/2012,2,1,4,11,0,3,1,2,0.6,0.6212,0.43,0.3582,61,152,213,152
10905,4/4/2012,2,1,4,12,0,3,1,2,0.6,0.6212,0.46,0.4179,73,210,283,210
10906,4/4/2012,2,1,4,13,0,3,1,2,0.6,0.6212,0.46,0.2537,70,181,251,181
10907,4/4/2012,2,1,4,14,0,3,1,2,0.62,0.6212,0.46,0.194,82,176,258,176
10908,4/4/2012,2,1,4,15,0,3,1,2,0.64,0.6212,0.44,0.2836,86,182,268,182
10909,4/4/2012,2,1,4,16,0,3,1,2,0.64,0.6212,0.44,0.2836,86,304,390,304
10910,4/4/2012,2,1,4,17,0,3,1,1,0.66,0.6212,0.41,0.2985,99,645,744,645
10911,4/4/2012,2,1,4,18,0,3,1,1,0.66,0.6212,0.41,0.2537,113,646,759,646
10912,4/4/2012,2,1,4,19,0,3,1,1,0.66,0.6212,0.39,0.2239,75,419,494,419
10913,4/4/2012,2,1,4,20,0,3,1,1,0.64,0.6212,0.27,0.2239,39,333,372,333
10914,4/4/2012,2,1,4,21,0,3,1,1,0.6,0.6061,0.23,0.3284,43,255,298,255
10915,4/4/2012,2,1,4,22,0,3,1,1,0.56,0.5303,0.22,0.1642,30,151,181,151
10916,4/4/2012,2,1,4,23,0,3,1,1,0.52,0.5,0.23,0.4179,19,112,131,112
10917,4/5/2012,2,1,4,0,0,4,1,1,0.52,0.5,0.23,0.4179,12,33,45,33
10918,4/5/2012,2,1,4,1,0,4,1,1,0.48,0.4697,0.27,0.3284,4,9,13,9
10919,4/5/2012,2,1,4,2,0,4,1,1,0.46,0.4545,0.33,0.4478,7,11,18,11
10920,4/5/2012,2,1,4,3,0,4,1,1,0.42,0.4242,0.41,0.2985,0,5,5,5
10921,4/5/2012,2,1,4,4,0,4,1,1,0.38,0.3939,0.43,0.2836,0,1,1,1
10922,4/5/2012,2,1,4,5,0,4,1,1,0.38,0.3939,0.43,0.2836,1,28,29,28
10923,4/5/2012,2,1,4,6,0,4,1,1,0.36,0.3333,0.46,0.3284,8,118,126,118
10924,4/5/2012,2,1,4,7,0,4,1,1,0.34,0.3333,0.49,0.194,15,339,354,339
10925,4/5/2012,2,1,4,8,0,4,1,1,0.36,0.3485,0.46,0.2239,28,610,638,610
10926,4/5/2012,2,1,4,9,0,4,1,1,0.4,0.4091,0.37,0.2537,61,290,351,290
10927,4/5/2012,2,1,4,10,0,4,1,1,0.42,0.4242,0.35,0.2836,88,158,246,158
10928,4/5/2012,2,1,4,11,0,4,1,2,0.42,0.4242,0.38,0.2239,109,159,268,159
10929,4/5/2012,2,1,4,12,0,4,1,1,0.44,0.4394,0.33,0,66,210,276,210
10930,4/5/2012,2,1,4,13,0,4,1,1,0.46,0.4545,0.31,0,89,202,291,202
10931,4/5/2012,2,1,4,14,0,4,1,1,0.46,0.4545,0.33,0.1642,143,144,287,144
10932,4/5/2012,2,1,4,15,0,4,1,1,0.5,0.4848,0.31,0.1045,98,171,269,171
10933,4/5/2012,2,1,4,16,0,4,1,1,0.5,0.4848,0.31,0.194,84,318,402,318
10934,4/5/2012,2,1,4,17,0,4,1,1,0.5,0.4848,0.31,0.1642,145,677,822,677
10935,4/5/2012,2,1,4,18,0,4,1,1,0.5,0.4848,0.31,0.1045,80,618,698,618
10936,4/5/2012,2,1,4,19,0,4,1,1,0.48,0.4697,0.31,0.2537,64,423,487,423
10937,4/5/2012,2,1,4,20,0,4,1,1,0.44,0.4394,0.41,0.194,33,279,312,279
10938,4/5/2012,2,1,4,21,0,4,1,1,0.42,0.4242,0.47,0.194,25,209,234,209
10939,4/5/2012,2,1,4,22,0,4,1,1,0.4,0.4091,0.47,0.194,20,129,149,129
10940,4/5/2012,2,1,4,23,0,4,1,1,0.4,0.4091,0.5,0.1343,12,124,136,124
10941,4/6/2012,2,1,4,0,0,5,1,1,0.4,0.4091,0.43,0,12,49,61,49
10942,4/6/2012,2,1,4,1,0,5,1,1,0.36,0.3485,0.62,0.1343,10,28,38,28
10943,4/6/2012,2,1,4,2,0,5,1,1,0.36,0.3333,0.5,0.3881,6,5,11,5
10944,4/6/2012,2,1,4,3,0,5,1,1,0.34,0.303,0.53,0.3284,3,5,8,5
10945,4/6/2012,2,1,4,4,0,5,1,1,0.34,0.3182,0.49,0.2537,2,3,5,3
10946,4/6/2012,2,1,4,5,0,5,1,1,0.32,0.303,0.53,0.3284,0,23,23,23
10947,4/6/2012,2,1,4,6,0,5,1,1,0.3,0.2727,0.49,0.3881,0,80,80,80
10948,4/6/2012,2,1,4,7,0,5,1,1,0.3,0.2879,0.49,0.2836,15,231,246,231
10949,4/6/2012,2,1,4,8,0,5,1,1,0.3,0.2727,0.49,0.3284,19,489,508,489
10950,4/6/2012,2,1,4,9,0,5,1,1,0.34,0.303,0.42,0.3284,58,318,376,318
10951,4/6/2012,2,1,4,10,0,5,1,1,0.36,0.3333,0.4,0.3284,81,157,238,157
10952,4/6/2012,2,1,4,11,0,5,1,1,0.4,0.4091,0.37,0.2985,112,179,291,179
10953,4/6/2012,2,1,4,12,0,5,1,1,0.42,0.4242,0.35,0.2985,113,224,337,224
10954,4/6/2012,2,1,4,13,0,5,1,1,0.44,0.4394,0.33,0.3284,173,238,411,238
10955,4/6/2012,2,1,4,14,0,5,1,1,0.48,0.4697,0.29,0.3881,240,250,490,250
10956,4/6/2012,2,1,4,15,0,5,1,1,0.5,0.4848,0.27,0.2836,218,319,537,319
10957,4/6/2012,2,1,4,16,0,5,1,1,0.5,0.4848,0.22,0.4179,184,352,536,352
10958,4/6/2012,2,1,4,17,0,5,1,1,0.52,0.5,0.23,0.4179,172,483,655,483
10959,4/6/2012,2,1,4,18,0,5,1,1,0.5,0.4848,0.22,0.4627,104,380,484,380
10960,4/6/2012,2,1,4,19,0,5,1,1,0.48,0.4697,0.23,0.2985,115,297,412,297
10961,4/6/2012,2,1,4,20,0,5,1,1,0.46,0.4545,0.24,0.2836,61,191,252,191
10962,4/6/2012,2,1,4,21,0,5,1,1,0.44,0.4394,0.26,0.1343,54,136,190,136
10963,4/6/2012,2,1,4,22,0,5,1,1,0.4,0.4091,0.35,0.2239,34,124,158,124
10964,4/6/2012,2,1,4,23,0,5,1,1,0.42,0.4242,0.3,0.2836,21,92,113,92
10965,4/7/2012,2,1,4,0,0,6,0,1,0.42,0.4242,0.26,0.2985,9,85,94,85
10966,4/7/2012,2,1,4,1,0,6,0,1,0.4,0.4091,0.28,0.2537,9,60,69,60
10967,4/7/2012,2,1,4,2,0,6,0,1,0.36,0.3333,0.29,0.3582,11,25,36,25
10968,4/7/2012,2,1,4,3,0,6,0,1,0.36,0.3333,0.32,0.2537,7,21,28,21
10969,4/7/2012,2,1,4,4,0,6,0,1,0.32,0.3182,0.36,0.1642,3,4,7,4
10970,4/7/2012,2,1,4,5,0,6,0,1,0.32,0.3182,0.33,0.1642,0,2,2,2
10971,4/7/2012,2,1,4,6,0,6,0,1,0.32,0.3182,0.36,0.194,1,18,19,18
10972,4/7/2012,2,1,4,7,0,6,0,1,0.32,0.303,0.33,0.2836,14,40,54,40
10973,4/7/2012,2,1,4,8,0,6,0,1,0.34,0.3182,0.34,0.2537,29,94,123,94
10974,4/7/2012,2,1,4,9,0,6,0,1,0.4,0.4091,0.3,0.2537,103,173,276,173
10975,4/7/2012,2,1,4,10,0,6,0,1,0.42,0.4242,0.28,0.2537,187,176,363,176
10976,4/7/2012,2,1,4,11,0,6,0,1,0.44,0.4394,0.24,0.2985,251,244,495,244
10977,4/7/2012,2,1,4,12,0,6,0,1,0.46,0.4545,0.23,0.3881,320,270,590,270
10978,4/7/2012,2,1,4,13,0,6,0,1,0.5,0.4848,0.22,0.194,355,288,643,288
10979,4/7/2012,2,1,4,14,0,6,0,1,0.5,0.4848,0.22,0.2985,326,252,578,252
10980,4/7/2012,2,1,4,15,0,6,0,1,0.52,0.5,0.19,0.4179,321,305,626,305
10981,4/7/2012,2,1,4,16,0,6,0,1,0.54,0.5152,0.19,0.3881,354,261,615,261
10982,4/7/2012,2,1,4,17,0,6,0,1,0.54,0.5152,0.19,0.4179,299,268,567,268
10983,4/7/2012,2,1,4,18,0,6,0,1,0.54,0.5152,0.18,0.2985,227,290,517,290
10984,4/7/2012,2,1,4,19,0,6,0,1,0.54,0.5152,0.16,0.3284,170,243,413,243
10985,4/7/2012,2,1,4,20,0,6,0,1,0.5,0.4848,0.2,0.2239,73,135,208,135
10986,4/7/2012,2,1,4,21,0,6,0,1,0.5,0.4848,0.2,0.194,75,159,234,159
10987,4/7/2012,2,1,4,22,0,6,0,1,0.48,0.4697,0.2,0.194,76,106,182,106
10988,4/7/2012,2,1,4,23,0,6,0,1,0.46,0.4545,0.23,0.2239,32,86,118,86
10989,4/8/2012,2,1,4,0,0,0,0,1,0.44,0.4394,0.24,0.2239,21,64,85,64
10990,4/8/2012,2,1,4,1,0,0,0,1,0.44,0.4394,0.24,0.2239,14,50,64,50
10991,4/8/2012,2,1,4,2,0,0,0,1,0.44,0.4394,0.24,0.2239,7,25,32,25
10992,4/8/2012,2,1,4,3,0,0,0,1,0.42,0.4242,0.26,0.1343,8,18,26,18
10993,4/8/2012,2,1,4,4,0,0,0,1,0.4,0.4091,0.4,0,0,7,7,7
10994,4/8/2012,2,1,4,5,0,0,0,1,0.38,0.3939,0.46,0,4,8,12,8
10995,4/8/2012,2,1,4,6,0,0,0,1,0.36,0.3788,0.37,0,7,21,28,21
10996,4/8/2012,2,1,4,7,0,0,0,1,0.38,0.3939,0.27,0.1642,12,25,37,25
10997,4/8/2012,2,1,4,8,0,0,0,1,0.4,0.4091,0.3,0.194,19,65,84,65
10998,4/8/2012,2,1,4,9,0,0,0,1,0.44,0.4394,0.26,0.2239,71,108,179,108
10999,4/8/2012,2,1,4,10,0,0,0,1,0.5,0.4848,0.25,0.2239,113,186,299,186
11000,4/8/2012,2,1,4,11,0,0,0,1,0.5,0.4848,0.25,0.2836,195,209,404,209
11001,4/8/2012,2,1,4,12,0,0,0,1,0.54,0.5152,0.24,0.2537,198,259,457,259
11002,4/8/2012,2,1,4,13,0,0,0,1,0.58,0.5455,0.23,0.1642,229,254,483,254
11003,4/8/2012,2,1,4,14,0,0,0,1,0.6,0.5909,0.18,0.4478,254,249,503,249
11004,4/8/2012,2,1,4,15,0,0,0,1,0.62,0.6061,0.17,0.3582,260,226,486,226
11005,4/8/2012,2,1,4,16,0,0,0,1,0.64,0.6061,0.19,0.3284,232,244,476,244
11006,4/8/2012,2,1,4,17,0,0,0,1,0.62,0.6061,0.22,0.2985,185,226,411,226
11007,4/8/2012,2,1,4,18,0,0,0,1,0.62,0.6061,0.25,0.3284,151,159,310,159
11008,4/8/2012,2,1,4,19,0,0,0,1,0.6,0.6061,0.23,0.3881,89,187,276,187
11009,4/8/2012,2,1,4,20,0,0,0,1,0.56,0.5303,0.28,0.4179,65,146,211,146
11010,4/8/2012,2,1,4,21,0,0,0,1,0.52,0.5,0.34,0.2239,53,77,130,77
11011,4/8/2012,2,1,4,22,0,0,0,1,0.5,0.4848,0.36,0.2239,33,85,118,85
11012,4/8/2012,2,1,4,23,0,0,0,1,0.5,0.4848,0.39,0.2537,10,41,51,41
11013,4/9/2012,2,1,4,0,0,1,1,1,0.48,0.4697,0.39,0.2836,8,29,37,29
11014,4/9/2012,2,1,4,1,0,1,1,1,0.46,0.4545,0.41,0.1343,4,12,16,12
11015,4/9/2012,2,1,4,2,0,1,1,1,0.46,0.4545,0.31,0.194,2,4,6,4
11016,4/9/2012,2,1,4,3,0,1,1,1,0.44,0.4394,0.3,0.1642,0,3,3,3
11017,4/9/2012,2,1,4,4,0,1,1,1,0.44,0.4394,0.24,0.194,2,3,5,3
11018,4/9/2012,2,1,4,5,0,1,1,1,0.44,0.4394,0.24,0.194,2,30,32,30
11019,4/9/2012,2,1,4,6,0,1,1,1,0.42,0.4242,0.26,0.2239,3,108,111,108
11020,4/9/2012,2,1,4,7,0,1,1,1,0.42,0.4242,0.28,0.194,11,320,331,320
11021,4/9/2012,2,1,4,8,0,1,1,1,0.44,0.4394,0.3,0.194,22,595,617,595
11022,4/9/2012,2,1,4,9,0,1,1,1,0.46,0.4545,0.31,0.3582,50,236,286,236
11023,4/9/2012,2,1,4,10,0,1,1,1,0.5,0.4848,0.27,0.4925,65,113,178,113
11024,4/9/2012,2,1,4,11,0,1,1,1,0.52,0.5,0.27,0.4179,96,127,223,127
11025,4/9/2012,2,1,4,12,0,1,1,1,0.54,0.5152,0.28,0.7164,94,186,280,186
11026,4/9/2012,2,1,4,13,0,1,1,1,0.54,0.5152,0.28,0.5821,108,173,281,173
11027,4/9/2012,2,1,4,14,0,1,1,1,0.56,0.5303,0.28,0.5522,66,152,218,152
11028,4/9/2012,2,1,4,15,0,1,1,1,0.58,0.5455,0.28,0.5522,82,173,255,173
11029,4/9/2012,2,1,4,16,0,1,1,1,0.56,0.5303,0.3,0.4179,81,310,391,310
11030,4/9/2012,2,1,4,17,0,1,1,1,0.54,0.5152,0.32,0.4179,67,565,632,565
11031,4/9/2012,2,1,4,18,0,1,1,1,0.54,0.5152,0.34,0.2985,60,586,646,586
11032,4/9/2012,2,1,4,19,0,1,1,1,0.52,0.5,0.34,0.3582,35,386,421,386
11033,4/9/2012,2,1,4,20,0,1,1,1,0.5,0.4848,0.36,0.4478,21,255,276,255
11034,4/9/2012,2,1,4,21,0,1,1,3,0.48,0.4697,0.41,0.4179,14,151,165,151
11035,4/9/2012,2,1,4,22,0,1,1,2,0.46,0.4545,0.41,0.4925,6,102,108,102
11036,4/9/2012,2,1,4,23,0,1,1,1,0.44,0.4394,0.44,0.2985,6,61,67,61
11037,4/10/2012,2,1,4,0,0,2,1,2,0.44,0.4394,0.47,0.2836,3,23,26,23
11038,4/10/2012,2,1,4,1,0,2,1,1,0.42,0.4242,0.5,0.2239,0,9,9,9
11039,4/10/2012,2,1,4,2,0,2,1,1,0.36,0.3485,0.71,0.1343,0,2,2,2
11040,4/10/2012,2,1,4,3,0,2,1,1,0.36,0.3485,0.71,0.1343,0,2,2,2
11041,4/10/2012,2,1,4,4,0,2,1,1,0.34,0.3333,0.71,0.1343,0,2,2,2
11042,4/10/2012,2,1,4,5,0,2,1,1,0.34,0.3333,0.71,0.1343,0,24,24,24
11043,4/10/2012,2,1,4,6,0,2,1,1,0.34,0.3485,0.71,0.1045,3,100,103,100
11044,4/10/2012,2,1,4,7,0,2,1,1,0.34,0.3485,0.71,0.1045,16,368,384,368
11045,4/10/2012,2,1,4,8,0,2,1,1,0.38,0.3939,0.62,0.1343,22,670,692,670
11046,4/10/2012,2,1,4,9,0,2,1,1,0.42,0.4242,0.67,0.194,16,303,319,303
11047,4/10/2012,2,1,4,10,0,2,1,1,0.46,0.4545,0.47,0.1642,49,132,181,132
11048,4/10/2012,2,1,4,11,0,2,1,1,0.5,0.4848,0.36,0,78,161,239,161
11049,4/10/2012,2,1,4,12,0,2,1,1,0.54,0.5152,0.22,0.2836,75,184,259,184
11050,4/10/2012,2,1,4,13,0,2,1,1,0.52,0.5,0.23,0.1642,81,202,283,202
11051,4/10/2012,2,1,4,14,0,2,1,1,0.54,0.5152,0.24,0.194,75,149,224,149
11052,4/10/2012,2,1,4,15,0,2,1,1,0.56,0.5303,0.21,0.2985,46,157,203,157
11053,4/10/2012,2,1,4,16,0,2,1,1,0.58,0.5455,0.21,0.2537,66,296,362,296
11054,4/10/2012,2,1,4,17,0,2,1,1,0.56,0.5303,0.21,0.5224,88,656,744,656
11055,4/10/2012,2,1,4,18,0,2,1,1,0.54,0.5152,0.22,0.4179,78,626,704,626
11056,4/10/2012,2,1,4,19,0,2,1,1,0.52,0.5,0.2,0.3582,51,428,479,428
11057,4/10/2012,2,1,4,20,0,2,1,1,0.46,0.4545,0.28,0.3881,34,248,282,248
11058,4/10/2012,2,1,4,21,0,2,1,1,0.44,0.4394,0.3,0.4478,15,191,206,191
11059,4/10/2012,2,1,4,22,0,2,1,1,0.4,0.4091,0.37,0.4925,9,118,127,118
11060,4/10/2012,2,1,4,23,0,2,1,1,0.36,0.3333,0.4,0.4179,14,48,62,48
11061,4/11/2012,2,1,4,0,0,3,1,1,0.34,0.303,0.36,0.4179,8,22,30,22
11062,4/11/2012,2,1,4,1,0,3,1,1,0.34,0.3182,0.39,0.2836,3,9,12,9
11063,4/11/2012,2,1,4,2,0,3,1,1,0.32,0.303,0.45,0.2836,0,2,2,2
11064,4/11/2012,2,1,4,3,0,3,1,1,0.3,0.2879,0.49,0.2239,0,2,2,2
11065,4/11/2012,2,1,4,5,0,3,1,1,0.28,0.2727,0.56,0.194,1,26,27,26
11066,4/11/2012,2,1,4,6,0,3,1,1,0.28,0.2879,0.56,0.1045,3,103,106,103
11067,4/11/2012,2,1,4,7,0,3,1,1,0.28,0.2879,0.52,0.1343,18,303,321,303
11068,4/11/2012,2,1,4,8,0,3,1,1,0.3,0.2879,0.49,0.2239,14,581,595,581
11069,4/11/2012,2,1,4,9,0,3,1,2,0.32,0.303,0.49,0.2985,20,282,302,282
11070,4/11/2012,2,1,4,10,0,3,1,2,0.34,0.303,0.49,0.3284,26,127,153,127
11071,4/11/2012,2,1,4,11,0,3,1,2,0.38,0.3939,0.43,0.3284,38,142,180,142
11072,4/11/2012,2,1,4,12,0,3,1,2,0.36,0.3333,0.46,0.3881,35,147,182,147
11073,4/11/2012,2,1,4,13,0,3,1,2,0.4,0.4091,0.4,0.3582,16,147,163,147
11074,4/11/2012,2,1,4,14,0,3,1,1,0.36,0.3485,0.57,0.194,34,101,135,101
11075,4/11/2012,2,1,4,15,0,3,1,3,0.38,0.3939,0.46,0.2239,50,152,202,152
11076,4/11/2012,2,1,4,16,0,3,1,1,0.44,0.4394,0.33,0.2985,51,256,307,256
11077,4/11/2012,2,1,4,17,0,3,1,1,0.42,0.4242,0.35,0.3881,52,527,579,527
11078,4/11/2012,2,1,4,18,0,3,1,3,0.4,0.4091,0.43,0.4179,39,546,585,546
11079,4/11/2012,2,1,4,19,0,3,1,1,0.4,0.4091,0.4,0.3582,28,356,384,356
11080,4/11/2012,2,1,4,20,0,3,1,1,0.36,0.3333,0.46,0.3284,22,213,235,213
11081,4/11/2012,2,1,4,21,0,3,1,1,0.34,0.303,0.57,0.3881,11,154,165,154
11082,4/11/2012,2,1,4,22,0,3,1,1,0.34,0.303,0.57,0.3284,4,130,134,130
11083,4/11/2012,2,1,4,23,0,3,1,1,0.34,0.303,0.57,0.2985,9,52,61,52
11084,4/12/2012,2,1,4,0,0,4,1,1,0.32,0.303,0.66,0.2836,1,22,23,22
11085,4/12/2012,2,1,4,1,0,4,1,1,0.32,0.303,0.66,0.2239,2,7,9,7
11086,4/12/2012,2,1,4,2,0,4,1,1,0.32,0.303,0.61,0.2836,0,4,4,4
11087,4/12/2012,2,1,4,3,0,4,1,1,0.32,0.303,0.61,0.2537,2,3,5,3
11088,4/12/2012,2,1,4,4,0,4,1,1,0.3,0.2879,0.61,0.2239,0,1,1,1
11089,4/12/2012,2,1,4,5,0,4,1,1,0.3,0.2879,0.61,0.2239,0,21,21,21
11090,4/12/2012,2,1,4,6,0,4,1,1,0.3,0.2879,0.65,0.2537,2,94,96,94
11091,4/12/2012,2,1,4,7,0,4,1,1,0.3,0.2727,0.65,0.3284,12,294,306,294
11092,4/12/2012,2,1,4,8,0,4,1,1,0.32,0.303,0.66,0.3284,20,604,624,604
11093,4/12/2012,2,1,4,9,0,4,1,1,0.36,0.3333,0.57,0.3582,16,271,287,271
11094,4/12/2012,2,1,4,10,0,4,1,1,0.4,0.4091,0.5,0.2985,38,103,141,103
11095,4/12/2012,2,1,4,11,0,4,1,1,0.42,0.4242,0.47,0.2985,50,174,224,174
11096,4/12/2012,2,1,4,12,0,4,1,1,0.46,0.4545,0.41,0.4478,60,199,259,199
11097,4/12/2012,2,1,4,13,0,4,1,1,0.48,0.4697,0.36,0.4478,55,148,203,148
11098,4/12/2012,2,1,4,14,0,4,1,1,0.5,0.4848,0.31,0.3284,74,150,224,150
11099,4/12/2012,2,1,4,15,0,4,1,1,0.48,0.4697,0.31,0.2537,42,169,211,169
11100,4/12/2012,2,1,4,16,0,4,1,1,0.48,0.4697,0.31,0.2836,54,299,353,299
11101,4/12/2012,2,1,4,17,0,4,1,1,0.5,0.4848,0.27,0.3881,60,596,656,596
11102,4/12/2012,2,1,4,18,0,4,1,1,0.5,0.4848,0.27,0.3881,63,547,610,547
11103,4/12/2012,2,1,4,19,0,4,1,1,0.46,0.4545,0.31,0.2985,50,383,433,383
11104,4/12/2012,2,1,4,20,0,4,1,1,0.44,0.4394,0.33,0.2537,26,254,280,254
11105,4/12/2012,2,1,4,21,0,4,1,1,0.42,0.4242,0.35,0.1343,13,174,187,174
11106,4/12/2012,2,1,4,22,0,4,1,1,0.42,0.4242,0.35,0.194,15,143,158,143
11107,4/12/2012,2,1,4,23,0,4,1,1,0.42,0.4242,0.35,0.194,8,86,94,86
11108,4/13/2012,2,1,4,0,0,5,1,1,0.4,0.4091,0.37,0.2537,14,41,55,41
11109,4/13/2012,2,1,4,1,0,5,1,1,0.36,0.3485,0.46,0.194,2,28,30,28
11110,4/13/2012,2,1,4,2,0,5,1,1,0.34,0.3333,0.49,0.194,6,5,11,5
11111,4/13/2012,2,1,4,3,0,5,1,1,0.34,0.3333,0.61,0.1642,3,8,11,8
11112,4/13/2012,2,1,4,4,0,5,1,2,0.34,0.3333,0.53,0.1343,1,4,5,4
11113,4/13/2012,2,1,4,5,0,5,1,2,0.34,0.3333,0.53,0.1642,2,19,21,19
11114,4/13/2012,2,1,4,6,0,5,1,1,0.32,0.3182,0.57,0.1642,0,84,84,84
11115,4/13/2012,2,1,4,7,0,5,1,1,0.34,0.3182,0.61,0.2239,13,283,296,283
11116,4/13/2012,2,1,4,8,0,5,1,1,0.38,0.3939,0.46,0.1642,24,539,563,539
11117,4/13/2012,2,1,4,9,0,5,1,1,0.42,0.4242,0.41,0.1642,36,294,330,294
11118,4/13/2012,2,1,4,10,0,5,1,1,0.44,0.4394,0.38,0.194,59,133,192,133
11119,4/13/2012,2,1,4,11,0,5,1,1,0.46,0.4545,0.36,0.1343,75,158,233,158
11120,4/13/2012,2,1,4,12,0,5,1,1,0.5,0.4848,0.31,0,104,218,322,218
11121,4/13/2012,2,1,4,13,0,5,1,1,0.52,0.5,0.27,0.2836,112,246,358,246
11122,4/13/2012,2,1,4,14,0,5,1,1,0.52,0.5,0.27,0,125,223,348,223
11123,4/13/2012,2,1,4,15,0,5,1,1,0.54,0.5152,0.28,0.2537,115,237,352,237
11124,4/13/2012,2,1,4,16,0,5,1,1,0.56,0.5303,0.26,0.2537,113,350,463,350
11125,4/13/2012,2,1,4,17,0,5,1,1,0.56,0.5303,0.24,0.1642,117,621,738,621
11126,4/13/2012,2,1,4,18,0,5,1,1,0.54,0.5152,0.26,0.1343,107,564,671,564
11127,4/13/2012,2,1,4,19,0,5,1,1,0.54,0.5152,0.24,0.1642,75,352,427,352
11128,4/13/2012,2,1,4,20,0,5,1,1,0.5,0.4848,0.29,0.1343,44,242,286,242
11129,4/13/2012,2,1,4,21,0,5,1,1,0.5,0.4848,0.36,0,36,153,189,153
11130,4/13/2012,2,1,4,22,0,5,1,1,0.44,0.4394,0.62,0.1045,34,181,215,181
11131,4/13/2012,2,1,4,23,0,5,1,1,0.42,0.4242,0.62,0.0896,35,163,198,163
11132,4/14/2012,2,1,4,0,0,6,0,1,0.4,0.4091,0.58,0.1343,11,85,96,85
11133,4/14/2012,2,1,4,1,0,6,0,1,0.4,0.4091,0.58,0.1343,10,60,70,60
11134,4/14/2012,2,1,4,2,0,6,0,1,0.38,0.3939,0.66,0.1343,3,53,56,53
11135,4/14/2012,2,1,4,3,0,6,0,1,0.36,0.3636,0.66,0.0896,6,26,32,26
11136,4/14/2012,2,1,4,4,0,6,0,1,0.36,0.3636,0.71,0.1045,5,9,14,9
11137,4/14/2012,2,1,4,5,0,6,0,1,0.36,0.3636,0.66,0.1045,2,5,7,5
11138,4/14/2012,2,1,4,6,0,6,0,1,0.34,0.3333,0.76,0.1642,2,19,21,19
11139,4/14/2012,2,1,4,7,0,6,0,1,0.36,0.3636,0.71,0.1045,8,56,64,56
11140,4/14/2012,2,1,4,8,0,6,0,1,0.36,0.3485,0.71,0.1343,24,136,160,136
11141,4/14/2012,2,1,4,9,0,6,0,1,0.42,0.4242,0.54,0.1343,59,206,265,206
11142,4/14/2012,2,1,4,10,0,6,0,1,0.46,0.4545,0.51,0.1642,139,267,406,267
11143,4/14/2012,2,1,4,11,0,6,0,1,0.52,0.5,0.45,0.194,207,357,564,357
11144,4/14/2012,2,1,4,12,0,6,0,1,0.58,0.5455,0.35,0.2537,274,404,678,404
11145,4/14/2012,2,1,4,13,0,6,0,1,0.62,0.6212,0.33,0.2985,308,370,678,370
11146,4/14/2012,2,1,4,14,0,6,0,2,0.64,0.6212,0.27,0.4478,288,372,660,372
11147,4/14/2012,2,1,4,15,0,6,0,2,0.64,0.6212,0.27,0.3582,311,347,658,347
11148,4/14/2012,2,1,4,16,0,6,0,2,0.64,0.6212,0.27,0.3582,253,329,582,329
11149,4/14/2012,2,1,4,17,0,6,0,2,0.62,0.6212,0.33,0.2537,251,309,560,309
11150,4/14/2012,2,1,4,18,0,6,0,2,0.62,0.6212,0.35,0.2239,197,284,481,284
11151,4/14/2012,2,1,4,19,0,6,0,2,0.6,0.6212,0.4,0.1642,163,296,459,296
11152,4/14/2012,2,1,4,20,0,6,0,2,0.56,0.5303,0.46,0.1343,112,209,321,209
11153,4/14/2012,2,1,4,21,0,6,0,2,0.56,0.5303,0.43,0.1343,53,167,220,167
11154,4/14/2012,2,1,4,22,0,6,0,2,0.54,0.5152,0.52,0.1642,64,148,212,148
11155,4/14/2012,2,1,4,23,0,6,0,2,0.54,0.5152,0.56,0.194,45,151,196,151
11156,4/15/2012,2,1,4,0,0,0,0,2,0.54,0.5152,0.56,0.194,30,94,124,94
11157,4/15/2012,2,1,4,1,0,0,0,2,0.54,0.5152,0.56,0.1642,17,89,106,89
11158,4/15/2012,2,1,4,2,0,0,0,2,0.54,0.5152,0.56,0.1045,20,54,74,54
11159,4/15/2012,2,1,4,3,0,0,0,2,0.52,0.5,0.59,0.1343,18,27,45,27
11160,4/15/2012,2,1,4,4,0,0,0,2,0.54,0.5152,0.52,0,2,10,12,10
11161,4/15/2012,2,1,4,5,0,0,0,1,0.5,0.4848,0.68,0.1642,4,6,10,6
11162,4/15/2012,2,1,4,6,0,0,0,1,0.5,0.4848,0.63,0.1343,5,11,16,11
11163,4/15/2012,2,1,4,7,0,0,0,1,0.5,0.4848,0.63,0.1045,16,30,46,30
11164,4/15/2012,2,1,4,8,0,0,0,1,0.52,0.5,0.59,0,33,64,97,64
11165,4/15/2012,2,1,4,9,0,0,0,1,0.54,0.5152,0.56,0.2239,97,154,251,154
11166,4/15/2012,2,1,4,10,0,0,0,1,0.58,0.5455,0.53,0.2239,186,235,421,235
11167,4/15/2012,2,1,4,11,0,0,0,1,0.62,0.6212,0.46,0.2985,227,301,528,301
11168,4/15/2012,2,1,4,12,0,0,0,1,0.64,0.6212,0.44,0.2836,275,360,635,360
11169,4/15/2012,2,1,4,13,0,0,0,1,0.66,0.6212,0.44,0.2836,298,383,681,383
11170,4/15/2012,2,1,4,14,0,0,0,1,0.7,0.6364,0.39,0.2836,282,346,628,346
11171,4/15/2012,2,1,4,15,0,0,0,1,0.7,0.6364,0.39,0.3881,266,351,617,351
11172,4/15/2012,2,1,4,16,0,0,0,1,0.72,0.6515,0.39,0.3582,286,330,616,330
11173,4/15/2012,2,1,4,17,0,0,0,1,0.7,0.6364,0.42,0.3284,262,361,623,361
11174,4/15/2012,2,1,4,18,0,0,0,1,0.7,0.6364,0.42,0.2537,184,295,479,295
11175,4/15/2012,2,1,4,19,0,0,0,1,0.7,0.6364,0.42,0.2537,114,265,379,265
11176,4/15/2012,2,1,4,20,0,0,0,1,0.64,0.6212,0.5,0.2239,86,205,291,205
11177,4/15/2012,2,1,4,21,0,0,0,1,0.62,0.6212,0.57,0.2537,76,153,229,153
11178,4/15/2012,2,1,4,22,0,0,0,1,0.68,0.6364,0.44,0.3582,37,97,134,97
11179,4/15/2012,2,1,4,23,0,0,0,1,0.66,0.6212,0.5,0.3881,25,65,90,65
11180,4/16/2012,2,1,4,0,1,1,0,1,0.64,0.6212,0.53,0.3284,15,26,41,26
11181,4/16/2012,2,1,4,1,1,1,0,1,0.62,0.6061,0.61,0.3582,7,21,28,21
11182,4/16/2012,2,1,4,2,1,1,0,1,0.6,0.6061,0.64,0.2537,5,9,14,9
11183,4/16/2012,2,1,4,3,1,1,0,1,0.58,0.5455,0.68,0.194,3,5,8,5
11184,4/16/2012,2,1,4,4,1,1,0,1,0.54,0.5152,0.77,0.2239,0,6,6,6
11185,4/16/2012,2,1,4,5,1,1,0,1,0.54,0.5152,0.77,0.2239,4,34,38,34
11186,4/16/2012,2,1,4,6,1,1,0,1,0.52,0.5,0.83,0.1642,10,123,133,123
11187,4/16/2012,2,1,4,7,1,1,0,1,0.52,0.5,0.83,0.1343,20,367,387,367
11188,4/16/2012,2,1,4,8,1,1,0,2,0.56,0.5303,0.83,0.1642,48,549,597,549
11189,4/16/2012,2,1,4,9,1,1,0,1,0.62,0.6061,0.69,0.2239,59,238,297,238
11190,4/16/2012,2,1,4,10,1,1,0,1,0.62,0.6061,0.69,0.2537,75,149,224,149
11191,4/16/2012,2,1,4,11,1,1,0,1,0.64,0.6061,0.65,0.2537,115,136,251,136
11192,4/16/2012,2,1,4,12,1,1,0,1,0.68,0.6364,0.57,0.2537,75,196,271,196
11193,4/16/2012,2,1,4,13,1,1,0,1,0.74,0.6667,0.45,0.2985,79,184,263,184
11194,4/16/2012,2,1,4,14,1,1,0,1,0.76,0.6818,0.45,0.3284,105,183,288,183
11195,4/16/2012,2,1,4,15,1,1,0,1,0.8,0.697,0.33,0.4478,81,194,275,194
11196,4/16/2012,2,1,4,16,1,1,0,1,0.8,0.697,0.33,0.4627,92,266,358,266
11197,4/16/2012,2,1,4,17,1,1,0,1,0.8,0.697,0.33,0.3881,111,601,712,601
11198,4/16/2012,2,1,4,18,1,1,0,1,0.8,0.697,0.31,0.3881,87,589,676,589
11199,4/16/2012,2,1,4,19,1,1,0,1,0.76,0.6667,0.35,0.3881,61,461,522,461
11200,4/16/2012,2,1,4,20,1,1,0,1,0.74,0.6515,0.37,0.2985,48,327,375,327
11201,4/16/2012,2,1,4,21,1,1,0,1,0.68,0.6364,0.51,0.2537,39,232,271,232
11202,4/16/2012,2,1,4,22,1,1,0,1,0.68,0.6364,0.51,0.2537,35,179,214,179
11203,4/16/2012,2,1,4,23,1,1,0,1,0.7,0.6364,0.45,0.2985,24,97,121,97
11204,4/17/2012,2,1,4,0,0,2,1,1,0.66,0.6212,0.54,0.194,10,33,43,33
11205,4/17/2012,2,1,4,1,0,2,1,1,0.64,0.6212,0.57,0.1642,6,5,11,5
11206,4/17/2012,2,1,4,2,0,2,1,1,0.56,0.5303,0.83,0.1045,1,3,4,3
11207,4/17/2012,2,1,4,3,0,2,1,1,0.56,0.5303,0.83,0.0896,0,6,6,6
11208,4/17/2012,2,1,4,4,0,2,1,1,0.66,0.6212,0.44,0.2239,3,6,9,6
11209,4/17/2012,2,1,4,5,0,2,1,1,0.6,0.6212,0.53,0.2537,1,29,30,29
11210,4/17/2012,2,1,4,6,0,2,1,1,0.6,0.6212,0.46,0.2537,8,136,144,136
11211,4/17/2012,2,1,4,7,0,2,1,1,0.6,0.6212,0.43,0.2537,18,443,461,443
11212,4/17/2012,2,1,4,8,0,2,1,1,0.6,0.6212,0.43,0.2239,42,631,673,631
11213,4/17/2012,2,1,4,9,0,2,1,1,0.6,0.6212,0.38,0.4925,71,329,400,329
11214,4/17/2012,2,1,4,10,0,2,1,1,0.6,0.6212,0.38,0.4179,52,165,217,165
11215,4/17/2012,2,1,4,11,0,2,1,1,0.6,0.6212,0.33,0.4179,65,174,239,174
11216,4/17/2012,2,1,4,12,0,2,1,1,0.6,0.6212,0.33,0.3582,65,179,244,179
11217,4/17/2012,2,1,4,13,0,2,1,1,0.62,0.6212,0.29,0.2537,52,187,239,187
11218,4/17/2012,2,1,4,14,0,2,1,1,0.64,0.6212,0.27,0.2836,59,198,257,198
11219,4/17/2012,2,1,4,15,0,2,1,1,0.66,0.6212,0.24,0.3284,91,217,308,217
11220,4/17/2012,2,1,4,16,0,2,1,1,0.68,0.6212,0.22,0.3582,50,320,370,320
11221,4/17/2012,2,1,4,17,0,2,1,1,0.64,0.6061,0.25,0.2985,108,673,781,673
11222,4/17/2012,2,1,4,18,0,2,1,1,0.64,0.6061,0.25,0.2836,105,670,775,670
11223,4/17/2012,2,1,4,19,0,2,1,1,0.6,0.6061,0.26,0.2537,73,464,537,464
11224,4/17/2012,2,1,4,20,0,2,1,1,0.6,0.6061,0.23,0.2836,44,358,402,358
11225,4/17/2012,2,1,4,21,0,2,1,1,0.56,0.5303,0.26,0.2985,37,260,297,260
11226,4/17/2012,2,1,4,22,0,2,1,1,0.54,0.5152,0.3,0.2537,18,144,162,144
11227,4/17/2012,2,1,4,23,0,2,1,1,0.54,0.5152,0.32,0.2239,10,72,82,72
11228,4/18/2012,2,1,4,0,0,3,1,1,0.54,0.5152,0.32,0.1642,3,35,38,35
11229,4/18/2012,2,1,4,1,0,3,1,1,0.52,0.5,0.34,0.194,1,13,14,13
11230,4/18/2012,2,1,4,2,0,3,1,2,0.5,0.4848,0.42,0.194,1,8,9,8
11231,4/18/2012,2,1,4,3,0,3,1,2,0.5,0.4848,0.42,0.2239,0,6,6,6
11232,4/18/2012,2,1,4,4,0,3,1,2,0.5,0.4848,0.42,0.2836,0,7,7,7
11233,4/18/2012,2,1,4,5,0,3,1,2,0.5,0.4848,0.39,0.2836,0,34,34,34
11234,4/18/2012,2,1,4,6,0,3,1,2,0.5,0.4848,0.39,0.2836,6,128,134,128
11235,4/18/2012,2,1,4,7,0,3,1,2,0.5,0.4848,0.39,0.194,10,408,418,408
11236,4/18/2012,2,1,4,8,0,3,1,3,0.5,0.4848,0.39,0.194,25,551,576,551
11237,4/18/2012,2,1,4,9,0,3,1,3,0.48,0.4697,0.44,0.2985,20,245,265,245
11238,4/18/2012,2,1,4,10,0,3,1,3,0.48,0.4697,0.47,0.2239,31,116,147,116
11239,4/18/2012,2,1,4,11,0,3,1,3,0.46,0.4545,0.47,0.2537,14,105,119,105
11240,4/18/2012,2,1,4,12,0,3,1,3,0.46,0.4545,0.51,0.1045,15,95,110,95
11241,4/18/2012,2,1,4,13,0,3,1,3,0.46,0.4545,0.59,0,13,51,64,51
11242,4/18/2012,2,1,4,14,0,3,1,3,0.44,0.4394,0.72,0.1045,8,43,51,43
11243,4/18/2012,2,1,4,15,0,3,1,3,0.42,0.4242,0.77,0.194,10,88,98,88
11244,4/18/2012,2,1,4,16,0,3,1,2,0.42,0.4242,0.77,0.2239,36,199,235,199
11245,4/18/2012,2,1,4,17,0,3,1,2,0.42,0.4242,0.77,0.194,46,442,488,442
11246,4/18/2012,2,1,4,18,0,3,1,2,0.42,0.4242,0.77,0,27,478,505,478
11247,4/18/2012,2,1,4,19,0,3,1,2,0.42,0.4242,0.77,0.1343,26,342,368,342
11248,4/18/2012,2,1,4,20,0,3,1,2,0.42,0.4242,0.77,0.1045,8,252,260,252
11249,4/18/2012,2,1,4,21,0,3,1,2,0.42,0.4242,0.82,0.0896,24,165,189,165
11250,4/18/2012,2,1,4,22,0,3,1,2,0.42,0.4242,0.77,0.0896,9,153,162,153
11251,4/18/2012,2,1,4,23,0,3,1,2,0.42,0.4242,0.77,0,14,56,70,56
11252,4/19/2012,2,1,4,0,0,4,1,3,0.42,0.4242,0.77,0,5,20,25,20
11253,4/19/2012,2,1,4,1,0,4,1,3,0.42,0.4242,0.77,0.1045,2,11,13,11
11254,4/19/2012,2,1,4,2,0,4,1,2,0.42,0.4242,0.77,0,2,4,6,4
11255,4/19/2012,2,1,4,3,0,4,1,2,0.42,0.4242,0.77,0,1,3,4,3
11256,4/19/2012,2,1,4,4,0,4,1,2,0.42,0.4242,0.71,0,0,4,4,4
11257,4/19/2012,2,1,4,5,0,4,1,1,0.4,0.4091,0.82,0,0,30,30,30
11258,4/19/2012,2,1,4,6,0,4,1,2,0.4,0.4091,0.82,0.1045,4,116,120,116
11259,4/19/2012,2,1,4,7,0,4,1,2,0.4,0.4091,0.82,0.1343,15,391,406,391
11260,4/19/2012,2,1,4,8,0,4,1,2,0.42,0.4242,0.82,0.1045,26,651,677,651
11261,4/19/2012,2,1,4,9,0,4,1,2,0.46,0.4545,0.72,0,31,270,301,270
11262,4/19/2012,2,1,4,10,0,4,1,1,0.48,0.4697,0.63,0.0896,46,143,189,143
11263,4/19/2012,2,1,4,11,0,4,1,1,0.52,0.5,0.48,0,46,183,229,183
11264,4/19/2012,2,1,4,12,0,4,1,1,0.54,0.5152,0.49,0,51,213,264,213
11265,4/19/2012,2,1,4,13,0,4,1,1,0.56,0.5303,0.46,0,52,186,238,186
11266,4/19/2012,2,1,4,14,0,4,1,1,0.58,0.5455,0.43,0,54,183,237,183
11267,4/19/2012,2,1,4,15,0,4,1,1,0.6,0.6212,0.43,0,66,196,262,196
11268,4/19/2012,2,1,4,16,0,4,1,1,0.62,0.6212,0.41,0.1045,63,324,387,324
11269,4/19/2012,2,1,4,17,0,4,1,1,0.6,0.6212,0.43,0.0896,85,663,748,663
11270,4/19/2012,2,1,4,18,0,4,1,1,0.6,0.6212,0.43,0.0896,99,677,776,677
11271,4/19/2012,2,1,4,19,0,4,1,1,0.58,0.5455,0.46,0.1343,70,516,586,516
11272,4/19/2012,2,1,4,20,0,4,1,1,0.56,0.5303,0.49,0.2239,52,352,404,352
11273,4/19/2012,2,1,4,21,0,4,1,1,0.52,0.5,0.55,0.1045,27,240,267,240
11274,4/19/2012,2,1,4,22,0,4,1,1,0.52,0.5,0.59,0.194,29,219,248,219
11275,4/19/2012,2,1,4,23,0,4,1,1,0.5,0.4848,0.63,0.1045,20,124,144,124
11276,4/20/2012,2,1,4,0,0,5,1,1,0.48,0.4697,0.67,0.1045,5,59,64,59
11277,4/20/2012,2,1,4,1,0,5,1,1,0.46,0.4545,0.82,0.194,3,22,25,22
11278,4/20/2012,2,1,4,2,0,5,1,1,0.44,0.4394,0.88,0.194,3,18,21,18
11279,4/20/2012,2,1,4,3,0,5,1,1,0.44,0.4394,0.88,0.1045,1,9,10,9
11280,4/20/2012,2,1,4,4,0,5,1,1,0.42,0.4242,0.94,0.1045,0,3,3,3
11281,4/20/2012,2,1,4,5,0,5,1,1,0.42,0.4242,0.94,0,1,24,25,24
11282,4/20/2012,2,1,4,6,0,5,1,1,0.42,0.4242,0.88,0,8,105,113,105
11283,4/20/2012,2,1,4,7,0,5,1,1,0.42,0.4242,0.94,0,9,350,359,350
11284,4/20/2012,2,1,4,8,0,5,1,1,0.44,0.4394,0.94,0,32,668,700,668
11285,4/20/2012,2,1,4,9,0,5,1,1,0.46,0.4545,0.88,0.0896,30,329,359,329
11286,4/20/2012,2,1,4,10,0,5,1,1,0.5,0.4848,0.77,0.194,67,170,237,170
11287,4/20/2012,2,1,4,11,0,5,1,1,0.54,0.5152,0.68,0.1642,64,190,254,190
11288,4/20/2012,2,1,4,12,0,5,1,1,0.58,0.5455,0.53,0.194,102,260,362,260
11289,4/20/2012,2,1,4,13,0,5,1,1,0.62,0.6212,0.43,0.194,105,276,381,276
11290,4/20/2012,2,1,4,14,0,5,1,1,0.64,0.6212,0.44,0.2239,156,238,394,238
11291,4/20/2012,2,1,4,15,0,5,1,1,0.64,0.6212,0.47,0.194,145,262,407,262
11292,4/20/2012,2,1,4,16,0,5,1,1,0.66,0.6212,0.44,0.194,151,429,580,429
11293,4/20/2012,2,1,4,17,0,5,1,1,0.64,0.6212,0.47,0.2836,122,697,819,697
11294,4/20/2012,2,1,4,18,0,5,1,1,0.62,0.6212,0.5,0.2836,110,558,668,558
11295,4/20/2012,2,1,4,19,0,5,1,1,0.6,0.6212,0.53,0.194,82,410,492,410
11296,4/20/2012,2,1,4,20,0,5,1,1,0.58,0.5455,0.56,0.1642,52,289,341,289
11297,4/20/2012,2,1,4,21,0,5,1,1,0.56,0.5303,0.68,0.1343,35,252,287,252
11298,4/20/2012,2,1,4,22,0,5,1,1,0.54,0.5152,0.68,0.2537,26,176,202,176
11299,4/20/2012,2,1,4,23,0,5,1,1,0.52,0.5,0.72,0.1343,31,156,187,156
11300,4/21/2012,2,1,4,0,0,6,0,1,0.52,0.5,0.77,0.2239,31,111,142,111
11301,4/21/2012,2,1,4,1,0,6,0,1,0.52,0.5,0.77,0.2239,24,64,88,64
11302,4/21/2012,2,1,4,2,0,6,0,1,0.52,0.5,0.77,0.1343,12,69,81,69
11303,4/21/2012,2,1,4,3,0,6,0,1,0.5,0.4848,0.82,0.2239,4,25,29,25
11304,4/21/2012,2,1,4,4,0,6,0,1,0.5,0.4848,0.82,0.2537,0,9,9,9
11305,4/21/2012,2,1,4,5,0,6,0,1,0.5,0.4848,0.82,0.2537,0,1,1,1
11306,4/21/2012,2,1,4,6,0,6,0,1,0.5,0.4848,0.82,0.2239,10,21,31,21
11307,4/21/2012,2,1,4,7,0,6,0,1,0.5,0.4848,0.82,0.2836,21,55,76,55
11308,4/21/2012,2,1,4,8,0,6,0,1,0.52,0.5,0.81,0.2537,52,149,201,149
11309,4/21/2012,2,1,4,9,0,6,0,1,0.54,0.5152,0.77,0.1642,115,216,331,216
11310,4/21/2012,2,1,4,10,0,6,0,1,0.6,0.6061,0.64,0.2836,183,299,482,299
11311,4/21/2012,2,1,4,11,0,6,0,1,0.62,0.6061,0.61,0.3284,260,348,608,348
11312,4/21/2012,2,1,4,12,0,6,0,1,0.64,0.6212,0.57,0.2239,262,378,640,378
11313,4/21/2012,2,1,4,13,0,6,0,1,0.66,0.6212,0.54,0.2239,291,358,649,358
11314,4/21/2012,2,1,4,14,0,6,0,1,0.7,0.6364,0.45,0.2836,278,331,609,331
11315,4/21/2012,2,1,4,15,0,6,0,1,0.72,0.6515,0.39,0.2537,267,361,628,361
11316,4/21/2012,2,1,4,16,0,6,0,1,0.7,0.6364,0.42,0.3284,267,372,639,372
11317,4/21/2012,2,1,4,17,0,6,0,2,0.74,0.6515,0.3,0.3881,259,309,568,309
11318,4/21/2012,2,1,4,18,0,6,0,2,0.68,0.6364,0.47,0.4925,133,283,416,283
11319,4/21/2012,2,1,4,19,0,6,0,3,0.56,0.5303,0.73,0.4925,9,45,54,45
11320,4/21/2012,2,1,4,20,0,6,0,3,0.5,0.4848,0.82,0.2985,5,34,39,34
11321,4/21/2012,2,1,4,21,0,6,0,3,0.5,0.4848,0.82,0.3881,20,82,102,82
11322,4/21/2012,2,1,4,22,0,6,0,1,0.48,0.4697,0.82,0.2985,20,90,110,90
11323,4/21/2012,2,1,4,23,0,6,0,2,0.46,0.4545,0.82,0.2836,18,73,91,73
11324,4/22/2012,2,1,4,0,0,0,0,2,0.46,0.4545,0.82,0.194,32,85,117,85
11325,4/22/2012,2,1,4,1,0,0,0,2,0.46,0.4545,0.82,0.3284,10,63,73,63
11326,4/22/2012,2,1,4,2,0,0,0,1,0.46,0.4545,0.72,0.2836,7,49,56,49
11327,4/22/2012,2,1,4,3,0,0,0,2,0.44,0.4394,0.82,0.1642,7,33,40,33
11328,4/22/2012,2,1,4,4,0,0,0,2,0.44,0.4394,0.77,0.1642,0,7,7,7
11329,4/22/2012,2,1,4,5,0,0,0,2,0.44,0.4394,0.77,0.2239,0,6,6,6
11330,4/22/2012,2,1,4,6,0,0,0,2,0.44,0.4394,0.72,0.3284,6,6,12,6
11331,4/22/2012,2,1,4,7,0,0,0,3,0.42,0.4242,0.77,0.3881,2,22,24,22
11332,4/22/2012,2,1,4,8,0,0,0,3,0.4,0.4091,0.82,0.2537,8,43,51,43
11333,4/22/2012,2,1,4,9,0,0,0,3,0.4,0.4091,0.82,0.2537,8,71,79,71
11334,4/22/2012,2,1,4,10,0,0,0,3,0.38,0.3939,0.82,0.3284,11,57,68,57
11335,4/22/2012,2,1,4,11,0,0,0,3,0.38,0.3939,0.87,0.2985,7,70,77,70
11336,4/22/2012,2,1,4,12,0,0,0,3,0.38,0.3939,0.87,0.3284,5,56,61,56
11337,4/22/2012,2,1,4,13,0,0,0,3,0.38,0.3939,0.82,0.3582,5,47,52,47
11338,4/22/2012,2,1,4,14,0,0,0,3,0.38,0.3939,0.87,0.3284,3,50,53,50
11339,4/22/2012,2,1,4,15,0,0,0,3,0.38,0.3939,0.87,0.3881,0,38,38,38
11340,4/22/2012,2,1,4,16,0,0,0,3,0.38,0.3939,0.87,0.4478,4,32,36,32
11341,4/22/2012,2,1,4,17,0,0,0,3,0.36,0.3182,0.93,0.4478,2,25,27,25
11342,4/22/2012,2,1,4,18,0,0,0,3,0.36,0.3182,0.93,0.4478,1,38,39,38
11343,4/22/2012,2,1,4,19,0,0,0,3,0.36,0.3182,0.87,0.5224,1,34,35,34
11344,4/22/2012,2,1,4,20,0,0,0,3,0.36,0.3333,0.93,0.4179,1,34,35,34
11345,4/22/2012,2,1,4,21,0,0,0,3,0.36,0.3333,0.87,0.3881,0,11,11,11
11346,4/22/2012,2,1,4,22,0,0,0,3,0.34,0.2879,0.87,0.5224,0,13,13,13
11347,4/22/2012,2,1,4,23,0,0,0,3,0.36,0.3182,0.81,0.4627,0,17,17,17
11348,4/23/2012,2,1,4,0,0,1,1,3,0.36,0.3333,0.81,0.4179,0,6,6,6
11349,4/23/2012,2,1,4,1,0,1,1,3,0.34,0.303,0.87,0.3582,1,1,2,1
11350,4/23/2012,2,1,4,2,0,1,1,2,0.32,0.303,0.87,0.3284,1,3,4,3
11351,4/23/2012,2,1,4,3,0,1,1,2,0.32,0.303,0.81,0.2836,0,1,1,1
11352,4/23/2012,2,1,4,4,0,1,1,3,0.3,0.2879,0.81,0.2836,0,3,3,3
11353,4/23/2012,2,1,4,5,0,1,1,3,0.3,0.2879,0.81,0.2836,0,14,14,14
11354,4/23/2012,2,1,4,6,0,1,1,2,0.3,0.2727,0.81,0.2985,2,43,45,43
11355,4/23/2012,2,1,4,7,0,1,1,3,0.3,0.2879,0.81,0.2537,1,206,207,206
11356,4/23/2012,2,1,4,8,0,1,1,2,0.3,0.2727,0.75,0.3284,11,471,482,471
11357,4/23/2012,2,1,4,9,0,1,1,2,0.3,0.2727,0.75,0.3881,17,255,272,255
11358,4/23/2012,2,1,4,10,0,1,1,2,0.32,0.303,0.7,0.3284,12,88,100,88
11359,4/23/2012,2,1,4,11,0,1,1,2,0.32,0.2879,0.7,0.3582,10,91,101,91
11360,4/23/2012,2,1,4,12,0,1,1,3,0.34,0.303,0.71,0.3582,12,117,129,117
11361,4/23/2012,2,1,4,13,0,1,1,3,0.34,0.303,0.66,0.3881,9,98,107,98
11362,4/23/2012,2,1,4,14,0,1,1,3,0.36,0.3182,0.62,0.4478,12,102,114,102
11363,4/23/2012,2,1,4,15,0,1,1,2,0.36,0.3333,0.62,0.3881,11,101,112,101
11364,4/23/2012,2,1,4,16,0,1,1,3,0.3,0.2727,0.81,0.3582,10,93,103,93
11365,4/23/2012,2,1,4,17,0,1,1,3,0.3,0.2727,0.82,0.3284,13,219,232,219
11366,4/23/2012,2,1,4,18,0,1,1,3,0.32,0.3333,0.81,0.1343,10,369,379,369
11367,4/23/2012,2,1,4,19,0,1,1,2,0.34,0.3182,0.76,0.2239,11,287,298,287
11368,4/23/2012,2,1,4,20,0,1,1,2,0.32,0.3182,0.76,0.1642,17,186,203,186
11369,4/23/2012,2,1,4,21,0,1,1,2,0.32,0.303,0.81,0.2239,7,145,152,145
11370,4/23/2012,2,1,4,22,0,1,1,1,0.32,0.3182,0.76,0.194,18,71,89,71
11371,4/23/2012,2,1,4,23,0,1,1,1,0.32,0.3182,0.76,0.1642,10,49,59,49
11372,4/24/2012,2,1,4,0,0,2,1,2,0.32,0.3333,0.76,0.1343,0,13,13,13
11373,4/24/2012,2,1,4,1,0,2,1,2,0.32,0.3333,0.81,0.1343,1,6,7,6
11374,4/24/2012,2,1,4,2,0,2,1,1,0.32,0.3182,0.81,0.194,0,3,3,3
11375,4/24/2012,2,1,4,3,0,2,1,1,0.32,0.303,0.81,0.2239,0,2,2,2
11376,4/24/2012,2,1,4,4,0,2,1,1,0.3,0.2879,0.7,0.194,0,3,3,3
11377,4/24/2012,2,1,4,5,0,2,1,1,0.3,0.2879,0.7,0.194,0,22,22,22
11378,4/24/2012,2,1,4,6,0,2,1,1,0.3,0.2879,0.7,0.2239,3,117,120,117
11379,4/24/2012,2,1,4,7,0,2,1,1,0.32,0.303,0.66,0.2836,3,387,390,387
11380,4/24/2012,2,1,4,8,0,2,1,1,0.34,0.3182,0.61,0.2537,12,599,611,599
11381,4/24/2012,2,1,4,9,0,2,1,1,0.4,0.4091,0.47,0.3582,6,302,308,302
11382,4/24/2012,2,1,4,10,0,2,1,1,0.42,0.4242,0.47,0.2985,33,129,162,129
11383,4/24/2012,2,1,4,11,0,2,1,1,0.46,0.4545,0.31,0.3881,27,157,184,157
11384,4/24/2012,2,1,4,12,0,2,1,1,0.48,0.4697,0.29,0.3881,36,188,224,188
11385,4/24/2012,2,1,4,13,0,2,1,1,0.5,0.4848,0.29,0.3881,35,189,224,189
11386,4/24/2012,2,1,4,14,0,2,1,1,0.5,0.4848,0.25,0.3881,50,166,216,166
11387,4/24/2012,2,1,4,15,0,2,1,1,0.5,0.4848,0.23,0.4179,60,176,236,176
11388,4/24/2012,2,1,4,16,0,2,1,1,0.5,0.4848,0.23,0.194,54,308,362,308
11389,4/24/2012,2,1,4,17,0,2,1,1,0.52,0.5,0.22,0.3881,72,619,691,619
11390,4/24/2012,2,1,4,18,0,2,1,1,0.5,0.4848,0.18,0,52,580,632,580
11391,4/24/2012,2,1,4,19,0,2,1,1,0.5,0.4848,0.18,0.2537,33,449,482,449
11392,4/24/2012,2,1,4,20,0,2,1,1,0.48,0.4697,0.21,0.3284,16,269,285,269
11393,4/24/2012,2,1,4,21,0,2,1,2,0.46,0.4545,0.28,0.1642,13,213,226,213
11394,4/24/2012,2,1,4,22,0,2,1,1,0.44,0.4394,0.35,0.1045,8,149,157,149
11395,4/24/2012,2,1,4,23,0,2,1,1,0.42,0.4242,0.38,0.0896,4,69,73,69
11396,4/25/2012,2,1,4,0,0,3,1,1,0.44,0.4394,0.38,0,13,23,36,23
11397,4/25/2012,2,1,4,1,0,3,1,1,0.42,0.4242,0.41,0,8,17,25,17
11398,4/25/2012,2,1,4,2,0,3,1,1,0.36,0.3788,0.62,0,1,6,7,6
11399,4/25/2012,2,1,4,3,0,3,1,1,0.32,0.3333,0.7,0.0896,0,3,3,3
11400,4/25/2012,2,1,4,4,0,3,1,1,0.34,0.3485,0.66,0.0896,0,6,6,6
11401,4/25/2012,2,1,4,5,0,3,1,1,0.34,0.3636,0.66,0,0,24,24,24
11402,4/25/2012,2,1,4,6,0,3,1,1,0.34,0.3636,0.66,0,3,103,106,103
11403,4/25/2012,2,1,4,7,0,3,1,1,0.34,0.3636,0.71,0,13,376,389,376
11404,4/25/2012,2,1,4,8,0,3,1,1,0.36,0.3636,0.76,0.0896,20,634,654,634
11405,4/25/2012,2,1,4,9,0,3,1,1,0.42,0.4242,0.54,0,33,288,321,288
11406,4/25/2012,2,1,4,10,0,3,1,1,0.52,0.5,0.34,0,44,138,182,138
11407,4/25/2012,2,1,4,11,0,3,1,1,0.52,0.5,0.32,0.1343,42,177,219,177
11408,4/25/2012,2,1,4,12,0,3,1,1,0.54,0.5152,0.28,0.2836,49,220,269,220
11409,4/25/2012,2,1,4,13,0,3,1,1,0.56,0.5303,0.26,0.2239,35,193,228,193
11410,4/25/2012,2,1,4,14,0,3,1,1,0.56,0.5303,0.22,0.3582,47,176,223,176
11411,4/25/2012,2,1,4,15,0,3,1,1,0.58,0.5455,0.19,0.1642,47,182,229,182
11412,4/25/2012,2,1,4,16,0,3,1,1,0.6,0.5909,0.2,0.3284,49,327,376,327
11413,4/25/2012,2,1,4,17,0,3,1,1,0.6,0.5909,0.2,0.2985,68,664,732,664
11414,4/25/2012,2,1,4,18,0,3,1,1,0.6,0.5909,0.2,0.2836,60,649,709,649
11415,4/25/2012,2,1,4,19,0,3,1,1,0.6,0.5909,0.2,0.194,42,501,543,501
11416,4/25/2012,2,1,4,20,0,3,1,1,0.56,0.5303,0.22,0.0896,22,358,380,358
11417,4/25/2012,2,1,4,21,0,3,1,1,0.52,0.5,0.52,0.1343,27,212,239,212
11418,4/25/2012,2,1,4,22,0,3,1,1,0.5,0.4848,0.51,0,22,170,192,170
11419,4/25/2012,2,1,4,23,0,3,1,2,0.5,0.4848,0.51,0.0896,10,94,104,94
11420,4/26/2012,2,1,4,0,0,4,1,2,0.48,0.4697,0.63,0,1,42,43,42
11421,4/26/2012,2,1,4,1,0,4,1,2,0.48,0.4697,0.48,0.0896,1,22,23,22
11422,4/26/2012,2,1,4,2,0,4,1,2,0.48,0.4697,0.55,0.1045,3,10,13,10
11423,4/26/2012,2,1,4,3,0,4,1,2,0.48,0.4697,0.55,0.0896,1,5,6,5
11424,4/26/2012,2,1,4,4,0,4,1,2,0.48,0.4697,0.59,0.0896,1,2,3,2
11425,4/26/2012,2,1,4,5,0,4,1,2,0.48,0.4697,0.63,0.1343,0,17,17,17
11426,4/26/2012,2,1,4,6,0,4,1,2,0.48,0.4697,0.63,0.2537,5,122,127,122
11427,4/26/2012,2,1,4,7,0,4,1,3,0.46,0.4545,0.82,0.3582,3,222,225,222
11428,4/26/2012,2,1,4,8,0,4,1,3,0.46,0.4545,0.82,0.194,4,358,362,358
11429,4/26/2012,2,1,4,9,0,4,1,3,0.46,0.4545,0.88,0.1642,12,189,201,189
11430,4/26/2012,2,1,4,10,0,4,1,2,0.46,0.4545,0.94,0.1642,14,125,139,125
11431,4/26/2012,2,1,4,11,0,4,1,2,0.46,0.4545,0.94,0.2239,16,135,151,135
11432,4/26/2012,2,1,4,12,0,4,1,2,0.52,0.5,0.83,0.1343,24,180,204,180
11433,4/26/2012,2,1,4,13,0,4,1,2,0.5,0.4848,0.82,0.1642,19,178,197,178
11434,4/26/2012,2,1,4,14,0,4,1,2,0.54,0.5152,0.77,0.194,37,132,169,132
11435,4/26/2012,2,1,4,15,0,4,1,2,0.52,0.5,0.83,0.3284,39,165,204,165
11436,4/26/2012,2,1,4,16,0,4,1,2,0.52,0.5,0.83,0.2239,37,281,318,281
11437,4/26/2012,2,1,4,17,0,4,1,1,0.54,0.5152,0.77,0.1642,49,565,614,565
11438,4/26/2012,2,1,4,18,0,4,1,2,0.54,0.5152,0.77,0.194,75,589,664,589
11439,4/26/2012,2,1,4,19,0,4,1,2,0.54,0.5152,0.77,0.2239,57,407,464,407
11440,4/26/2012,2,1,4,20,0,4,1,1,0.54,0.5152,0.77,0.194,23,314,337,314
11441,4/26/2012,2,1,4,21,0,4,1,1,0.52,0.5,0.83,0.2239,28,222,250,222
11442,4/26/2012,2,1,4,22,0,4,1,1,0.52,0.5,0.83,0.1642,20,163,183,163
11443,4/26/2012,2,1,4,23,0,4,1,1,0.5,0.4848,0.88,0.1642,6,106,112,106
11444,4/27/2012,2,1,4,0,0,5,1,1,0.54,0.5152,0.68,0.5522,12,61,73,61
11445,4/27/2012,2,1,4,1,0,5,1,1,0.5,0.4848,0.59,0.4478,3,32,35,32
11446,4/27/2012,2,1,4,2,0,5,1,1,0.48,0.4697,0.59,0.4179,4,18,22,18
11447,4/27/2012,2,1,4,3,0,5,1,1,0.44,0.4394,0.47,0.4925,1,2,3,2
11448,4/27/2012,2,1,4,4,0,5,1,1,0.42,0.4242,0.44,0.2537,0,6,6,6
11449,4/27/2012,2,1,4,5,0,5,1,1,0.42,0.4242,0.44,0.3582,0,19,19,19
11450,4/27/2012,2,1,4,6,0,5,1,1,0.4,0.4091,0.43,0.2537,5,115,120,115
11451,4/27/2012,2,1,4,7,0,5,1,1,0.38,0.3939,0.5,0.2836,10,305,315,305
11452,4/27/2012,2,1,4,8,0,5,1,1,0.4,0.4091,0.5,0,17,575,592,575
11453,4/27/2012,2,1,4,9,0,5,1,1,0.42,0.4242,0.44,0.4925,42,292,334,292
11454,4/27/2012,2,1,4,10,0,5,1,1,0.44,0.4394,0.38,0.4179,64,172,236,172
11455,4/27/2012,2,1,4,11,0,5,1,1,0.44,0.4394,0.38,0.3284,47,186,233,186
11456,4/27/2012,2,1,4,12,0,5,1,1,0.46,0.4545,0.36,0.3582,63,244,307,244
11457,4/27/2012,2,1,4,13,0,5,1,1,0.46,0.4545,0.33,0.3881,94,212,306,212
11458,4/27/2012,2,1,4,14,0,5,1,1,0.46,0.4545,0.33,0.3284,94,206,300,206
11459,4/27/2012,2,1,4,15,0,5,1,1,0.52,0.5,0.29,0.4925,101,223,324,223
11460,4/27/2012,2,1,4,16,0,5,1,1,0.52,0.5,0.29,0.2537,105,335,440,335
11461,4/27/2012,2,1,4,17,0,5,1,1,0.54,0.5152,0.24,0.3881,89,613,702,613
11462,4/27/2012,2,1,4,18,0,5,1,1,0.52,0.5,0.25,0.3582,94,560,654,560
11463,4/27/2012,2,1,4,19,0,5,1,1,0.5,0.4848,0.27,0.3881,62,379,441,379
11464,4/27/2012,2,1,4,20,0,5,1,1,0.46,0.4545,0.31,0.2836,49,240,289,240
11465,4/27/2012,2,1,4,21,0,5,1,1,0.44,0.4394,0.33,0.2985,23,185,208,185
11466,4/27/2012,2,1,4,22,0,5,1,1,0.42,0.4242,0.38,0.2537,24,134,158,134
11467,4/27/2012,2,1,4,23,0,5,1,1,0.4,0.4091,0.4,0.2537,11,105,116,105
11468,4/28/2012,2,1,4,0,0,6,0,1,0.38,0.3939,0.43,0.1642,4,99,103,99
11469,4/28/2012,2,1,4,1,0,6,0,1,0.36,0.3333,0.5,0.2985,7,60,67,60
11470,4/28/2012,2,1,4,2,0,6,0,1,0.36,0.3485,0.43,0.1642,8,49,57,49
11471,4/28/2012,2,1,4,3,0,6,0,1,0.34,0.3182,0.49,0.2239,3,23,26,23
11472,4/28/2012,2,1,4,4,0,6,0,1,0.34,0.3333,0.49,0.1642,0,2,2,2
11473,4/28/2012,2,1,4,5,0,6,0,1,0.34,0.3333,0.46,0.1343,2,3,5,3
11474,4/28/2012,2,1,4,6,0,6,0,1,0.34,0.3333,0.49,0.194,10,18,28,18
11475,4/28/2012,2,1,4,7,0,6,0,1,0.34,0.3333,0.49,0.1642,10,45,55,45
11476,4/28/2012,2,1,4,8,0,6,0,1,0.38,0.3939,0.4,0.1343,24,134,158,134
11477,4/28/2012,2,1,4,9,0,6,0,2,0.38,0.3939,0.37,0,45,169,214,169
11478,4/28/2012,2,1,4,10,0,6,0,2,0.38,0.3939,0.4,0.1642,60,231,291,231
11479,4/28/2012,2,1,4,11,0,6,0,2,0.38,0.3939,0.4,0.1045,96,262,358,262
11480,4/28/2012,2,1,4,12,0,6,0,2,0.38,0.3939,0.43,0,105,276,381,276
11481,4/28/2012,2,1,4,13,0,6,0,2,0.4,0.4091,0.37,0,120,269,389,269
11482,4/28/2012,2,1,4,14,0,6,0,1,0.42,0.4242,0.38,0.1045,147,293,440,293
11483,4/28/2012,2,1,4,15,0,6,0,1,0.42,0.4242,0.41,0.2239,148,260,408,260
11484,4/28/2012,2,1,4,16,0,6,0,2,0.44,0.4394,0.38,0.194,132,244,376,244
11485,4/28/2012,2,1,4,17,0,6,0,2,0.42,0.4242,0.41,0.1343,98,224,322,224
11486,4/28/2012,2,1,4,18,0,6,0,3,0.4,0.4091,0.47,0,17,73,90,73
11487,4/28/2012,2,1,4,19,0,6,0,3,0.36,0.3485,0.71,0.1343,29,110,139,110
11488,4/28/2012,2,1,4,20,0,6,0,2,0.38,0.3939,0.66,0,21,81,102,81
11489,4/28/2012,2,1,4,21,0,6,0,3,0.36,0.3485,0.71,0.194,12,72,84,72
11490,4/28/2012,2,1,4,22,0,6,0,2,0.36,0.3485,0.71,0.1343,17,66,83,66
11491,4/28/2012,2,1,4,23,0,6,0,2,0.38,0.3939,0.76,0.0896,5,37,42,37
11492,4/29/2012,2,1,4,0,0,0,0,3,0.36,0.3485,0.81,0.1343,0,36,36,36
11493,4/29/2012,2,1,4,1,0,0,0,2,0.36,0.3485,0.81,0.1343,5,37,42,37
11494,4/29/2012,2,1,4,2,0,0,0,2,0.36,0.3636,0.87,0.1045,4,36,40,36
11495,4/29/2012,2,1,4,3,0,0,0,2,0.36,0.3485,0.87,0.194,2,14,16,14
11496,4/29/2012,2,1,4,4,0,0,0,2,0.36,0.3485,0.87,0.1343,0,4,4,4
11497,4/29/2012,2,1,4,5,0,0,0,1,0.34,0.3636,0.87,0,0,6,6,6
11498,4/29/2012,2,1,4,6,0,0,0,1,0.34,0.3333,0.87,0.1343,1,6,7,6
11499,4/29/2012,2,1,4,7,0,0,0,2,0.34,0.3333,0.87,0.1343,7,20,27,20
11500,4/29/2012,2,1,4,8,0,0,0,1,0.38,0.3939,0.76,0.1343,26,81,107,81
11501,4/29/2012,2,1,4,9,0,0,0,1,0.4,0.4091,0.71,0.1343,52,133,185,133
11502,4/29/2012,2,1,4,10,0,0,0,1,0.42,0.4242,0.67,0.0896,127,253,380,253
11503,4/29/2012,2,1,4,11,0,0,0,1,0.46,0.4545,0.51,0,128,283,411,283
11504,4/29/2012,2,1,4,12,0,0,0,1,0.48,0.4697,0.44,0.1045,223,361,584,361
11505,4/29/2012,2,1,4,13,0,0,0,1,0.5,0.4848,0.45,0.1045,226,369,595,369
11506,4/29/2012,2,1,4,14,0,0,0,1,0.54,0.5152,0.34,0,281,372,653,372
11507,4/29/2012,2,1,4,15,0,0,0,1,0.56,0.5303,0.37,0.1343,279,324,603,324
11508,4/29/2012,2,1,4,16,0,0,0,1,0.6,0.6061,0.28,0.194,240,347,587,347
11509,4/29/2012,2,1,4,17,0,0,0,1,0.62,0.6061,0.27,0.2985,188,334,522,334
11510,4/29/2012,2,1,4,18,0,0,0,1,0.6,0.6061,0.26,0.2836,164,323,487,323
11511,4/29/2012,2,1,4,19,0,0,0,1,0.56,0.5303,0.35,0.1343,128,247,375,247
11512,4/29/2012,2,1,4,20,0,0,0,1,0.56,0.5303,0.32,0.0896,45,198,243,198
11513,4/29/2012,2,1,4,21,0,0,0,1,0.52,0.5,0.48,0.1343,65,139,204,139
11514,4/29/2012,2,1,4,22,0,0,0,1,0.5,0.4848,0.45,0,23,85,108,85
11515,4/29/2012,2,1,4,23,0,0,0,1,0.48,0.4697,0.59,0,15,67,82,67
11516,4/30/2012,2,1,4,0,0,1,1,1,0.44,0.4394,0.72,0.1045,12,36,48,36
11517,4/30/2012,2,1,4,1,0,1,1,1,0.42,0.4242,0.77,0.0896,9,15,24,15
11518,4/30/2012,2,1,4,2,0,1,1,1,0.42,0.4242,0.71,0.1343,3,5,8,5
11519,4/30/2012,2,1,4,3,0,1,1,1,0.4,0.4091,0.76,0.1642,0,4,4,4
11520,4/30/2012,2,1,4,4,0,1,1,1,0.38,0.3939,0.62,0.2537,0,2,2,2
11521,4/30/2012,2,1,4,5,0,1,1,1,0.38,0.3939,0.62,0.2537,1,19,20,19
11522,4/30/2012,2,1,4,6,0,1,1,1,0.4,0.4091,0.47,0.194,2,121,123,121
11523,4/30/2012,2,1,4,7,0,1,1,1,0.4,0.4091,0.5,0.194,6,343,349,343
11524,4/30/2012,2,1,4,8,0,1,1,1,0.4,0.4091,0.43,0.194,17,579,596,579
11525,4/30/2012,2,1,4,9,0,1,1,2,0.4,0.4091,0.43,0.194,29,239,268,239
11526,4/30/2012,2,1,4,10,0,1,1,2,0.42,0.4242,0.41,0.1642,41,116,157,116
11527,4/30/2012,2,1,4,11,0,1,1,2,0.44,0.4394,0.44,0.1045,52,111,163,111
11528,4/30/2012,2,1,4,12,0,1,1,2,0.44,0.4394,0.47,0.1343,45,180,225,180
11529,4/30/2012,2,1,4,13,0,1,1,2,0.48,0.4697,0.51,0.0896,48,199,247,199
11530,4/30/2012,2,1,4,14,0,1,1,2,0.5,0.4848,0.55,0.1343,56,162,218,162
11531,4/30/2012,2,1,4,15,0,1,1,2,0.52,0.5,0.55,0.1045,55,176,231,176
11532,4/30/2012,2,1,4,16,0,1,1,1,0.56,0.5303,0.6,0.194,44,303,347,303
11533,4/30/2012,2,1,4,17,0,1,1,1,0.56,0.5303,0.6,0.1642,66,617,683,617
11534,4/30/2012,2,1,4,18,0,1,1,2,0.56,0.5303,0.6,0.2239,53,611,664,611
11535,4/30/2012,2,1,4,19,0,1,1,2,0.54,0.5152,0.64,0.2537,51,420,471,420
11536,4/30/2012,2,1,4,20,0,1,1,2,0.52,0.5,0.59,0.194,28,281,309,281
11537,4/30/2012,2,1,4,21,0,1,1,2,0.52,0.5,0.59,0.194,26,195,221,195
11538,4/30/2012,2,1,4,22,0,1,1,2,0.52,0.5,0.55,0.1642,11,123,134,123
11539,4/30/2012,2,1,4,23,0,1,1,2,0.52,0.5,0.55,0.2239,10,50,60,50
11540,5/1/2012,2,1,5,0,0,2,1,2,0.5,0.4848,0.59,0.194,7,28,35,28
11541,5/1/2012,2,1,5,1,0,2,1,2,0.5,0.4848,0.63,0.1343,0,21,21,21
11542,5/1/2012,2,1,5,2,0,2,1,2,0.5,0.4848,0.72,0.0896,1,7,8,7
11543,5/1/2012,2,1,5,3,0,2,1,2,0.5,0.4848,0.77,0,1,2,3,2
11544,5/1/2012,2,1,5,4,0,2,1,2,0.52,0.5,0.72,0.0896,1,7,8,7
11545,5/1/2012,2,1,5,5,0,2,1,2,0.52,0.5,0.72,0.0896,0,17,17,17
11546,5/1/2012,2,1,5,6,0,2,1,3,0.52,0.5,0.77,0.1045,2,24,26,24
11547,5/1/2012,2,1,5,7,0,2,1,2,0.5,0.4848,0.94,0.2537,8,161,169,161
11548,5/1/2012,2,1,5,8,0,2,1,2,0.52,0.5,0.94,0.2836,19,538,557,538
11549,5/1/2012,2,1,5,9,0,2,1,2,0.54,0.5152,0.88,0.194,18,331,349,331
11550,5/1/2012,2,1,5,10,0,2,1,1,0.62,0.5909,0.78,0.2537,30,144,174,144
11551,5/1/2012,2,1,5,11,0,2,1,2,0.66,0.6212,0.65,0.2836,50,179,229,179
11552,5/1/2012,2,1,5,12,0,2,1,2,0.7,0.6515,0.58,0.2239,41,228,269,228
11553,5/1/2012,2,1,5,13,0,2,1,2,0.72,0.6667,0.51,0.2239,41,208,249,208
11554,5/1/2012,2,1,5,14,0,2,1,2,0.74,0.6667,0.48,0.2537,37,167,204,167
11555,5/1/2012,2,1,5,15,0,2,1,2,0.74,0.6667,0.45,0.2239,48,186,234,186
11556,5/1/2012,2,1,5,16,0,2,1,1,0.74,0.6667,0.45,0.194,41,313,354,313
11557,5/1/2012,2,1,5,17,0,2,1,1,0.74,0.6667,0.48,0.0896,65,616,681,616
11558,5/1/2012,2,1,5,18,0,2,1,1,0.7,0.6515,0.54,0.1343,81,662,743,662
11559,5/1/2012,2,1,5,19,0,2,1,1,0.7,0.6515,0.54,0.1343,58,429,487,429
11560,5/1/2012,2,1,5,20,0,2,1,1,0.66,0.6212,0.61,0.1642,36,299,335,299
11561,5/1/2012,2,1,5,21,0,2,1,1,0.64,0.6061,0.65,0.1343,31,251,282,251
11562,5/1/2012,2,1,5,22,0,2,1,1,0.64,0.6061,0.65,0,21,190,211,190
11563,5/1/2012,2,1,5,23,0,2,1,1,0.6,0.5758,0.78,0,16,79,95,79
11564,5/2/2012,2,1,5,0,0,3,1,1,0.6,0.5758,0.78,0.1045,4,43,47,43
11565,5/2/2012,2,1,5,1,0,3,1,1,0.56,0.5303,0.83,0,8,7,15,7
11566,5/2/2012,2,1,5,2,0,3,1,1,0.56,0.5303,0.83,0,7,9,16,9
11567,5/2/2012,2,1,5,3,0,3,1,1,0.56,0.5303,0.83,0.0896,0,6,6,6
11568,5/2/2012,2,1,5,4,0,3,1,1,0.54,0.5152,0.88,0,2,2,4,2
11569,5/2/2012,2,1,5,5,0,3,1,1,0.54,0.5152,0.9,0.1343,2,31,33,31
11570,5/2/2012,2,1,5,6,0,3,1,3,0.56,0.5303,0.84,0,3,117,120,117
11571,5/2/2012,2,1,5,7,0,3,1,2,0.54,0.5152,0.88,0.194,14,344,358,344
11572,5/2/2012,2,1,5,8,0,3,1,2,0.56,0.5303,0.88,0,26,640,666,640
11573,5/2/2012,2,1,5,9,0,3,1,2,0.56,0.5303,0.88,0,26,289,315,289
11574,5/2/2012,2,1,5,10,0,3,1,2,0.58,0.5455,0.83,0.1045,28,147,175,147
11575,5/2/2012,2,1,5,11,0,3,1,2,0.58,0.5455,0.81,0.1343,39,145,184,145
11576,5/2/2012,2,1,5,12,0,3,1,2,0.58,0.5455,0.83,0.2239,35,210,245,210
11577,5/2/2012,2,1,5,13,0,3,1,2,0.58,0.5455,0.78,0.194,49,179,228,179
11578,5/2/2012,2,1,5,14,0,3,1,1,0.62,0.6061,0.69,0.0896,51,189,240,189
11579,5/2/2012,2,1,5,15,0,3,1,1,0.64,0.6061,0.65,0.194,52,204,256,204
11580,5/2/2012,2,1,5,16,0,3,1,1,0.64,0.6061,0.65,0.1642,54,313,367,313
11581,5/2/2012,2,1,5,17,0,3,1,1,0.6,0.5909,0.73,0.2537,70,659,729,659
11582,5/2/2012,2,1,5,18,0,3,1,1,0.56,0.5303,0.73,0.2239,43,770,813,770
11583,5/2/2012,2,1,5,19,0,3,1,1,0.54,0.5152,0.77,0.2537,43,461,504,461
11584,5/2/2012,2,1,5,20,0,3,1,1,0.52,0.5,0.77,0.2537,42,296,338,296
11585,5/2/2012,2,1,5,21,0,3,1,1,0.52,0.5,0.77,0.2239,21,218,239,218
11586,5/2/2012,2,1,5,22,0,3,1,1,0.5,0.4848,0.82,0.2239,27,146,173,146
11587,5/2/2012,2,1,5,23,0,3,1,2,0.5,0.4848,0.77,0.2537,21,77,98,77
11588,5/3/2012,2,1,5,0,0,4,1,2,0.48,0.4697,0.82,0.2239,15,75,90,75
11589,5/3/2012,2,1,5,1,0,4,1,2,0.46,0.4545,0.88,0.1045,9,15,24,15
11590,5/3/2012,2,1,5,2,0,4,1,2,0.46,0.4545,0.88,0.1343,4,13,17,13
11591,5/3/2012,2,1,5,3,0,4,1,2,0.46,0.4545,0.88,0,2,4,6,4
11592,5/3/2012,2,1,5,4,0,4,1,2,0.46,0.4545,0.88,0.2537,0,2,2,2
11593,5/3/2012,2,1,5,5,0,4,1,2,0.46,0.4545,0.88,0.2537,1,20,21,20
11594,5/3/2012,2,1,5,6,0,4,1,2,0.46,0.4545,0.88,0.1642,8,128,136,128
11595,5/3/2012,2,1,5,7,0,4,1,3,0.44,0.4394,0.94,0.1045,8,376,384,376
11596,5/3/2012,2,1,5,8,0,4,1,3,0.46,0.4545,0.88,0.194,19,608,627,608
11597,5/3/2012,2,1,5,9,0,4,1,2,0.48,0.4697,0.88,0.1045,25,279,304,279
11598,5/3/2012,2,1,5,10,0,4,1,2,0.52,0.5,0.77,0,36,132,168,132
11599,5/3/2012,2,1,5,11,0,4,1,1,0.54,0.5152,0.77,0,34,167,201,167
11600,5/3/2012,2,1,5,12,0,4,1,1,0.56,0.5303,0.73,0.1343,64,237,301,237
11601,5/3/2012,2,1,5,13,0,4,1,1,0.6,0.5909,0.69,0.194,48,217,265,217
11602,5/3/2012,2,1,5,14,0,4,1,1,0.64,0.6061,0.65,0.194,33,171,204,171
11603,5/3/2012,2,1,5,15,0,4,1,1,0.66,0.6212,0.61,0.194,63,220,283,220
11604,5/3/2012,2,1,5,16,0,4,1,1,0.68,0.6364,0.57,0.1642,45,325,370,325
11605,5/3/2012,2,1,5,17,0,4,1,1,0.72,0.6667,0.54,0.1343,87,617,704,617
11606,5/3/2012,2,1,5,18,0,4,1,1,0.72,0.6667,0.58,0.1343,64,642,706,642
11607,5/3/2012,2,1,5,19,0,4,1,1,0.7,0.6515,0.61,0.194,55,467,522,467
11608,5/3/2012,2,1,5,20,0,4,1,1,0.64,0.6061,0.73,0.194,52,368,420,368
11609,5/3/2012,2,1,5,21,0,4,1,1,0.62,0.5909,0.78,0.1343,42,257,299,257
11610,5/3/2012,2,1,5,22,0,4,1,1,0.62,0.5909,0.78,0,29,217,246,217
11611,5/3/2012,2,1,5,23,0,4,1,1,0.6,0.5606,0.83,0,21,100,121,100
11612,5/4/2012,2,1,5,0,0,5,1,1,0.6,0.5758,0.78,0.3284,19,70,89,70
11613,5/4/2012,2,1,5,1,0,5,1,1,0.6,0.5758,0.78,0.1045,15,33,48,33
11614,5/4/2012,2,1,5,2,0,5,1,1,0.58,0.5455,0.83,0.1343,0,11,11,11
11615,5/4/2012,2,1,5,3,0,5,1,1,0.56,0.5303,0.88,0.2239,0,14,14,14
11616,5/4/2012,2,1,5,4,0,5,1,1,0.56,0.5303,0.88,0.194,0,4,4,4
11617,5/4/2012,2,1,5,5,0,5,1,1,0.56,0.5303,0.88,0.194,0,24,24,24
11618,5/4/2012,2,1,5,6,0,5,1,1,0.54,0.5152,0.94,0.1045,8,127,135,127
11619,5/4/2012,2,1,5,7,0,5,1,1,0.56,0.5303,0.88,0,9,347,356,347
11620,5/4/2012,2,1,5,8,0,5,1,1,0.56,0.5303,0.88,0,34,584,618,584
11621,5/4/2012,2,1,5,9,0,5,1,1,0.6,0.5758,0.78,0,32,262,294,262
11622,5/4/2012,2,1,5,10,0,5,1,2,0.62,0.5909,0.73,0.1343,45,154,199,154
11623,5/4/2012,2,1,5,11,0,5,1,2,0.7,0.6515,0.61,0,77,181,258,181
11624,5/4/2012,2,1,5,12,0,5,1,3,0.62,0.5909,0.78,0.3582,46,125,171,125
11625,5/4/2012,2,1,5,13,0,5,1,2,0.64,0.6061,0.73,0,71,207,278,207
11626,5/4/2012,2,1,5,14,0,5,1,2,0.66,0.6212,0.74,0.2836,83,159,242,159
11627,5/4/2012,2,1,5,15,0,5,1,2,0.72,0.6818,0.62,0.1045,103,240,343,240
11628,5/4/2012,2,1,5,16,0,5,1,1,0.76,0.6818,0.48,0.1642,82,358,440,358
11629,5/4/2012,2,1,5,17,0,5,1,1,0.7,0.6515,0.54,0.4627,96,547,643,547
11630,5/4/2012,2,1,5,18,0,5,1,1,0.7,0.6515,0.54,0.4627,77,564,641,564
11631,5/4/2012,2,1,5,19,0,5,1,1,0.7,0.6515,0.51,0.1343,64,388,452,388
11632,5/4/2012,2,1,5,20,0,5,1,1,0.68,0.6364,0.51,0.1045,58,255,313,255
11633,5/4/2012,2,1,5,21,0,5,1,1,0.64,0.6061,0.69,0.194,49,186,235,186
11634,5/4/2012,2,1,5,22,0,5,1,1,0.6,0.5606,0.83,0.1343,50,182,232,182
11635,5/4/2012,2,1,5,23,0,5,1,1,0.6,0.5606,0.83,0.0896,51,205,256,205
11636,5/5/2012,2,1,5,0,0,6,0,1,0.6,0.5606,0.83,0,42,111,153,111
11637,5/5/2012,2,1,5,1,0,6,0,1,0.6,0.5606,0.83,0,28,79,107,79
11638,5/5/2012,2,1,5,2,0,6,0,1,0.58,0.5455,0.88,0,24,51,75,51
11639,5/5/2012,2,1,5,3,0,6,0,1,0.58,0.5455,0.83,0,11,21,32,21
11640,5/5/2012,2,1,5,4,0,6,0,1,0.56,0.5303,0.88,0.1045,0,9,9,9
11641,5/5/2012,2,1,5,5,0,6,0,1,0.56,0.5303,0.88,0.0896,8,14,22,14
11642,5/5/2012,2,1,5,6,0,6,0,2,0.54,0.5152,0.94,0,9,33,42,33
11643,5/5/2012,2,1,5,7,0,6,0,1,0.56,0.5303,0.88,0,8,79,87,79
11644,5/5/2012,2,1,5,8,0,6,0,1,0.58,0.5455,0.83,0.0896,42,155,197,155
11645,5/5/2012,2,1,5,9,0,6,0,1,0.62,0.5909,0.78,0.1045,61,223,284,223
11646,5/5/2012,2,1,5,10,0,6,0,1,0.66,0.6212,0.65,0.1343,148,284,432,284
11647,5/5/2012,2,1,5,11,0,6,0,1,0.7,0.6515,0.58,0.0896,221,354,575,354
11648,5/5/2012,2,1,5,12,0,6,0,1,0.72,0.6667,0.58,0.1045,220,330,550,330
11649,5/5/2012,2,1,5,13,0,6,0,1,0.74,0.6818,0.55,0.1343,217,307,524,307
11650,5/5/2012,2,1,5,14,0,6,0,3,0.7,0.6515,0.61,0.2985,187,241,428,241
11651,5/5/2012,2,1,5,15,0,6,0,3,0.66,0.6212,0.74,0.194,241,300,541,300
11652,5/5/2012,2,1,5,16,0,6,0,2,0.68,0.6364,0.65,0.3881,230,310,540,310
11653,5/5/2012,2,1,5,17,0,6,0,2,0.68,0.6364,0.65,0.2985,204,298,502,298
11654,5/5/2012,2,1,5,18,0,6,0,2,0.66,0.6212,0.69,0.3582,156,278,434,278
11655,5/5/2012,2,1,5,19,0,6,0,2,0.62,0.5909,0.73,0.3284,151,254,405,254
11656,5/5/2012,2,1,5,20,0,6,0,1,0.6,0.5758,0.78,0.2537,100,209,309,209
11657,5/5/2012,2,1,5,21,0,6,0,2,0.58,0.5455,0.78,0.2239,86,183,269,183
11658,5/5/2012,2,1,5,22,0,6,0,2,0.58,0.5455,0.78,0.194,67,150,217,150
11659,5/5/2012,2,1,5,23,0,6,0,2,0.56,0.5303,0.83,0.2836,35,114,149,114
11660,5/6/2012,2,1,5,0,0,0,0,2,0.56,0.5303,0.83,0.1343,23,111,134,111
11661,5/6/2012,2,1,5,1,0,0,0,2,0.54,0.5152,0.83,0.2239,37,84,121,84
11662,5/6/2012,2,1,5,2,0,0,0,2,0.54,0.5152,0.83,0.2836,29,64,93,64
11663,5/6/2012,2,1,5,3,0,0,0,2,0.54,0.5152,0.83,0.194,9,19,28,19
11664,5/6/2012,2,1,5,4,0,0,0,3,0.52,0.5,0.83,0.1642,9,7,16,7
11665,5/6/2012,2,1,5,5,0,0,0,3,0.52,0.5,0.83,0.1642,1,10,11,10
11666,5/6/2012,2,1,5,6,0,0,0,3,0.52,0.5,0.83,0.2239,3,14,17,14
11667,5/6/2012,2,1,5,7,0,0,0,3,0.52,0.5,0.83,0.1642,5,31,36,31
11668,5/6/2012,2,1,5,8,0,0,0,2,0.5,0.4848,0.88,0.1343,23,91,114,91
11669,5/6/2012,2,1,5,9,0,0,0,2,0.52,0.5,0.83,0.1642,63,128,191,128
11670,5/6/2012,2,1,5,10,0,0,0,2,0.54,0.5152,0.77,0.1045,112,221,333,221
11671,5/6/2012,2,1,5,11,0,0,0,1,0.56,0.5303,0.73,0.1045,144,270,414,270
11672,5/6/2012,2,1,5,12,0,0,0,2,0.6,0.6061,0.64,0.0896,207,351,558,351
11673,5/6/2012,2,1,5,13,0,0,0,2,0.6,0.6061,0.64,0,197,368,565,368
11674,5/6/2012,2,1,5,14,0,0,0,2,0.6,0.6061,0.64,0.1045,226,292,518,292
11675,5/6/2012,2,1,5,15,0,0,0,2,0.62,0.6061,0.61,0.1045,229,342,571,342
11676,5/6/2012,2,1,5,16,0,0,0,2,0.62,0.6061,0.61,0,181,363,544,363
11677,5/6/2012,2,1,5,17,0,0,0,2,0.62,0.6061,0.65,0.1343,195,316,511,316
11678,5/6/2012,2,1,5,18,0,0,0,2,0.62,0.6061,0.61,0.194,131,332,463,332
11679,5/6/2012,2,1,5,19,0,0,0,2,0.6,0.6061,0.64,0.1642,117,266,383,266
11680,5/6/2012,2,1,5,20,0,0,0,1,0.6,0.6061,0.64,0.194,73,203,276,203
11681,5/6/2012,2,1,5,21,0,0,0,1,0.56,0.5303,0.73,0.194,55,148,203,148
11682,5/6/2012,2,1,5,22,0,0,0,1,0.56,0.5303,0.73,0.1642,44,113,157,113
11683,5/6/2012,2,1,5,23,0,0,0,1,0.52,0.5,0.77,0.194,22,80,102,80
11684,5/7/2012,2,1,5,0,0,1,1,2,0.52,0.5,0.77,0.1343,13,21,34,21
11685,5/7/2012,2,1,5,1,0,1,1,2,0.52,0.5,0.77,0.194,1,8,9,8
11686,5/7/2012,2,1,5,2,0,1,1,1,0.5,0.4848,0.77,0.194,1,5,6,5
11687,5/7/2012,2,1,5,3,0,1,1,1,0.5,0.4848,0.77,0.194,2,3,5,3
11688,5/7/2012,2,1,5,4,0,1,1,2,0.46,0.4545,0.88,0.1343,0,2,2,2
11689,5/7/2012,2,1,5,5,0,1,1,1,0.46,0.4545,0.88,0.1045,2,21,23,21
11690,5/7/2012,2,1,5,6,0,1,1,1,0.46,0.4545,0.88,0.1045,8,134,142,134
11691,5/7/2012,2,1,5,7,0,1,1,2,0.48,0.4697,0.82,0.1045,18,367,385,367
11692,5/7/2012,2,1,5,8,0,1,1,2,0.5,0.4848,0.82,0.194,31,608,639,608
11693,5/7/2012,2,1,5,9,0,1,1,2,0.5,0.4848,0.82,0.2239,61,289,350,289
11694,5/7/2012,2,1,5,10,0,1,1,2,0.52,0.5,0.77,0.194,62,128,190,128
11695,5/7/2012,2,1,5,11,0,1,1,2,0.54,0.5152,0.73,0.194,64,149,213,149
11696,5/7/2012,2,1,5,12,0,1,1,2,0.56,0.5303,0.68,0.2239,74,189,263,189
11697,5/7/2012,2,1,5,13,0,1,1,2,0.6,0.6212,0.53,0.3284,75,197,272,197
11698,5/7/2012,2,1,5,14,0,1,1,2,0.62,0.6212,0.5,0.3582,59,180,239,180
11699,5/7/2012,2,1,5,15,0,1,1,2,0.62,0.6212,0.53,0.2985,76,186,262,186
11700,5/7/2012,2,1,5,16,0,1,1,2,0.6,0.6212,0.53,0.3881,68,320,388,320
11701,5/7/2012,2,1,5,17,0,1,1,2,0.6,0.6212,0.53,0.3284,102,667,769,667
11702,5/7/2012,2,1,5,18,0,1,1,2,0.6,0.6212,0.53,0.3582,78,602,680,602
11703,5/7/2012,2,1,5,19,0,1,1,1,0.58,0.5455,0.56,0.3284,83,463,546,463
11704,5/7/2012,2,1,5,20,0,1,1,1,0.54,0.5152,0.52,0.2836,46,277,323,277
11705,5/7/2012,2,1,5,21,0,1,1,2,0.54,0.5152,0.45,0.2239,37,210,247,210
11706,5/7/2012,2,1,5,22,0,1,1,2,0.54,0.5152,0.45,0.2537,26,147,173,147
11707,5/7/2012,2,1,5,23,0,1,1,2,0.54,0.5152,0.45,0.194,21,92,113,92
11708,5/8/2012,2,1,5,0,0,2,1,2,0.52,0.5,0.52,0.2537,10,28,38,28
11709,5/8/2012,2,1,5,1,0,2,1,2,0.52,0.5,0.59,0.2239,6,3,9,3
11710,5/8/2012,2,1,5,2,0,2,1,2,0.52,0.5,0.63,0.2985,9,7,16,7
11711,5/8/2012,2,1,5,3,0,2,1,2,0.52,0.5,0.68,0.2836,2,4,6,4
11712,5/8/2012,2,1,5,4,0,2,1,2,0.52,0.5,0.68,0.3284,0,5,5,5
11713,5/8/2012,2,1,5,5,0,2,1,2,0.52,0.5,0.72,0.2836,0,20,20,20
11714,5/8/2012,2,1,5,6,0,2,1,1,0.5,0.4848,0.77,0.2985,7,158,165,158
11715,5/8/2012,2,1,5,7,0,2,1,1,0.52,0.5,0.72,0.2836,21,442,463,442
11716,5/8/2012,2,1,5,8,0,2,1,2,0.54,0.5152,0.73,0.2985,36,605,641,605
11717,5/8/2012,2,1,5,9,0,2,1,2,0.56,0.5303,0.68,0.3582,37,258,295,258
11718,5/8/2012,2,1,5,10,0,2,1,2,0.58,0.5455,0.68,0.4179,46,111,157,111
11719,5/8/2012,2,1,5,11,0,2,1,2,0.6,0.6061,0.64,0.3881,60,157,217,157
11720,5/8/2012,2,1,5,12,0,2,1,2,0.62,0.6061,0.65,0.3284,60,203,263,203
11721,5/8/2012,2,1,5,13,0,2,1,3,0.64,0.6061,0.65,0.2537,53,166,219,166
11722,5/8/2012,2,1,5,14,0,2,1,3,0.62,0.6061,0.69,0.3284,8,63,71,63
11723,5/8/2012,2,1,5,15,0,2,1,3,0.62,0.5909,0.73,0.2537,40,94,134,94
11724,5/8/2012,2,1,5,16,0,2,1,3,0.64,0.6061,0.73,0.2239,54,335,389,335
11725,5/8/2012,2,1,5,17,0,2,1,2,0.64,0.6061,0.69,0.2836,77,640,717,640
11726,5/8/2012,2,1,5,18,0,2,1,2,0.64,0.6061,0.69,0.2836,69,641,710,641
11727,5/8/2012,2,1,5,19,0,2,1,2,0.64,0.6061,0.69,0.2836,59,399,458,399
11728,5/8/2012,2,1,5,20,0,2,1,2,0.64,0.6061,0.69,0.2836,40,262,302,262
11729,5/8/2012,2,1,5,21,0,2,1,2,0.64,0.6061,0.65,0.2836,21,202,223,202
11730,5/8/2012,2,1,5,22,0,2,1,3,0.6,0.5758,0.78,0.2537,13,134,147,134
11731,5/8/2012,2,1,5,23,0,2,1,3,0.6,0.5758,0.78,0.3284,10,53,63,53
11732,5/9/2012,2,1,5,0,0,3,1,2,0.58,0.5455,0.83,0.194,8,27,35,27
11733,5/9/2012,2,1,5,1,0,3,1,2,0.6,0.5758,0.78,0.2537,3,11,14,11
11734,5/9/2012,2,1,5,2,0,3,1,3,0.56,0.5303,0.88,0.4478,0,1,1,1
11735,5/9/2012,2,1,5,3,0,3,1,3,0.56,0.5303,0.88,0.1642,0,2,2,2
11736,5/9/2012,2,1,5,4,0,3,1,3,0.56,0.5303,0.88,0.2239,0,5,5,5
11737,5/9/2012,2,1,5,5,0,3,1,2,0.56,0.5303,0.88,0.1343,1,27,28,27
11738,5/9/2012,2,1,5,6,0,3,1,2,0.56,0.5303,0.88,0.1045,5,121,126,121
11739,5/9/2012,2,1,5,7,0,3,1,2,0.56,0.5303,0.94,0.194,17,401,418,401
11740,5/9/2012,2,1,5,8,0,3,1,2,0.6,0.5606,0.83,0.1343,28,594,622,594
11741,5/9/2012,2,1,5,9,0,3,1,2,0.6,0.5606,0.83,0,40,285,325,285
11742,5/9/2012,2,1,5,10,0,3,1,2,0.62,0.6061,0.65,0.2537,40,113,153,113
11743,5/9/2012,2,1,5,11,0,3,1,2,0.62,0.6212,0.59,0.2985,45,156,201,156
11744,5/9/2012,2,1,5,12,0,3,1,2,0.62,0.6212,0.57,0.2239,58,222,280,222
11745,5/9/2012,2,1,5,13,0,3,1,2,0.64,0.6212,0.53,0.2537,50,216,266,216
11746,5/9/2012,2,1,5,14,0,3,1,2,0.64,0.6212,0.53,0.2537,68,175,243,175
11747,5/9/2012,2,1,5,15,0,3,1,2,0.64,0.6212,0.53,0.1045,68,191,259,191
11748,5/9/2012,2,1,5,16,0,3,1,2,0.66,0.6212,0.5,0.194,68,289,357,289
11749,5/9/2012,2,1,5,17,0,3,1,2,0.64,0.6212,0.53,0.1343,76,629,705,629
11750,5/9/2012,2,1,5,18,0,3,1,3,0.52,0.5,0.77,0.5821,23,349,372,349
11751,5/9/2012,2,1,5,19,0,3,1,3,0.5,0.4848,0.77,0.3582,2,96,98,96
11752,5/9/2012,2,1,5,20,0,3,1,3,0.5,0.4848,0.82,0.2239,3,48,51,48
11753,5/9/2012,2,1,5,21,0,3,1,3,0.5,0.4848,0.82,0.1642,4,30,34,30
11754,5/9/2012,2,1,5,22,0,3,1,3,0.48,0.4697,0.82,0.1045,5,62,67,62
11755,5/9/2012,2,1,5,23,0,3,1,3,0.48,0.4697,0.82,0.194,8,47,55,47
11756,5/10/2012,2,1,5,0,0,4,1,3,0.5,0.4848,0.77,0.1642,2,31,33,31
11757,5/10/2012,2,1,5,1,0,4,1,2,0.48,0.4697,0.88,0.1343,2,9,11,9
11758,5/10/2012,2,1,5,2,0,4,1,2,0.48,0.4697,0.88,0.1045,0,3,3,3
11759,5/10/2012,2,1,5,3,0,4,1,1,0.46,0.4545,0.88,0.2239,0,3,3,3
11760,5/10/2012,2,1,5,4,0,4,1,1,0.46,0.4545,0.77,0.194,0,2,2,2
11761,5/10/2012,2,1,5,5,0,4,1,1,0.46,0.4545,0.72,0.2985,1,23,24,23
11762,5/10/2012,2,1,5,6,0,4,1,1,0.44,0.4394,0.72,0.2239,9,130,139,130
11763,5/10/2012,2,1,5,7,0,4,1,1,0.44,0.4394,0.72,0.2985,8,393,401,393
11764,5/10/2012,2,1,5,8,0,4,1,1,0.46,0.4545,0.67,0.3582,27,603,630,603
11765,5/10/2012,2,1,5,9,0,4,1,1,0.5,0.4848,0.59,0.4627,62,299,361,299
11766,5/10/2012,2,1,5,10,0,4,1,1,0.5,0.4848,0.51,0.4179,42,112,154,112
11767,5/10/2012,2,1,5,11,0,4,1,1,0.52,0.5,0.48,0.5224,77,179,256,179
11768,5/10/2012,2,1,5,12,0,4,1,1,0.52,0.5,0.48,0.4179,65,207,272,207
11769,5/10/2012,2,1,5,13,0,4,1,1,0.54,0.5152,0.39,0.4478,90,228,318,228
11770,5/10/2012,2,1,5,14,0,4,1,1,0.56,0.5303,0.37,0.4179,61,186,247,186
11771,5/10/2012,2,1,5,15,0,4,1,1,0.54,0.5152,0.37,0.3881,79,192,271,192
11772,5/10/2012,2,1,5,16,0,4,1,1,0.58,0.5455,0.3,0.4627,87,334,421,334
11773,5/10/2012,2,1,5,17,0,4,1,1,0.6,0.6212,0.31,0.3881,84,648,732,648
11774,5/10/2012,2,1,5,18,0,4,1,1,0.56,0.5303,0.35,0.5224,109,661,770,661
11775,5/10/2012,2,1,5,19,0,4,1,1,0.54,0.5152,0.37,0.3582,84,469,553,469
11776,5/10/2012,2,1,5,20,0,4,1,1,0.52,0.5,0.4,0.3284,59,315,374,315
11777,5/10/2012,2,1,5,21,0,4,1,1,0.5,0.4848,0.42,0.194,19,211,230,211
11778,5/10/2012,2,1,5,22,0,4,1,1,0.5,0.4848,0.42,0.1045,36,196,232,196
11779,5/10/2012,2,1,5,23,0,4,1,1,0.48,0.4697,0.48,0.1045,23,112,135,112
11780,5/11/2012,2,1,5,0,0,5,1,1,0.46,0.4545,0.55,0.1045,17,47,64,47
11781,5/11/2012,2,1,5,1,0,5,1,1,0.46,0.4545,0.51,0.1343,14,32,46,32
11782,5/11/2012,2,1,5,2,0,5,1,1,0.46,0.4545,0.44,0.1642,15,16,31,16
11783,5/11/2012,2,1,5,3,0,5,1,1,0.46,0.4545,0.41,0.2836,5,8,13,8
11784,5/11/2012,2,1,5,4,0,5,1,1,0.42,0.4242,0.5,0.194,3,6,9,6
11785,5/11/2012,2,1,5,5,0,5,1,1,0.42,0.4242,0.47,0.1642,3,23,26,23
11786,5/11/2012,2,1,5,6,0,5,1,1,0.42,0.4242,0.5,0.2537,7,128,135,128
11787,5/11/2012,2,1,5,7,0,5,1,1,0.42,0.4242,0.5,0.2537,6,345,351,345
11788,5/11/2012,2,1,5,8,0,5,1,1,0.46,0.4545,0.44,0.2537,41,579,620,579
11789,5/11/2012,2,1,5,9,0,5,1,1,0.48,0.4697,0.41,0.2985,34,288,322,288
11790,5/11/2012,2,1,5,10,0,5,1,1,0.52,0.5,0.36,0.3284,69,141,210,141
11791,5/11/2012,2,1,5,11,0,5,1,1,0.56,0.5303,0.35,0.2537,88,203,291,203
11792,5/11/2012,2,1,5,12,0,5,1,1,0.56,0.5303,0.28,0.4179,89,259,348,259
11793,5/11/2012,2,1,5,13,0,5,1,1,0.6,0.6061,0.26,0.3881,100,263,363,263
11794,5/11/2012,2,1,5,14,0,5,1,1,0.62,0.6061,0.23,0.2239,116,218,334,218
11795,5/11/2012,2,1,5,15,0,5,1,1,0.62,0.6061,0.25,0.194,140,299,439,299
11796,5/11/2012,2,1,5,16,0,5,1,1,0.62,0.6061,0.25,0.3284,128,397,525,397
11797,5/11/2012,2,1,5,17,0,5,1,1,0.64,0.6061,0.23,0.2537,102,677,779,677
11798,5/11/2012,2,1,5,18,0,5,1,1,0.64,0.6061,0.23,0.2836,78,518,596,518
11799,5/11/2012,2,1,5,19,0,5,1,1,0.64,0.6061,0.23,0.2537,73,430,503,430
11800,5/11/2012,2,1,5,20,0,5,1,1,0.62,0.6061,0.25,0.1343,64,277,341,277
11801,5/11/2012,2,1,5,21,0,5,1,1,0.6,0.6061,0.28,0.1045,45,225,270,225
11802,5/11/2012,2,1,5,22,0,5,1,1,0.56,0.5303,0.35,0.2239,44,190,234,190
11803,5/11/2012,2,1,5,23,0,5,1,1,0.54,0.5152,0.37,0.194,38,142,180,142
11804,5/12/2012,2,1,5,0,0,6,0,1,0.52,0.5,0.42,0.1642,25,111,136,111
11805,5/12/2012,2,1,5,1,0,6,0,1,0.5,0.4848,0.48,0,14,79,93,79
11806,5/12/2012,2,1,5,2,0,6,0,1,0.46,0.4545,0.59,0.1343,10,46,56,46
11807,5/12/2012,2,1,5,3,0,6,0,1,0.48,0.4697,0.59,0,14,20,34,20
11808,5/12/2012,2,1,5,4,0,6,0,1,0.44,0.4394,0.67,0.1045,3,6,9,6
11809,5/12/2012,2,1,5,5,0,6,0,1,0.42,0.4242,0.67,0.1343,5,8,13,8
11810,5/12/2012,2,1,5,6,0,6,0,1,0.42,0.4242,0.67,0.0896,10,23,33,23
11811,5/12/2012,2,1,5,7,0,6,0,1,0.42,0.4242,0.71,0.1343,10,57,67,57
11812,5/12/2012,2,1,5,8,0,6,0,1,0.52,0.5,0.48,0,22,156,178,156
11813,5/12/2012,2,1,5,9,0,6,0,1,0.54,0.5152,0.49,0,87,248,335,248
11814,5/12/2012,2,1,5,10,0,6,0,1,0.56,0.5303,0.49,0.0896,132,279,411,279
11815,5/12/2012,2,1,5,11,0,6,0,1,0.62,0.6212,0.41,0.0896,157,365,522,365
11816,5/12/2012,2,1,5,12,0,6,0,1,0.64,0.6212,0.36,0.1642,206,353,559,353
11817,5/12/2012,2,1,5,13,0,6,0,1,0.64,0.6212,0.36,0.194,293,366,659,366
11818,5/12/2012,2,1,5,14,0,6,0,1,0.66,0.6212,0.36,0.194,257,358,615,358
11819,5/12/2012,2,1,5,15,0,6,0,1,0.68,0.6212,0.24,0.194,269,321,590,321
11820,5/12/2012,2,1,5,16,0,6,0,2,0.7,0.6364,0.21,0.194,254,337,591,337
11821,5/12/2012,2,1,5,17,0,6,0,2,0.66,0.6212,0.36,0.194,233,343,576,343
11822,5/12/2012,2,1,5,18,0,6,0,2,0.66,0.6212,0.31,0.194,164,382,546,382
11823,5/12/2012,2,1,5,19,0,6,0,2,0.64,0.6212,0.36,0.1642,166,273,439,273
11824,5/12/2012,2,1,5,20,0,6,0,1,0.62,0.6212,0.46,0.1642,113,174,287,174
11825,5/12/2012,2,1,5,21,0,6,0,2,0.6,0.6061,0.6,0.1343,74,156,230,156
11826,5/12/2012,2,1,5,22,0,6,0,1,0.56,0.5303,0.68,0.1343,62,212,274,212
11827,5/12/2012,2,1,5,23,0,6,0,1,0.58,0.5455,0.56,0.0896,42,134,176,134
11828,5/13/2012,2,1,5,0,0,0,0,1,0.56,0.5303,0.64,0.1642,19,79,98,79
11829,5/13/2012,2,1,5,1,0,0,0,2,0.54,0.5152,0.68,0.1343,22,72,94,72
11830,5/13/2012,2,1,5,2,0,0,0,2,0.54,0.5152,0.68,0.1642,22,60,82,60
11831,5/13/2012,2,1,5,3,0,0,0,2,0.54,0.5152,0.64,0.1343,2,26,28,26
11832,5/13/2012,2,1,5,4,0,0,0,2,0.54,0.5152,0.68,0.194,2,7,9,7
11833,5/13/2012,2,1,5,5,0,0,0,1,0.52,0.5,0.72,0.194,4,8,12,8
11834,5/13/2012,2,1,5,6,0,0,0,1,0.52,0.5,0.68,0.1642,6,15,21,15
11835,5/13/2012,2,1,5,7,0,0,0,1,0.52,0.5,0.68,0.1642,18,42,60,42
11836,5/13/2012,2,1,5,8,0,0,0,1,0.56,0.5303,0.64,0.1642,32,124,156,124
11837,5/13/2012,2,1,5,9,0,0,0,1,0.6,0.6212,0.56,0.1343,79,143,222,143
11838,5/13/2012,2,1,5,10,0,0,0,1,0.6,0.6061,0.6,0.2537,128,222,350,222
11839,5/13/2012,2,1,5,11,0,0,0,1,0.62,0.6212,0.57,0.2537,150,278,428,278
11840,5/13/2012,2,1,5,12,0,0,0,1,0.64,0.6212,0.57,0.2239,189,342,531,342
11841,5/13/2012,2,1,5,13,0,0,0,1,0.68,0.6364,0.54,0.2537,255,347,602,347
11842,5/13/2012,2,1,5,14,0,0,0,1,0.7,0.6515,0.48,0.1343,228,324,552,324
11843,5/13/2012,2,1,5,15,0,0,0,1,0.72,0.6515,0.45,0.3582,190,309,499,309
11844,5/13/2012,2,1,5,16,0,0,0,1,0.72,0.6515,0.42,0.2537,225,339,564,339
11845,5/13/2012,2,1,5,17,0,0,0,1,0.7,0.6364,0.45,0.4179,191,287,478,287
11846,5/13/2012,2,1,5,18,0,0,0,2,0.68,0.6364,0.44,0.3582,129,260,389,260
11847,5/13/2012,2,1,5,19,0,0,0,2,0.66,0.6212,0.5,0.4179,107,232,339,232
11848,5/13/2012,2,1,5,20,0,0,0,2,0.66,0.6212,0.5,0.2836,67,163,230,163
11849,5/13/2012,2,1,5,21,0,0,0,2,0.64,0.6212,0.53,0.194,48,121,169,121
11850,5/13/2012,2,1,5,22,0,0,0,2,0.62,0.6061,0.61,0.1642,42,89,131,89
11851,5/13/2012,2,1,5,23,0,0,0,2,0.62,0.6212,0.57,0.2239,17,57,74,57
11852,5/14/2012,2,1,5,0,0,1,1,2,0.6,0.6212,0.56,0.2537,21,14,35,14
11853,5/14/2012,2,1,5,1,0,1,1,2,0.6,0.6061,0.6,0.2836,5,6,11,6
11854,5/14/2012,2,1,5,2,0,1,1,1,0.6,0.6061,0.6,0.2985,1,1,2,1
11855,5/14/2012,2,1,5,3,0,1,1,2,0.58,0.5455,0.68,0.3284,0,2,2,2
11856,5/14/2012,2,1,5,4,0,1,1,2,0.54,0.5152,0.77,0.2239,3,3,6,3
11857,5/14/2012,2,1,5,5,0,1,1,2,0.54,0.5152,0.77,0.1642,1,25,26,25
11858,5/14/2012,2,1,5,6,0,1,1,3,0.52,0.5,0.94,0.2985,3,62,65,62
11859,5/14/2012,2,1,5,7,0,1,1,3,0.52,0.5,0.94,0.194,3,72,75,72
11860,5/14/2012,2,1,5,8,0,1,1,3,0.54,0.5152,0.88,0.2239,1,155,156,155
11861,5/14/2012,2,1,5,9,0,1,1,3,0.54,0.5152,0.88,0.2836,5,105,110,105
11862,5/14/2012,2,1,5,10,0,1,1,3,0.54,0.5152,0.88,0.2537,6,53,59,53
11863,5/14/2012,2,1,5,11,0,1,1,2,0.56,0.5303,0.83,0.2239,12,67,79,67
11864,5/14/2012,2,1,5,12,0,1,1,2,0.56,0.5303,0.88,0.2836,53,132,185,132
11865,5/14/2012,2,1,5,13,0,1,1,2,0.62,0.5909,0.73,0.2239,33,143,176,143
11866,5/14/2012,2,1,5,14,0,1,1,2,0.62,0.5909,0.73,0.2537,43,128,171,128
11867,5/14/2012,2,1,5,15,0,1,1,2,0.62,0.5909,0.73,0.1642,40,156,196,156
11868,5/14/2012,2,1,5,16,0,1,1,3,0.62,0.6061,0.69,0.2836,20,91,111,91
11869,5/14/2012,2,1,5,17,0,1,1,3,0.56,0.5303,0.88,0.2537,25,204,229,204
11870,5/14/2012,2,1,5,18,0,1,1,2,0.58,0.5455,0.83,0,17,283,300,283
11871,5/14/2012,2,1,5,19,0,1,1,3,0.58,0.5455,0.88,0.1343,10,294,304,294
11872,5/14/2012,2,1,5,20,0,1,1,2,0.58,0.5455,0.88,0.194,11,178,189,178
11873,5/14/2012,2,1,5,21,0,1,1,2,0.58,0.5455,0.83,0.0896,7,145,152,145
11874,5/14/2012,2,1,5,22,0,1,1,2,0.58,0.5455,0.78,0.0896,11,118,129,118
11875,5/14/2012,2,1,5,23,0,1,1,2,0.58,0.5455,0.78,0.1045,11,64,75,64
11876,5/15/2012,2,1,5,0,0,2,1,2,0.56,0.5303,0.88,0.1343,7,25,32,25
11877,5/15/2012,2,1,5,1,0,2,1,3,0.56,0.5303,0.88,0.1343,5,14,19,14
11878,5/15/2012,2,1,5,2,0,2,1,2,0.56,0.5303,0.88,0.1343,1,3,4,3
11879,5/15/2012,2,1,5,3,0,2,1,3,0.58,0.5455,0.83,0.1343,1,5,6,5
11880,5/15/2012,2,1,5,4,0,2,1,3,0.56,0.5303,0.94,0,1,4,5,4
11881,5/15/2012,2,1,5,5,0,2,1,3,0.56,0.5303,0.94,0.2239,0,8,8,8
11882,5/15/2012,2,1,5,6,0,2,1,3,0.56,0.5303,0.94,0.2239,2,22,24,22
11883,5/15/2012,2,1,5,7,0,2,1,3,0.56,0.5303,0.94,0.1343,1,91,92,91
11884,5/15/2012,2,1,5,8,0,2,1,2,0.58,0.5455,0.88,0.0896,8,401,409,401
11885,5/15/2012,2,1,5,9,0,2,1,2,0.58,0.5455,0.88,0.0896,28,327,355,327
11886,5/15/2012,2,1,5,10,0,2,1,1,0.62,0.5909,0.78,0.1045,27,144,171,144
11887,5/15/2012,2,1,5,11,0,2,1,1,0.64,0.5909,0.78,0.194,38,186,224,186
11888,5/15/2012,2,1,5,12,0,2,1,1,0.64,0.6061,0.73,0.194,44,220,264,220
11889,5/15/2012,2,1,5,13,0,2,1,3,0.64,0.6061,0.73,0.194,35,204,239,204
11890,5/15/2012,2,1,5,14,0,2,1,2,0.64,0.6061,0.73,0.194,39,145,184,145
11891,5/15/2012,2,1,5,15,0,2,1,2,0.7,0.6515,0.61,0.0896,51,205,256,205
11892,5/15/2012,2,1,5,16,0,2,1,1,0.68,0.6364,0.65,0.1642,74,300,374,300
11893,5/15/2012,2,1,5,17,0,2,1,1,0.68,0.6364,0.65,0.1045,75,603,678,603
11894,5/15/2012,2,1,5,18,0,2,1,1,0.7,0.6515,0.61,0.0896,68,665,733,665
11895,5/15/2012,2,1,5,19,0,2,1,1,0.66,0.6212,0.69,0.1642,57,455,512,455
11896,5/15/2012,2,1,5,20,0,2,1,3,0.64,0.6061,0.73,0.1343,30,233,263,233
11897,5/15/2012,2,1,5,21,0,2,1,3,0.64,0.6061,0.73,0.2836,11,98,109,98
11898,5/15/2012,2,1,5,22,0,2,1,1,0.58,0.5455,0.78,0.2239,9,74,83,74
11899,5/15/2012,2,1,5,23,0,2,1,3,0.56,0.5303,0.88,0.1045,13,58,71,58
11900,5/16/2012,2,1,5,0,0,3,1,2,0.58,0.5455,0.88,0,12,27,39,27
11901,5/16/2012,2,1,5,1,0,3,1,2,0.58,0.5455,0.88,0.1343,7,14,21,14
11902,5/16/2012,2,1,5,2,0,3,1,1,0.56,0.5303,0.94,0.194,5,14,19,14
11903,5/16/2012,2,1,5,3,0,3,1,1,0.56,0.5303,0.88,0.1045,1,5,6,5
11904,5/16/2012,2,1,5,4,0,3,1,1,0.54,0.5152,0.94,0.1343,1,3,4,3
11905,5/16/2012,2,1,5,5,0,3,1,1,0.54,0.5152,0.94,0.1045,4,34,38,34
11906,5/16/2012,2,1,5,6,0,3,1,1,0.54,0.5152,0.94,0.0896,8,150,158,150
11907,5/16/2012,2,1,5,7,0,3,1,1,0.56,0.5303,0.83,0,14,426,440,426
11908,5/16/2012,2,1,5,8,0,3,1,1,0.58,0.5455,0.83,0,33,617,650,617
11909,5/16/2012,2,1,5,9,0,3,1,2,0.6,0.5758,0.78,0.1343,33,314,347,314
11910,5/16/2012,2,1,5,10,0,3,1,1,0.66,0.6212,0.61,0,43,149,192,149
11911,5/16/2012,2,1,5,11,0,3,1,1,0.7,0.6515,0.54,0.1343,55,212,267,212
11912,5/16/2012,2,1,5,12,0,3,1,1,0.7,0.6515,0.54,0.194,59,271,330,271
11913,5/16/2012,2,1,5,13,0,3,1,1,0.72,0.6515,0.42,0,77,273,350,273
11914,5/16/2012,2,1,5,14,0,3,1,1,0.72,0.6515,0.42,0.0896,42,221,263,221
11915,5/16/2012,2,1,5,15,0,3,1,2,0.72,0.6667,0.48,0.1045,52,222,274,222
11916,5/16/2012,2,1,5,16,0,3,1,1,0.72,0.6515,0.45,0.1045,70,376,446,376
11917,5/16/2012,2,1,5,17,0,3,1,1,0.72,0.6667,0.51,0.194,104,769,873,769
11918,5/16/2012,2,1,5,18,0,3,1,1,0.72,0.6667,0.51,0.2239,97,749,846,749
11919,5/16/2012,2,1,5,19,0,3,1,1,0.7,0.6515,0.54,0.2836,91,499,590,499
11920,5/16/2012,2,1,5,20,0,3,1,1,0.66,0.6212,0.65,0.2537,61,398,459,398
11921,5/16/2012,2,1,5,21,0,3,1,1,0.64,0.6061,0.73,0.194,63,330,393,330
11922,5/16/2012,2,1,5,22,0,3,1,1,0.64,0.6061,0.73,0.1642,33,253,286,253
11923,5/16/2012,2,1,5,23,0,3,1,1,0.62,0.5909,0.78,0.1045,26,107,133,107
11924,5/17/2012,2,1,5,0,0,4,1,1,0.6,0.5758,0.78,0.1343,30,49,79,49
11925,5/17/2012,2,1,5,1,0,4,1,1,0.6,0.5606,0.83,0.1642,12,16,28,16
11926,5/17/2012,2,1,5,2,0,4,1,1,0.6,0.5758,0.78,0.1642,8,8,16,8
11927,5/17/2012,2,1,5,3,0,4,1,1,0.6,0.5909,0.73,0.2537,0,3,3,3
11928,5/17/2012,2,1,5,4,0,4,1,1,0.6,0.6061,0.64,0.3284,3,13,16,13
11929,5/17/2012,2,1,5,5,0,4,1,1,0.56,0.5303,0.68,0.3284,1,34,35,34
11930,5/17/2012,2,1,5,6,0,4,1,1,0.54,0.5152,0.73,0.3582,10,149,159,149
11931,5/17/2012,2,1,5,7,0,4,1,1,0.54,0.5152,0.73,0.3881,25,449,474,449
11932,5/17/2012,2,1,5,8,0,4,1,1,0.52,0.5,0.55,0.4478,29,605,634,605
11933,5/17/2012,2,1,5,9,0,4,1,1,0.54,0.5152,0.52,0.4179,57,289,346,289
11934,5/17/2012,2,1,5,10,0,4,1,1,0.56,0.5303,0.52,0.2537,43,162,205,162
11935,5/17/2012,2,1,5,11,0,4,1,1,0.58,0.5455,0.49,0.2239,77,202,279,202
11936,5/17/2012,2,1,5,12,0,4,1,1,0.6,0.6212,0.43,0.194,72,276,348,276
11937,5/17/2012,2,1,5,13,0,4,1,1,0.62,0.6212,0.41,0.194,86,241,327,241
11938,5/17/2012,2,1,5,14,0,4,1,1,0.64,0.6212,0.38,0.194,68,202,270,202
11939,5/17/2012,2,1,5,15,0,4,1,1,0.64,0.6212,0.36,0.2537,83,233,316,233
11940,5/17/2012,2,1,5,16,0,4,1,1,0.66,0.6212,0.31,0.194,86,344,430,344
11941,5/17/2012,2,1,5,17,0,4,1,1,0.66,0.6212,0.31,0.1343,133,719,852,719
11942,5/17/2012,2,1,5,18,0,4,1,1,0.66,0.6212,0.27,0.1642,134,734,868,734
11943,5/17/2012,2,1,5,19,0,4,1,1,0.64,0.6212,0.31,0.194,86,451,537,451
11944,5/17/2012,2,1,5,20,0,4,1,1,0.6,0.6212,0.4,0.194,83,363,446,363
11945,5/17/2012,2,1,5,21,0,4,1,1,0.58,0.5455,0.4,0.1045,45,254,299,254
11946,5/17/2012,2,1,5,22,0,4,1,1,0.56,0.5303,0.43,0.0896,42,209,251,209
11947,5/17/2012,2,1,5,23,0,4,1,1,0.54,0.5152,0.49,0.1343,29,137,166,137
11948,5/18/2012,2,1,5,0,0,5,1,1,0.52,0.5,0.59,0.1045,13,57,70,57
11949,5/18/2012,2,1,5,1,0,5,1,1,0.5,0.4848,0.59,0.0896,16,33,49,33
11950,5/18/2012,2,1,5,2,0,5,1,1,0.48,0.4697,0.67,0.1343,12,9,21,9
11951,5/18/2012,2,1,5,3,0,5,1,1,0.46,0.4545,0.72,0.0896,6,8,14,8
11952,5/18/2012,2,1,5,4,0,5,1,1,0.46,0.4545,0.77,0.1642,0,11,11,11
11953,5/18/2012,2,1,5,5,0,5,1,1,0.46,0.4545,0.77,0.1045,1,33,34,33
11954,5/18/2012,2,1,5,6,0,5,1,1,0.44,0.4394,0.77,0.1343,14,168,182,168
11955,5/18/2012,2,1,5,7,0,5,1,1,0.46,0.4545,0.82,0.1045,40,475,515,475
11956,5/18/2012,2,1,5,8,0,5,1,1,0.52,0.5,0.59,0.1343,49,696,745,696
11957,5/18/2012,2,1,5,9,0,5,1,1,0.56,0.5303,0.56,0.1045,57,304,361,304
11958,5/18/2012,2,1,5,10,0,5,1,1,0.6,0.6212,0.46,0.1343,74,181,255,181
11959,5/18/2012,2,1,5,11,0,5,1,1,0.62,0.6212,0.43,0,109,225,334,225
11960,5/18/2012,2,1,5,12,0,5,1,1,0.62,0.6212,0.41,0.194,108,252,360,252
11961,5/18/2012,2,1,5,13,0,5,1,1,0.64,0.6212,0.36,0.1642,98,297,395,297
11962,5/18/2012,2,1,5,14,0,5,1,1,0.66,0.6212,0.34,0.1343,108,242,350,242
11963,5/18/2012,2,1,5,15,0,5,1,1,0.66,0.6212,0.36,0.194,131,260,391,260
11964,5/18/2012,2,1,5,16,0,5,1,1,0.66,0.6212,0.34,0.2537,151,417,568,417
11965,5/18/2012,2,1,5,17,0,5,1,1,0.66,0.6212,0.34,0.1343,124,688,812,688
11966,5/18/2012,2,1,5,18,0,5,1,1,0.64,0.6212,0.38,0.2239,99,570,669,570
11967,5/18/2012,2,1,5,19,0,5,1,1,0.62,0.6212,0.41,0.194,91,392,483,392
11968,5/18/2012,2,1,5,20,0,5,1,1,0.62,0.6212,0.41,0.1642,73,264,337,264
11969,5/18/2012,2,1,5,21,0,5,1,1,0.6,0.6212,0.4,0,49,209,258,209
11970,5/18/2012,2,1,5,22,0,5,1,1,0.56,0.5303,0.52,0.3284,57,194,251,194
11971,5/18/2012,2,1,5,23,0,5,1,1,0.52,0.5,0.55,0,41,133,174,133
11972,5/19/2012,2,1,5,0,0,6,0,1,0.52,0.5,0.48,0.1045,30,118,148,118
11973,5/19/2012,2,1,5,1,0,6,0,1,0.5,0.4848,0.48,0,20,84,104,84
11974,5/19/2012,2,1,5,2,0,6,0,1,0.5,0.4848,0.51,0.1045,13,56,69,56
11975,5/19/2012,2,1,5,3,0,6,0,1,0.5,0.4848,0.48,0.1045,10,23,33,23
11976,5/19/2012,2,1,5,4,0,6,0,1,0.48,0.4697,0.59,0.0896,6,8,14,8
11977,5/19/2012,2,1,5,5,0,6,0,1,0.46,0.4545,0.67,0,1,11,12,11
11978,5/19/2012,2,1,5,6,0,6,0,1,0.44,0.4394,0.72,0.0896,12,38,50,38
11979,5/19/2012,2,1,5,7,0,6,0,1,0.46,0.4545,0.67,0.1045,28,67,95,67
11980,5/19/2012,2,1,5,8,0,6,0,1,0.52,0.5,0.52,0.1642,33,162,195,162
11981,5/19/2012,2,1,5,9,0,6,0,1,0.56,0.5303,0.43,0.1642,79,213,292,213
11982,5/19/2012,2,1,5,10,0,6,0,1,0.56,0.5303,0.43,0,177,275,452,275
11983,5/19/2012,2,1,5,11,0,6,0,1,0.62,0.6212,0.38,0.0896,235,351,586,351
11984,5/19/2012,2,1,5,12,0,6,0,1,0.66,0.6212,0.36,0,276,366,642,366
11985,5/19/2012,2,1,5,13,0,6,0,1,0.7,0.6364,0.37,0.1343,332,372,704,372
11986,5/19/2012,2,1,5,14,0,6,0,1,0.72,0.6515,0.3,0.0896,361,369,730,369
11987,5/19/2012,2,1,5,15,0,6,0,1,0.72,0.6515,0.3,0.1045,356,316,672,316
11988,5/19/2012,2,1,5,16,0,6,0,1,0.74,0.6515,0.3,0.1045,331,311,642,311
11989,5/19/2012,2,1,5,17,0,6,0,1,0.74,0.6515,0.3,0.0896,279,347,626,347
11990,5/19/2012,2,1,5,18,0,6,0,1,0.74,0.6515,0.33,0.0896,254,391,645,391
11991,5/19/2012,2,1,5,19,0,6,0,1,0.7,0.6364,0.39,0.1343,203,229,432,229
11992,5/19/2012,2,1,5,20,0,6,0,1,0.68,0.6364,0.41,0.0896,118,197,315,197
11993,5/19/2012,2,1,5,21,0,6,0,1,0.64,0.6212,0.5,0,81,178,259,178
11994,5/19/2012,2,1,5,22,0,6,0,1,0.64,0.6212,0.47,0,104,234,338,234
11995,5/19/2012,2,1,5,23,0,6,0,1,0.6,0.6212,0.56,0.1642,71,168,239,168
11996,5/20/2012,2,1,5,0,0,0,0,1,0.58,0.5455,0.53,0.1045,42,128,170,128
11997,5/20/2012,2,1,5,1,0,0,0,1,0.56,0.5303,0.52,0,28,102,130,102
11998,5/20/2012,2,1,5,2,0,0,0,1,0.56,0.5303,0.52,0,36,62,98,62
11999,5/20/2012,2,1,5,3,0,0,0,1,0.54,0.5152,0.56,0.0896,26,40,66,40
12000,5/20/2012,2,1,5,4,0,0,0,1,0.52,0.5,0.68,0.0896,2,14,16,14
12001,5/20/2012,2,1,5,5,0,0,0,1,0.5,0.4848,0.72,0.1045,1,7,8,7
12002,5/20/2012,2,1,5,6,0,0,0,1,0.5,0.4848,0.63,0.1343,4,21,25,21
12003,5/20/2012,2,1,5,7,0,0,0,1,0.52,0.5,0.68,0.194,35,55,90,55
12004,5/20/2012,2,1,5,8,0,0,0,1,0.56,0.5303,0.56,0.1642,51,120,171,120
12005,5/20/2012,2,1,5,9,0,0,0,1,0.62,0.6212,0.32,0.2537,129,184,313,184
12006,5/20/2012,2,1,5,10,0,0,0,1,0.66,0.6212,0.34,0.2985,174,258,432,258
12007,5/20/2012,2,1,5,11,0,0,0,1,0.66,0.6212,0.36,0.3284,258,323,581,323
12008,5/20/2012,2,1,5,12,0,0,0,1,0.68,0.6364,0.36,0.3284,247,390,637,390
12009,5/20/2012,2,1,5,13,0,0,0,1,0.7,0.6364,0.37,0.2836,244,363,607,363
12010,5/20/2012,2,1,5,14,0,0,0,1,0.72,0.6515,0.39,0.3881,236,307,543,307
12011,5/20/2012,2,1,5,15,0,0,0,2,0.7,0.6364,0.39,0.4179,246,256,502,256
12012,5/20/2012,2,1,5,16,0,0,0,1,0.72,0.6515,0.42,0.3582,238,339,577,339
12013,5/20/2012,2,1,5,17,0,0,0,1,0.72,0.6515,0.45,0.3284,209,340,549,340
12014,5/20/2012,2,1,5,18,0,0,0,1,0.7,0.6515,0.51,0.3284,146,328,474,328
12015,5/20/2012,2,1,5,19,0,0,0,1,0.66,0.6212,0.61,0.4179,142,260,402,260
12016,5/20/2012,2,1,5,20,0,0,0,1,0.66,0.6212,0.61,0.4179,83,191,274,191
12017,5/20/2012,2,1,5,21,0,0,0,1,0.64,0.6061,0.69,0.3881,51,182,233,182
12018,5/20/2012,2,1,5,22,0,0,0,1,0.62,0.5909,0.73,0.3284,44,101,145,101
12019,5/20/2012,2,1,5,23,0,0,0,3,0.6,0.5758,0.78,0.3582,32,54,86,54
12020,5/21/2012,2,1,5,0,0,1,1,3,0.58,0.5455,0.88,0.2985,12,28,40,28
12021,5/21/2012,2,1,5,1,0,1,1,3,0.58,0.5455,0.88,0.3582,4,11,15,11
12022,5/21/2012,2,1,5,2,0,1,1,3,0.56,0.5303,0.94,0.2537,2,9,11,9
12023,5/21/2012,2,1,5,3,0,1,1,2,0.56,0.5303,0.88,0.2985,0,2,2,2
12024,5/21/2012,2,1,5,4,0,1,1,3,0.56,0.5303,0.88,0.2985,2,5,7,5
12025,5/21/2012,2,1,5,5,0,1,1,3,0.56,0.5303,0.88,0.2985,1,14,15,14
12026,5/21/2012,2,1,5,6,0,1,1,3,0.56,0.5303,0.88,0.2985,3,76,79,76
12027,5/21/2012,2,1,5,7,0,1,1,3,0.56,0.5303,0.88,0.2985,7,146,153,146
12028,5/21/2012,2,1,5,8,0,1,1,3,0.56,0.5303,0.88,0.2537,12,258,270,258
12029,5/21/2012,2,1,5,9,0,1,1,3,0.56,0.5303,0.88,0.2239,14,172,186,172
12030,5/21/2012,2,1,5,10,0,1,1,3,0.58,0.5455,0.88,0.2836,28,71,99,71
12031,5/21/2012,2,1,5,11,0,1,1,2,0.6,0.5606,0.83,0.1642,24,82,106,82
12032,5/21/2012,2,1,5,12,0,1,1,2,0.6,0.5606,0.83,0.2537,46,124,170,124
12033,5/21/2012,2,1,5,13,0,1,1,3,0.6,0.5606,0.83,0.2537,49,135,184,135
12034,5/21/2012,2,1,5,14,0,1,1,3,0.6,0.5606,0.83,0.194,45,135,180,135
12035,5/21/2012,2,1,5,15,0,1,1,2,0.64,0.6061,0.73,0.194,67,158,225,158
12036,5/21/2012,2,1,5,16,0,1,1,2,0.64,0.6061,0.73,0.2537,46,269,315,269
12037,5/21/2012,2,1,5,17,0,1,1,2,0.66,0.6212,0.69,0.2537,40,468,508,468
12038,5/21/2012,2,1,5,18,0,1,1,1,0.64,0.6061,0.73,0.1045,52,478,530,478
12039,5/21/2012,2,1,5,19,0,1,1,1,0.66,0.6212,0.69,0.0896,57,391,448,391
12040,5/21/2012,2,1,5,20,0,1,1,1,0.64,0.6061,0.69,0.1343,44,292,336,292
12041,5/21/2012,2,1,5,21,0,1,1,1,0.62,0.6061,0.69,0.0896,31,210,241,210
12042,5/21/2012,2,1,5,22,0,1,1,2,0.62,0.5909,0.73,0.1642,26,116,142,116
12043,5/21/2012,2,1,5,23,0,1,1,1,0.62,0.5909,0.73,0.2836,18,79,97,79
12044,5/22/2012,2,1,5,0,0,2,1,1,0.58,0.5455,0.83,0.2537,10,26,36,26
12045,5/22/2012,2,1,5,1,0,2,1,2,0.58,0.5455,0.83,0.1343,11,16,27,16
12046,5/22/2012,2,1,5,2,0,2,1,2,0.58,0.5455,0.83,0.1045,1,10,11,10
12047,5/22/2012,2,1,5,3,0,2,1,2,0.58,0.5455,0.83,0.1045,0,5,5,5
12048,5/22/2012,2,1,5,4,0,2,1,2,0.56,0.5303,0.88,0.1642,0,7,7,7
12049,5/22/2012,2,1,5,5,0,2,1,3,0.56,0.5303,0.88,0.194,0,17,17,17
12050,5/22/2012,2,1,5,6,0,2,1,3,0.56,0.5303,0.88,0.1045,8,129,137,129
12051,5/22/2012,2,1,5,7,0,2,1,3,0.56,0.5303,0.88,0.1045,9,315,324,315
12052,5/22/2012,2,1,5,8,0,2,1,2,0.56,0.5303,0.88,0.1343,20,570,590,570
12053,5/22/2012,2,1,5,9,0,2,1,2,0.6,0.5606,0.83,0.1045,46,287,333,287
12054,5/22/2012,2,1,5,10,0,2,1,2,0.6,0.5758,0.78,0.0896,52,148,200,148
12055,5/22/2012,2,1,5,11,0,2,1,2,0.6,0.5758,0.78,0,39,150,189,150
12056,5/22/2012,2,1,5,12,0,2,1,2,0.62,0.5909,0.78,0.1045,76,178,254,178
12057,5/22/2012,2,1,5,13,0,2,1,2,0.64,0.6061,0.73,0,48,195,243,195
12058,5/22/2012,2,1,5,14,0,2,1,2,0.64,0.6061,0.73,0.1045,73,149,222,149
12059,5/22/2012,2,1,5,15,0,2,1,1,0.7,0.6515,0.61,0.0896,54,191,245,191
12060,5/22/2012,2,1,5,16,0,2,1,1,0.68,0.6364,0.61,0.1045,70,316,386,316
12061,5/22/2012,2,1,5,17,0,2,1,1,0.72,0.6667,0.54,0,69,716,785,716
12062,5/22/2012,2,1,5,18,0,2,1,1,0.68,0.6364,0.61,0.1343,76,709,785,709
12063,5/22/2012,2,1,5,19,0,2,1,1,0.66,0.6212,0.69,0.2239,44,320,364,320
12064,5/22/2012,2,1,5,20,0,2,1,1,0.64,0.6061,0.73,0.2537,54,319,373,319
12065,5/22/2012,2,1,5,21,0,2,1,1,0.62,0.5909,0.78,0.1343,28,233,261,233
12066,5/22/2012,2,1,5,22,0,2,1,1,0.62,0.5909,0.73,0.0896,17,157,174,157
12067,5/22/2012,2,1,5,23,0,2,1,1,0.62,0.5909,0.73,0.1045,14,91,105,91
12068,5/23/2012,2,1,5,0,0,3,1,1,0.62,0.5909,0.78,0.1343,19,28,47,28
12069,5/23/2012,2,1,5,1,0,3,1,1,0.6,0.5606,0.83,0.1642,23,9,32,9
12070,5/23/2012,2,1,5,2,0,3,1,2,0.6,0.5606,0.83,0.1642,2,10,12,10
12071,5/23/2012,2,1,5,3,0,3,1,1,0.6,0.5758,0.78,0.1045,0,5,5,5
12072,5/23/2012,2,1,5,4,0,3,1,3,0.58,0.5455,0.83,0.194,0,3,3,3
12073,5/23/2012,2,1,5,5,0,3,1,3,0.56,0.5303,0.88,0.2537,6,29,35,29
12074,5/23/2012,2,1,5,6,0,3,1,1,0.56,0.5303,0.88,0.1045,6,154,160,154
12075,5/23/2012,2,1,5,7,0,3,1,1,0.58,0.5455,0.83,0,16,452,468,452
12076,5/23/2012,2,1,5,8,0,3,1,1,0.58,0.5455,0.83,0,38,681,719,681
12077,5/23/2012,2,1,5,9,0,3,1,2,0.62,0.5909,0.78,0,39,258,297,258
12078,5/23/2012,2,1,5,10,0,3,1,1,0.62,0.5909,0.78,0.0896,52,139,191,139
12079,5/23/2012,2,1,5,11,0,3,1,1,0.64,0.6061,0.73,0,46,151,197,151
12080,5/23/2012,2,1,5,12,0,3,1,2,0.66,0.6212,0.69,0.0896,42,206,248,206
12081,5/23/2012,2,1,5,13,0,3,1,2,0.66,0.6212,0.74,0.1642,69,201,270,201
12082,5/23/2012,2,1,5,14,0,3,1,1,0.68,0.6364,0.65,0.1343,67,181,248,181
12083,5/23/2012,2,1,5,15,0,3,1,2,0.7,0.6515,0.61,0,65,192,257,192
12084,5/23/2012,2,1,5,16,0,3,1,3,0.7,0.6515,0.61,0.0896,62,216,278,216
12085,5/23/2012,2,1,5,17,0,3,1,3,0.64,0.6061,0.69,0.1045,45,240,285,240
12086,5/23/2012,2,1,5,18,0,3,1,3,0.64,0.6061,0.69,0.1045,31,296,327,296
12087,5/23/2012,2,1,5,19,0,3,1,2,0.62,0.5758,0.83,0.1642,40,336,376,336
12088,5/23/2012,2,1,5,20,0,3,1,2,0.62,0.5758,0.83,0.0896,28,267,295,267
12089,5/23/2012,2,1,5,21,0,3,1,2,0.62,0.5758,0.83,0,24,221,245,221
12090,5/23/2012,2,1,5,22,0,3,1,2,0.62,0.5758,0.83,0.1642,23,136,159,136
12091,5/23/2012,2,1,5,23,0,3,1,1,0.6,0.5606,0.83,0.1343,23,83,106,83
12092,5/24/2012,2,1,5,0,0,4,1,1,0.6,0.5606,0.83,0.0896,7,49,56,49
12093,5/24/2012,2,1,5,1,0,4,1,1,0.6,0.5455,0.88,0.0896,9,21,30,21
12094,5/24/2012,2,1,5,2,0,4,1,1,0.6,0.5455,0.88,0,1,15,16,15
12095,5/24/2012,2,1,5,3,0,4,1,2,0.6,0.5455,0.88,0.1045,1,3,4,3
12096,5/24/2012,2,1,5,4,0,4,1,2,0.6,0.5455,0.88,0.1642,0,5,5,5
12097,5/24/2012,2,1,5,5,0,4,1,2,0.6,0.5455,0.88,0.1642,1,29,30,29
12098,5/24/2012,2,1,5,6,0,4,1,2,0.6,0.5455,0.88,0.1642,10,146,156,146
12099,5/24/2012,2,1,5,7,0,4,1,1,0.6,0.5606,0.83,0.1045,22,393,415,393
12100,5/24/2012,2,1,5,8,0,4,1,1,0.62,0.5909,0.73,0.1343,33,659,692,659
12101,5/24/2012,2,1,5,9,0,4,1,1,0.62,0.5909,0.73,0.1642,34,267,301,267
12102,5/24/2012,2,1,5,10,0,4,1,1,0.64,0.6061,0.65,0.1343,47,138,185,138
12103,5/24/2012,2,1,5,11,0,4,1,1,0.66,0.6212,0.65,0.1343,61,160,221,160
12104,5/24/2012,2,1,5,12,0,4,1,1,0.7,0.6515,0.58,0.1045,76,213,289,213
12105,5/24/2012,2,1,5,13,0,4,1,1,0.72,0.6667,0.54,0.1642,69,233,302,233
12106,5/24/2012,2,1,5,14,0,4,1,1,0.74,0.6818,0.55,0.2239,72,180,252,180
12107,5/24/2012,2,1,5,15,0,4,1,1,0.74,0.6818,0.55,0.2537,69,222,291,222
12108,5/24/2012,2,1,5,16,0,4,1,1,0.74,0.6818,0.55,0.3582,61,329,390,329
12109,5/24/2012,2,1,5,17,0,4,1,1,0.74,0.6818,0.55,0.2836,120,678,798,678
12110,5/24/2012,2,1,5,18,0,4,1,1,0.72,0.6667,0.54,0.3284,118,634,752,634
12111,5/24/2012,2,1,5,19,0,4,1,1,0.7,0.6515,0.61,0.2985,76,416,492,416
12112,5/24/2012,2,1,5,20,0,4,1,2,0.66,0.6212,0.69,0.2836,55,343,398,343
12113,5/24/2012,2,1,5,21,0,4,1,3,0.64,0.5909,0.78,0.1642,48,237,285,237
12114,5/24/2012,2,1,5,22,0,4,1,2,0.64,0.5909,0.78,0.1045,33,210,243,210
12115,5/24/2012,2,1,5,23,0,4,1,2,0.64,0.5909,0.78,0.1343,36,131,167,131
12116,5/25/2012,2,1,5,0,0,5,1,1,0.62,0.5758,0.83,0.1343,10,63,73,63
12117,5/25/2012,2,1,5,1,0,5,1,1,0.62,0.5758,0.83,0.0896,8,34,42,34
12118,5/25/2012,2,1,5,2,0,5,1,2,0.62,0.5758,0.83,0,7,16,23,16
12119,5/25/2012,2,1,5,3,0,5,1,2,0.62,0.5606,0.88,0.1045,8,6,14,6
12120,5/25/2012,2,1,5,4,0,5,1,2,0.62,0.5606,0.88,0,3,6,9,6
12121,5/25/2012,2,1,5,5,0,5,1,2,0.62,0.5606,0.88,0.0896,2,28,30,28
12122,5/25/2012,2,1,5,6,0,5,1,2,0.62,0.5606,0.88,0.1045,5,108,113,108
12123,5/25/2012,2,1,5,7,0,5,1,2,0.62,0.5606,0.88,0.1642,7,352,359,352
12124,5/25/2012,2,1,5,8,0,5,1,2,0.64,0.5758,0.89,0.1045,32,551,583,551
12125,5/25/2012,2,1,5,9,0,5,1,2,0.64,0.5758,0.89,0.1343,52,288,340,288
12126,5/25/2012,2,1,5,10,0,5,1,1,0.68,0.6364,0.79,0.1642,69,163,232,163
12127,5/25/2012,2,1,5,11,0,5,1,1,0.68,0.6364,0.79,0.1343,90,193,283,193
12128,5/25/2012,2,1,5,12,0,5,1,1,0.72,0.6818,0.66,0.1045,84,237,321,237
12129,5/25/2012,2,1,5,13,0,5,1,1,0.74,0.6818,0.62,0.1343,86,247,333,247
12130,5/25/2012,2,1,5,14,0,5,1,1,0.74,0.6818,0.58,0.1343,104,263,367,263
12131,5/25/2012,2,1,5,15,0,5,1,1,0.76,0.7121,0.62,0.194,106,360,466,360
12132,5/25/2012,2,1,5,16,0,5,1,1,0.78,0.7121,0.52,0.2239,137,447,584,447
12133,5/25/2012,2,1,5,17,0,5,1,1,0.76,0.7121,0.62,0.2836,124,529,653,529
12134,5/25/2012,2,1,5,18,0,5,1,1,0.76,0.7121,0.62,0.194,131,391,522,391
12135,5/25/2012,2,1,5,19,0,5,1,1,0.74,0.6818,0.62,0.2537,111,293,404,293
12136,5/25/2012,2,1,5,20,0,5,1,1,0.7,0.6515,0.65,0.1642,80,270,350,270
12137,5/25/2012,2,1,5,21,0,5,1,1,0.7,0.6515,0.65,0.1343,62,193,255,193
12138,5/25/2012,2,1,5,22,0,5,1,1,0.66,0.6212,0.74,0.1045,65,147,212,147
12139,5/25/2012,2,1,5,23,0,5,1,1,0.66,0.6061,0.78,0.2239,34,132,166,132
12140,5/26/2012,2,1,5,0,0,6,0,1,0.64,0.5758,0.83,0.1642,18,98,116,98
12141,5/26/2012,2,1,5,1,0,6,0,1,0.64,0.5758,0.83,0.1343,18,64,82,64
12142,5/26/2012,2,1,5,2,0,6,0,1,0.64,0.5758,0.89,0.1343,9,55,64,55
12143,5/26/2012,2,1,5,3,0,6,0,1,0.62,0.5606,0.88,0.1045,9,22,31,22
12144,5/26/2012,2,1,5,4,0,6,0,1,0.62,0.5606,0.88,0.1343,0,2,2,2
12145,5/26/2012,2,1,5,5,0,6,0,1,0.62,0.5758,0.83,0.2537,0,10,10,10
12146,5/26/2012,2,1,5,6,0,6,0,1,0.62,0.5606,0.88,0.194,6,25,31,25
12147,5/26/2012,2,1,5,7,0,6,0,2,0.62,0.5606,0.88,0.1642,10,44,54,44
12148,5/26/2012,2,1,5,8,0,6,0,1,0.64,0.5909,0.78,0.1343,38,103,141,103
12149,5/26/2012,2,1,5,9,0,6,0,1,0.64,0.5758,0.83,0.194,97,192,289,192
12150,5/26/2012,2,1,5,10,0,6,0,1,0.68,0.6364,0.79,0.2239,181,256,437,256
12151,5/26/2012,2,1,5,11,0,6,0,1,0.7,0.6667,0.74,0.194,208,312,520,312
12152,5/26/2012,2,1,5,12,0,6,0,1,0.74,0.697,0.66,0.2239,236,293,529,293
12153,5/26/2012,2,1,5,13,0,6,0,1,0.76,0.7273,0.66,0.194,265,274,539,274
12154,5/26/2012,2,1,5,14,0,6,0,1,0.76,0.7273,0.66,0.2239,307,257,564,257
12155,5/26/2012,2,1,5,15,0,6,0,1,0.76,0.7273,0.66,0.2836,274,239,513,239
12156,5/26/2012,2,1,5,16,0,6,0,1,0.78,0.7273,0.55,0.2537,261,243,504,243
12157,5/26/2012,2,1,5,17,0,6,0,2,0.78,0.7121,0.52,0.2537,235,227,462,227
12158,5/26/2012,2,1,5,18,0,6,0,2,0.76,0.697,0.52,0.194,199,216,415,216
12159,5/26/2012,2,1,5,19,0,6,0,2,0.74,0.697,0.66,0.2239,159,214,373,214
12160,5/26/2012,2,1,5,20,0,6,0,2,0.74,0.6818,0.55,0.194,103,152,255,152
12161,5/26/2012,2,1,5,21,0,6,0,2,0.72,0.6818,0.62,0.194,100,151,251,151
12162,5/26/2012,2,1,5,22,0,6,0,1,0.7,0.6667,0.74,0.2537,86,118,204,118
12163,5/26/2012,2,1,5,23,0,6,0,1,0.7,0.6667,0.74,0.2537,36,114,150,114
12164,5/27/2012,2,1,5,0,0,0,0,2,0.68,0.6364,0.69,0.1642,48,89,137,89
12165,5/27/2012,2,1,5,1,0,0,0,1,0.66,0.6212,0.74,0.2239,17,61,78,61
12166,5/27/2012,2,1,5,2,0,0,0,1,0.64,0.6061,0.73,0.2239,16,45,61,45
12167,5/27/2012,2,1,5,3,0,0,0,1,0.64,0.6061,0.73,0.1642,11,25,36,25
12168,5/27/2012,2,1,5,4,0,0,0,1,0.62,0.5758,0.83,0.194,4,7,11,7
12169,5/27/2012,2,1,5,5,0,0,0,1,0.62,0.5758,0.83,0.194,2,5,7,5
12170,5/27/2012,2,1,5,6,0,0,0,1,0.62,0.5758,0.83,0.1642,8,14,22,14
12171,5/27/2012,2,1,5,7,0,0,0,1,0.62,0.5606,0.88,0.1642,22,30,52,30
12172,5/27/2012,2,1,5,8,0,0,0,1,0.64,0.5758,0.83,0.194,69,82,151,82
12173,5/27/2012,2,1,5,9,0,0,0,1,0.66,0.6061,0.83,0.2239,130,140,270,140
12174,5/27/2012,2,1,5,10,0,0,0,1,0.68,0.6364,0.74,0.2537,209,215,424,215
12175,5/27/2012,2,1,5,11,0,0,0,1,0.72,0.6818,0.66,0.2239,268,251,519,251
12176,5/27/2012,2,1,5,12,0,0,0,1,0.74,0.697,0.66,0.2537,301,269,570,269
12177,5/27/2012,2,1,5,13,0,0,0,1,0.76,0.7121,0.58,0.194,270,228,498,228
12178,5/27/2012,2,1,5,14,0,0,0,1,0.76,0.7121,0.58,0.2537,317,230,547,230
12179,5/27/2012,2,1,5,15,0,0,0,1,0.78,0.7121,0.52,0.2836,290,245,535,245
12180,5/27/2012,2,1,5,16,0,0,0,1,0.78,0.7121,0.52,0.2836,258,243,501,243
12181,5/27/2012,2,1,5,17,0,0,0,1,0.78,0.7121,0.49,0.2985,275,247,522,247
12182,5/27/2012,2,1,5,18,0,0,0,1,0.76,0.7121,0.58,0.2985,266,252,518,252
12183,5/27/2012,2,1,5,19,0,0,0,1,0.76,0.7121,0.58,0.194,230,212,442,212
12184,5/27/2012,2,1,5,20,0,0,0,1,0.74,0.6818,0.55,0.1642,168,224,392,224
12185,5/27/2012,2,1,5,21,0,0,0,3,0.66,0.6212,0.69,0.4179,64,79,143,79
12186,5/27/2012,2,1,5,22,0,0,0,3,0.62,0.5758,0.83,0,9,50,59,50
12187,5/27/2012,2,1,5,23,0,0,0,3,0.62,0.5758,0.83,0.1343,31,65,96,65
12188,5/28/2012,2,1,5,0,1,1,0,1,0.62,0.5758,0.83,0.2239,21,44,65,44
12189,5/28/2012,2,1,5,1,1,1,0,2,0.62,0.5909,0.78,0.2985,14,45,59,45
12190,5/28/2012,2,1,5,2,1,1,0,1,0.6,0.5606,0.83,0.2239,20,28,48,28
12191,5/28/2012,2,1,5,3,1,1,0,1,0.62,0.5909,0.73,0.1642,6,12,18,12
12192,5/28/2012,2,1,5,4,1,1,0,1,0.6,0.5758,0.78,0.1343,2,4,6,4
12193,5/28/2012,2,1,5,5,1,1,0,1,0.6,0.5758,0.78,0.1343,4,5,9,5
12194,5/28/2012,2,1,5,6,1,1,0,1,0.62,0.5909,0.73,0.1642,6,14,20,14
12195,5/28/2012,2,1,5,7,1,1,0,1,0.62,0.5909,0.78,0.1045,24,43,67,43
12196,5/28/2012,2,1,5,8,1,1,0,1,0.66,0.6212,0.69,0,62,93,155,93
12197,5/28/2012,2,1,5,9,1,1,0,1,0.7,0.6515,0.61,0,121,142,263,142
12198,5/28/2012,2,1,5,10,1,1,0,1,0.7,0.6515,0.61,0,189,175,364,175
12199,5/28/2012,2,1,5,11,1,1,0,1,0.72,0.6818,0.66,0.1343,254,222,476,222
12200,5/28/2012,2,1,5,12,1,1,0,1,0.76,0.7121,0.62,0.1343,233,292,525,292
12201,5/28/2012,2,1,5,13,1,1,0,1,0.8,0.7879,0.63,0.2836,272,284,556,284
12202,5/28/2012,2,1,5,14,1,1,0,1,0.8,0.7879,0.63,0.2836,238,227,465,227
12203,5/28/2012,2,1,5,15,1,1,0,1,0.82,0.7879,0.56,0.2985,181,279,460,279
12204,5/28/2012,2,1,5,16,1,1,0,1,0.82,0.7879,0.56,0.3284,223,278,501,278
12205,5/28/2012,2,1,5,17,1,1,0,1,0.82,0.7879,0.56,0.2985,158,247,405,247
12206,5/28/2012,2,1,5,18,1,1,0,1,0.8,0.7727,0.59,0.2985,132,251,383,251
12207,5/28/2012,2,1,5,19,1,1,0,1,0.8,0.7576,0.55,0.2985,148,247,395,247
12208,5/28/2012,2,1,5,20,1,1,0,1,0.78,0.7424,0.62,0.2985,114,203,317,203
12209,5/28/2012,2,1,5,21,1,1,0,1,0.76,0.7273,0.66,0.2836,66,181,247,181
12210,5/28/2012,2,1,5,22,1,1,0,1,0.74,0.697,0.7,0.1642,47,110,157,110
12211,5/28/2012,2,1,5,23,1,1,0,1,0.72,0.697,0.74,0.1642,22,60,82,60
12212,5/29/2012,2,1,5,0,0,2,1,1,0.7,0.6667,0.79,0.194,12,33,45,33
12213,5/29/2012,2,1,5,1,0,2,1,1,0.7,0.6667,0.79,0.194,1,13,14,13
12214,5/29/2012,2,1,5,2,0,2,1,1,0.68,0.6364,0.83,0.1343,0,8,8,8
12215,5/29/2012,2,1,5,3,0,2,1,1,0.68,0.6364,0.79,0.2836,1,2,3,2
12216,5/29/2012,2,1,5,4,0,2,1,1,0.66,0.6061,0.78,0.2239,0,5,5,5
12217,5/29/2012,2,1,5,5,0,2,1,1,0.66,0.6061,0.78,0.2239,1,32,33,32
12218,5/29/2012,2,1,5,6,0,2,1,1,0.66,0.6061,0.78,0.2239,9,145,154,145
12219,5/29/2012,2,1,5,7,0,2,1,1,0.66,0.6061,0.78,0.2239,19,431,450,431
12220,5/29/2012,2,1,5,8,0,2,1,1,0.7,0.6667,0.74,0.194,46,588,634,588
12221,5/29/2012,2,1,5,9,0,2,1,1,0.72,0.6818,0.7,0.2537,26,231,257,231
12222,5/29/2012,2,1,5,10,0,2,1,1,0.74,0.697,0.7,0.2985,67,116,183,116
12223,5/29/2012,2,1,5,11,0,2,1,1,0.76,0.7121,0.62,0.2985,50,147,197,147
12224,5/29/2012,2,1,5,12,0,2,1,1,0.8,0.7576,0.55,0.3284,56,181,237,181
12225,5/29/2012,2,1,5,13,0,2,1,1,0.82,0.7727,0.52,0.3881,63,176,239,176
12226,5/29/2012,2,1,5,14,0,2,1,1,0.82,0.7727,0.52,0.4179,80,158,238,158
12227,5/29/2012,2,1,5,15,0,2,1,1,0.82,0.7727,0.49,0.3881,71,185,256,185
12228,5/29/2012,2,1,5,16,0,2,1,1,0.82,0.7727,0.49,0.4925,73,320,393,320
12229,5/29/2012,2,1,5,17,0,2,1,1,0.82,0.7576,0.46,0.4179,107,674,781,674
12230,5/29/2012,2,1,5,18,0,2,1,1,0.8,0.7424,0.49,0.4925,78,632,710,632
12231,5/29/2012,2,1,5,19,0,2,1,1,0.78,0.7121,0.52,0.3582,69,457,526,457
12232,5/29/2012,2,1,5,20,0,2,1,3,0.7,0.6515,0.61,0.5224,36,168,204,168
12233,5/29/2012,2,1,5,21,0,2,1,3,0.6,0.5455,0.88,0.4478,3,68,71,68
12234,5/29/2012,2,1,5,22,0,2,1,2,0.62,0.5606,0.88,0.0896,2,53,55,53
12235,5/29/2012,2,1,5,23,0,2,1,3,0.62,0.5455,0.94,0,10,40,50,40
12236,5/30/2012,2,1,5,0,0,3,1,3,0.64,0.5758,0.89,0.1045,4,32,36,32
12237,5/30/2012,2,1,5,1,0,3,1,3,0.64,0.5758,0.89,0.194,0,4,4,4
12238,5/30/2012,2,1,5,2,0,3,1,3,0.62,0.5455,0.94,0.0896,1,4,5,4
12239,5/30/2012,2,1,5,3,0,3,1,3,0.62,0.5606,0.88,0.1343,0,5,5,5
12240,5/30/2012,2,1,5,4,0,3,1,2,0.62,0.5606,0.88,0.1343,0,6,6,6
12241,5/30/2012,2,1,5,5,0,3,1,2,0.62,0.5909,0.78,0.1343,1,40,41,40
12242,5/30/2012,2,1,5,6,0,3,1,2,0.6,0.5758,0.78,0.1045,5,139,144,139
12243,5/30/2012,2,1,5,7,0,3,1,3,0.6,0.5758,0.78,0.194,14,469,483,469
12244,5/30/2012,2,1,5,8,0,3,1,2,0.6,0.5909,0.73,0.1642,29,642,671,642
12245,5/30/2012,2,1,5,9,0,3,1,2,0.62,0.6061,0.69,0.194,23,282,305,282
12246,5/30/2012,2,1,5,10,0,3,1,2,0.62,0.6061,0.69,0.2836,39,138,177,138
12247,5/30/2012,2,1,5,11,0,3,1,2,0.66,0.6212,0.65,0.194,53,155,208,155
12248,5/30/2012,2,1,5,12,0,3,1,1,0.7,0.6515,0.54,0,33,220,253,220
12249,5/30/2012,2,1,5,13,0,3,1,1,0.7,0.6515,0.51,0,53,236,289,236
12250,5/30/2012,2,1,5,14,0,3,1,1,0.72,0.6515,0.42,0.1343,44,208,252,208
12251,5/30/2012,2,1,5,15,0,3,1,1,0.72,0.6667,0.51,0.1343,54,221,275,221
12252,5/30/2012,2,1,5,16,0,3,1,1,0.72,0.6667,0.51,0.1642,46,352,398,352
12253,5/30/2012,2,1,5,17,0,3,1,1,0.74,0.6667,0.48,0.0896,83,756,839,756
12254,5/30/2012,2,1,5,18,0,3,1,1,0.74,0.6667,0.48,0.1642,50,746,796,746
12255,5/30/2012,2,1,5,19,0,3,1,1,0.72,0.6667,0.54,0.1642,50,506,556,506
12256,5/30/2012,2,1,5,20,0,3,1,2,0.54,0.5152,0.6,0.1343,57,374,431,374
12257,5/30/2012,2,1,5,21,0,3,1,1,0.68,0.6364,0.57,0.1045,41,263,304,263
12258,5/30/2012,2,1,5,22,0,3,1,1,0.66,0.6212,0.69,0.1045,26,191,217,191
12259,5/30/2012,2,1,5,23,0,3,1,1,0.66,0.6212,0.65,0.1045,39,121,160,121
12260,5/31/2012,2,1,5,0,0,4,1,1,0.64,0.6061,0.69,0.1343,13,48,61,48
12261,5/31/2012,2,1,5,1,0,4,1,1,0.64,0.6061,0.69,0.0896,4,22,26,22
12262,5/31/2012,2,1,5,2,0,4,1,1,0.64,0.6061,0.65,0.0896,6,8,14,8
12263,5/31/2012,2,1,5,3,0,4,1,1,0.62,0.6061,0.69,0.0896,0,8,8,8
12264,5/31/2012,2,1,5,4,0,4,1,1,0.62,0.6061,0.69,0,0,8,8,8
12265,5/31/2012,2,1,5,5,0,4,1,1,0.62,0.6061,0.69,0.2537,1,32,33,32
12266,5/31/2012,2,1,5,6,0,4,1,1,0.6,0.5909,0.73,0.2239,7,171,178,171
12267,5/31/2012,2,1,5,7,0,4,1,1,0.6,0.6061,0.64,0.2836,18,489,507,489
12268,5/31/2012,2,1,5,8,0,4,1,1,0.62,0.6212,0.57,0.2537,18,675,693,675
12269,5/31/2012,2,1,5,9,0,4,1,1,0.66,0.6212,0.47,0.2537,47,264,311,264
12270,5/31/2012,2,1,5,10,0,4,1,1,0.7,0.6364,0.39,0.3881,65,155,220,155
12271,5/31/2012,2,1,5,11,0,4,1,1,0.72,0.6515,0.37,0.2836,65,153,218,153
12272,5/31/2012,2,1,5,12,0,4,1,1,0.72,0.6515,0.37,0.194,62,230,292,230
12273,5/31/2012,2,1,5,13,0,4,1,1,0.74,0.6515,0.35,0.1343,77,216,293,216
12274,5/31/2012,2,1,5,14,0,4,1,1,0.76,0.6667,0.31,0.194,61,193,254,193
12275,5/31/2012,2,1,5,15,0,4,1,1,0.76,0.6667,0.33,0.2985,81,209,290,209
12276,5/31/2012,2,1,5,16,0,4,1,1,0.76,0.6667,0.33,0.2836,103,384,487,384
12277,5/31/2012,2,1,5,17,0,4,1,1,0.76,0.6667,0.31,0.1642,85,742,827,742
12278,5/31/2012,2,1,5,18,0,4,1,1,0.74,0.6515,0.3,0.194,85,700,785,700
12279,5/31/2012,2,1,5,19,0,4,1,1,0.72,0.6515,0.34,0.1642,104,487,591,487
12280,5/31/2012,2,1,5,20,0,4,1,1,0.68,0.6364,0.44,0.1642,88,391,479,391
12281,5/31/2012,2,1,5,21,0,4,1,1,0.68,0.6364,0.44,0.1642,41,318,359,318
12282,5/31/2012,2,1,5,22,0,4,1,1,0.66,0.6212,0.5,0.1642,43,221,264,221
12283,5/31/2012,2,1,5,23,0,4,1,1,0.66,0.6212,0.54,0.2239,26,114,140,114
12284,6/1/2012,2,1,6,0,0,5,1,1,0.66,0.6212,0.5,0.2537,10,76,86,76
12285,6/1/2012,2,1,6,1,0,5,1,1,0.64,0.6212,0.53,0.2239,0,34,34,34
12286,6/1/2012,2,1,6,2,0,5,1,1,0.64,0.6212,0.57,0.2239,3,13,16,13
12287,6/1/2012,2,1,6,3,0,5,1,2,0.62,0.5909,0.73,0.0896,0,4,4,4
12288,6/1/2012,2,1,6,4,0,5,1,2,0.62,0.5909,0.73,0.0896,1,5,6,5
12289,6/1/2012,2,1,6,5,0,5,1,2,0.62,0.5909,0.78,0.0896,4,41,45,41
12290,6/1/2012,2,1,6,6,0,5,1,3,0.62,0.5606,0.88,0.1343,5,136,141,136
12291,6/1/2012,2,1,6,7,0,5,1,2,0.64,0.5758,0.89,0.194,33,369,402,369
12292,6/1/2012,2,1,6,8,0,5,1,2,0.64,0.5758,0.89,0.194,19,675,694,675
12293,6/1/2012,2,1,6,9,0,5,1,2,0.64,0.5758,0.83,0.2239,24,274,298,274
12294,6/1/2012,2,1,6,10,0,5,1,2,0.66,0.6061,0.78,0.2836,49,155,204,155
12295,6/1/2012,2,1,6,11,0,5,1,2,0.7,0.6667,0.74,0.2836,42,193,235,193
12296,6/1/2012,2,1,6,12,0,5,1,2,0.7,0.6667,0.74,0.3582,72,238,310,238
12297,6/1/2012,2,1,6,13,0,5,1,1,0.72,0.6818,0.7,0.2985,76,240,316,240
12298,6/1/2012,2,1,6,14,0,5,1,3,0.72,0.6818,0.66,0.2836,55,199,254,199
12299,6/1/2012,2,1,6,15,0,5,1,3,0.72,0.6818,0.66,0.2836,45,213,258,213
12300,6/1/2012,2,1,6,16,0,5,1,3,0.74,0.6818,0.58,0.4478,36,186,222,186
12301,6/1/2012,2,1,6,17,0,5,1,3,0.7,0.6515,0.7,0.2537,25,202,227,202
12302,6/1/2012,2,1,6,18,0,5,1,3,0.62,0.5606,0.88,0.3582,10,100,110,100
12303,6/1/2012,2,1,6,19,0,5,1,3,0.62,0.5606,0.88,0.3582,4,41,45,41
12304,6/1/2012,2,1,6,20,0,5,1,3,0.62,0.5455,0.94,0.2537,1,38,39,38
12305,6/1/2012,2,1,6,21,0,5,1,3,0.64,0.5909,0.78,0.2537,12,73,85,73
12306,6/1/2012,2,1,6,22,0,5,1,3,0.6,0.5455,0.88,0.1343,1,22,23,22
12307,6/1/2012,2,1,6,23,0,5,1,3,0.6,0.5455,0.88,0.1343,6,67,73,67
12308,6/2/2012,2,1,6,0,0,6,0,2,0.56,0.5303,0.83,0.1343,5,81,86,81
12309,6/2/2012,2,1,6,1,0,6,0,2,0.56,0.5303,0.83,0.1045,15,61,76,61
12310,6/2/2012,2,1,6,2,0,6,0,2,0.54,0.5152,0.88,0,3,38,41,38
12311,6/2/2012,2,1,6,3,0,6,0,1,0.56,0.5303,0.73,0.2537,8,18,26,18
12312,6/2/2012,2,1,6,4,0,6,0,1,0.54,0.5152,0.68,0.2836,2,11,13,11
12313,6/2/2012,2,1,6,5,0,6,0,1,0.5,0.4848,0.72,0.194,1,11,12,11
12314,6/2/2012,2,1,6,6,0,6,0,2,0.5,0.4848,0.77,0.194,5,31,36,31
12315,6/2/2012,2,1,6,7,0,6,0,1,0.52,0.5,0.72,0.1045,9,77,86,77
12316,6/2/2012,2,1,6,8,0,6,0,1,0.54,0.5152,0.64,0.1642,30,180,210,180
12317,6/2/2012,2,1,6,9,0,6,0,1,0.56,0.5303,0.6,0.2537,89,243,332,243
12318,6/2/2012,2,1,6,10,0,6,0,1,0.6,0.6212,0.53,0.2985,145,348,493,348
12319,6/2/2012,2,1,6,11,0,6,0,1,0.58,0.5455,0.46,0.2836,179,357,536,357
12320,6/2/2012,2,1,6,12,0,6,0,1,0.62,0.6212,0.43,0.3582,250,418,668,418
12321,6/2/2012,2,1,6,13,0,6,0,1,0.62,0.6212,0.41,0.2537,279,400,679,400
12322,6/2/2012,2,1,6,14,0,6,0,1,0.64,0.6212,0.38,0.2985,259,388,647,388
12323,6/2/2012,2,1,6,15,0,6,0,1,0.64,0.6212,0.38,0.2537,297,405,702,405
12324,6/2/2012,2,1,6,16,0,6,0,1,0.64,0.6212,0.38,0.2537,275,369,644,369
12325,6/2/2012,2,1,6,17,0,6,0,1,0.64,0.6212,0.36,0,248,338,586,338
12326,6/2/2012,2,1,6,18,0,6,0,1,0.64,0.6212,0.36,0,171,341,512,341
12327,6/2/2012,2,1,6,19,0,6,0,1,0.64,0.6212,0.36,0.1642,185,369,554,369
12328,6/2/2012,2,1,6,20,0,6,0,1,0.62,0.6212,0.35,0.2836,139,260,399,260
12329,6/2/2012,2,1,6,21,0,6,0,1,0.6,0.6212,0.4,0.1045,96,220,316,220
12330,6/2/2012,2,1,6,22,0,6,0,1,0.58,0.5455,0.46,0.1343,52,176,228,176
12331,6/2/2012,2,1,6,23,0,6,0,1,0.56,0.5303,0.52,0.1045,53,185,238,185
12332,6/3/2012,2,1,6,0,0,0,0,1,0.54,0.5152,0.6,0.1642,27,142,169,142
12333,6/3/2012,2,1,6,1,0,0,0,1,0.54,0.5152,0.56,0.1343,21,100,121,100
12334,6/3/2012,2,1,6,2,0,0,0,1,0.52,0.5,0.59,0.1045,22,67,89,67
12335,6/3/2012,2,1,6,3,0,0,0,1,0.52,0.5,0.63,0.1045,16,34,50,34
12336,6/3/2012,2,1,6,4,0,0,0,1,0.5,0.4848,0.72,0.0896,1,12,13,12
12337,6/3/2012,2,1,6,5,0,0,0,1,0.5,0.4848,0.68,0,1,11,12,11
12338,6/3/2012,2,1,6,6,0,0,0,1,0.46,0.4545,0.82,0.1045,6,16,22,16
12339,6/3/2012,2,1,6,7,0,0,0,1,0.5,0.4848,0.68,0.1045,6,29,35,29
12340,6/3/2012,2,1,6,8,0,0,0,1,0.54,0.5152,0.6,0.0896,30,110,140,110
12341,6/3/2012,2,1,6,9,0,0,0,1,0.6,0.6212,0.46,0.194,70,230,300,230
12342,6/3/2012,2,1,6,10,0,0,0,1,0.62,0.6212,0.43,0.2239,127,277,404,277
12343,6/3/2012,2,1,6,11,0,0,0,1,0.64,0.6212,0.41,0.2537,199,312,511,312
12344,6/3/2012,2,1,6,12,0,0,0,1,0.66,0.6212,0.39,0.2985,276,408,684,408
12345,6/3/2012,2,1,6,13,0,0,0,1,0.68,0.6364,0.36,0.2836,265,421,686,421
12346,6/3/2012,2,1,6,14,0,0,0,1,0.68,0.6364,0.36,0.3284,267,411,678,411
12347,6/3/2012,2,1,6,15,0,0,0,1,0.7,0.6364,0.34,0,236,408,644,408
12348,6/3/2012,2,1,6,16,0,0,0,1,0.7,0.6364,0.34,0.2985,226,436,662,436
12349,6/3/2012,2,1,6,17,0,0,0,1,0.7,0.6364,0.34,0.2537,192,386,578,386
12350,6/3/2012,2,1,6,18,0,0,0,1,0.7,0.6364,0.34,0.2537,153,343,496,343
12351,6/3/2012,2,1,6,19,0,0,0,1,0.68,0.6364,0.34,0.2836,116,337,453,337
12352,6/3/2012,2,1,6,20,0,0,0,1,0.66,0.6212,0.39,0.194,84,230,314,230
12353,6/3/2012,2,1,6,21,0,0,0,1,0.62,0.6212,0.43,0.1642,66,180,246,180
12354,6/3/2012,2,1,6,22,0,0,0,1,0.62,0.6212,0.5,0.3881,61,165,226,165
12355,6/3/2012,2,1,6,23,0,0,0,1,0.58,0.5455,0.53,0.1045,26,82,108,82
12356,6/4/2012,2,1,6,0,0,1,1,1,0.58,0.5455,0.53,0,11,38,49,38
12357,6/4/2012,2,1,6,1,0,1,1,3,0.56,0.5303,0.6,0.1642,4,10,14,10
12358,6/4/2012,2,1,6,2,0,1,1,1,0.56,0.5303,0.6,0.2239,1,10,11,10
12359,6/4/2012,2,1,6,3,0,1,1,2,0.56,0.5303,0.6,0.1642,0,5,5,5
12360,6/4/2012,2,1,6,4,0,1,1,1,0.54,0.5152,0.64,0.0896,2,6,8,6
12361,6/4/2012,2,1,6,5,0,1,1,1,0.52,0.5,0.68,0,2,33,35,33
12362,6/4/2012,2,1,6,6,0,1,1,1,0.52,0.5,0.68,0,4,135,139,135
12363,6/4/2012,2,1,6,7,0,1,1,1,0.56,0.5303,0.6,0.2239,13,504,517,504
12364,6/4/2012,2,1,6,8,0,1,1,1,0.6,0.6212,0.49,0.2239,22,643,665,643
12365,6/4/2012,2,1,6,9,0,1,1,1,0.62,0.6212,0.43,0.2836,38,244,282,244
12366,6/4/2012,2,1,6,10,0,1,1,1,0.64,0.6212,0.41,0.4627,67,120,187,120
12367,6/4/2012,2,1,6,11,0,1,1,1,0.64,0.6212,0.38,0.4925,71,168,239,168
12368,6/4/2012,2,1,6,12,0,1,1,1,0.64,0.6212,0.41,0.4478,62,220,282,220
12369,6/4/2012,2,1,6,13,0,1,1,1,0.64,0.6212,0.41,0.3582,85,189,274,189
12370,6/4/2012,2,1,6,14,0,1,1,1,0.62,0.6212,0.41,0.4925,84,186,270,186
12371,6/4/2012,2,1,6,15,0,1,1,1,0.66,0.6212,0.39,0.2985,77,215,292,215
12372,6/4/2012,2,1,6,16,0,1,1,1,0.66,0.6212,0.39,0.4627,73,375,448,375
12373,6/4/2012,2,1,6,17,0,1,1,1,0.64,0.6212,0.38,0.4478,101,733,834,733
12374,6/4/2012,2,1,6,18,0,1,1,1,0.64,0.6212,0.38,0.3881,103,719,822,719
12375,6/4/2012,2,1,6,19,0,1,1,1,0.62,0.6212,0.38,0.4179,91,554,645,554
12376,6/4/2012,2,1,6,20,0,1,1,1,0.6,0.6212,0.4,0.3582,71,390,461,390
12377,6/4/2012,2,1,6,21,0,1,1,1,0.58,0.5455,0.49,0.2537,40,225,265,225
12378,6/4/2012,2,1,6,22,0,1,1,1,0.56,0.5303,0.52,0.2836,41,127,168,127
12379,6/4/2012,2,1,6,23,0,1,1,1,0.58,0.5455,0.49,0.2985,8,78,86,78
12380,6/5/2012,2,1,6,0,0,2,1,1,0.54,0.5152,0.68,0.4179,6,28,34,28
12381,6/5/2012,2,1,6,1,0,2,1,2,0.52,0.5,0.77,0.3284,2,18,20,18
12382,6/5/2012,2,1,6,2,0,2,1,3,0.52,0.5,0.72,0.2985,0,8,8,8
12383,6/5/2012,2,1,6,3,0,2,1,3,0.5,0.4848,0.82,0.194,0,5,5,5
12384,6/5/2012,2,1,6,4,0,2,1,3,0.5,0.4848,0.82,0.194,1,4,5,4
12385,6/5/2012,2,1,6,5,0,2,1,3,0.48,0.4697,0.82,0.1642,1,35,36,35
12386,6/5/2012,2,1,6,6,0,2,1,1,0.48,0.4697,0.82,0.2537,7,177,184,177
12387,6/5/2012,2,1,6,7,0,2,1,1,0.48,0.4697,0.77,0.2985,29,540,569,540
12388,6/5/2012,2,1,6,8,0,2,1,2,0.48,0.4697,0.77,0.2239,30,680,710,680
12389,6/5/2012,2,1,6,9,0,2,1,2,0.52,0.5,0.72,0.2537,50,285,335,285
12390,6/5/2012,2,1,6,10,0,2,1,2,0.52,0.5,0.63,0.2985,58,118,176,118
12391,6/5/2012,2,1,6,11,0,2,1,2,0.56,0.5303,0.56,0.194,65,162,227,162
12392,6/5/2012,2,1,6,12,0,2,1,2,0.54,0.5152,0.56,0.2239,45,202,247,202
12393,6/5/2012,2,1,6,13,0,2,1,2,0.6,0.6212,0.46,0.1642,66,201,267,201
12394,6/5/2012,2,1,6,14,0,2,1,2,0.58,0.5455,0.46,0.1642,82,194,276,194
12395,6/5/2012,2,1,6,15,0,2,1,2,0.58,0.5455,0.46,0.1343,54,218,272,218
12396,6/5/2012,2,1,6,16,0,2,1,1,0.6,0.6212,0.43,0.194,91,382,473,382
12397,6/5/2012,2,1,6,17,0,2,1,1,0.6,0.6212,0.43,0,86,764,850,764
12398,6/5/2012,2,1,6,18,0,2,1,1,0.6,0.6212,0.43,0.194,111,679,790,679
12399,6/5/2012,2,1,6,19,0,2,1,1,0.58,0.5455,0.46,0.2537,68,445,513,445
12400,6/5/2012,2,1,6,20,0,2,1,1,0.56,0.5303,0.49,0.2239,44,371,415,371
12401,6/5/2012,2,1,6,21,0,2,1,1,0.54,0.5152,0.56,0.1642,30,253,283,253
12402,6/5/2012,2,1,6,22,0,2,1,1,0.56,0.5303,0.52,0.1045,22,171,193,171
12403,6/5/2012,2,1,6,23,0,2,1,1,0.54,0.5152,0.56,0.0896,20,93,113,93
12404,6/6/2012,2,1,6,0,0,3,1,1,0.52,0.5,0.59,0.0896,3,46,49,46
12405,6/6/2012,2,1,6,1,0,3,1,1,0.52,0.5,0.68,0,6,21,27,21
12406,6/6/2012,2,1,6,2,0,3,1,1,0.5,0.4848,0.68,0,4,7,11,7
12407,6/6/2012,2,1,6,3,0,3,1,1,0.46,0.4545,0.82,0,0,8,8,8
12408,6/6/2012,2,1,6,4,0,3,1,1,0.46,0.4545,0.82,0.1045,3,7,10,7
12409,6/6/2012,2,1,6,5,0,3,1,1,0.48,0.4697,0.77,0,1,37,38,37
12410,6/6/2012,2,1,6,6,0,3,1,1,0.48,0.4697,0.77,0,7,165,172,165
12411,6/6/2012,2,1,6,7,0,3,1,1,0.5,0.4848,0.72,0,16,531,547,531
12412,6/6/2012,2,1,6,8,0,3,1,1,0.54,0.5152,0.68,0,31,637,668,637
12413,6/6/2012,2,1,6,9,0,3,1,1,0.56,0.5303,0.6,0.0896,35,268,303,268
12414,6/6/2012,2,1,6,10,0,3,1,1,0.6,0.6212,0.46,0.0896,55,148,203,148
12415,6/6/2012,2,1,6,11,0,3,1,1,0.62,0.6212,0.43,0.0896,65,161,226,161
12416,6/6/2012,2,1,6,12,0,3,1,1,0.62,0.6212,0.38,0,80,235,315,235
12417,6/6/2012,2,1,6,13,0,3,1,1,0.62,0.6212,0.41,0.0896,73,230,303,230
12418,6/6/2012,2,1,6,14,0,3,1,1,0.64,0.6212,0.38,0,111,191,302,191
12419,6/6/2012,2,1,6,15,0,3,1,1,0.64,0.6212,0.38,0,75,225,300,225
12420,6/6/2012,2,1,6,16,0,3,1,1,0.64,0.6212,0.41,0.1343,107,345,452,345
12421,6/6/2012,2,1,6,17,0,3,1,1,0.62,0.6212,0.43,0.1343,72,652,724,652
12422,6/6/2012,2,1,6,18,0,3,1,3,0.6,0.6212,0.53,0.194,94,688,782,688
12423,6/6/2012,2,1,6,19,0,3,1,1,0.56,0.5303,0.73,0.2985,52,486,538,486
12424,6/6/2012,2,1,6,20,0,3,1,1,0.54,0.5152,0.73,0.2836,59,349,408,349
12425,6/6/2012,2,1,6,21,0,3,1,1,0.54,0.5152,0.73,0.1642,38,260,298,260
12426,6/6/2012,2,1,6,22,0,3,1,1,0.52,0.5,0.77,0.0896,27,221,248,221
12427,6/6/2012,2,1,6,23,0,3,1,1,0.52,0.5,0.77,0,13,110,123,110
12428,6/7/2012,2,1,6,0,0,4,1,1,0.52,0.5,0.77,0.1343,9,50,59,50
12429,6/7/2012,2,1,6,1,0,4,1,1,0.52,0.5,0.77,0.1642,5,17,22,17
12430,6/7/2012,2,1,6,2,0,4,1,1,0.52,0.5,0.77,0.0896,0,12,12,12
12431,6/7/2012,2,1,6,3,0,4,1,1,0.5,0.4848,0.77,0.1045,0,5,5,5
12432,6/7/2012,2,1,6,4,0,4,1,1,0.46,0.4545,0.88,0.1045,0,6,6,6
12433,6/7/2012,2,1,6,5,0,4,1,1,0.48,0.4697,0.82,0.0896,0,34,34,34
12434,6/7/2012,2,1,6,6,0,4,1,1,0.46,0.4545,0.88,0.1045,5,165,170,165
12435,6/7/2012,2,1,6,7,0,4,1,1,0.5,0.4848,0.82,0.1642,20,506,526,506
12436,6/7/2012,2,1,6,8,0,4,1,1,0.52,0.5,0.77,0,20,661,681,661
12437,6/7/2012,2,1,6,9,0,4,1,1,0.58,0.5455,0.68,0,37,300,337,300
12438,6/7/2012,2,1,6,10,0,4,1,1,0.6,0.6061,0.64,0.0896,56,154,210,154
12439,6/7/2012,2,1,6,11,0,4,1,1,0.66,0.6212,0.47,0.2239,67,170,237,170
12440,6/7/2012,2,1,6,12,0,4,1,1,0.7,0.6364,0.42,0,62,274,336,274
12441,6/7/2012,2,1,6,13,0,4,1,1,0.7,0.6364,0.37,0.2836,65,250,315,250
12442,6/7/2012,2,1,6,14,0,4,1,1,0.72,0.6515,0.37,0.2537,67,198,265,198
12443,6/7/2012,2,1,6,15,0,4,1,1,0.74,0.6515,0.3,0,99,234,333,234
12444,6/7/2012,2,1,6,16,0,4,1,1,0.72,0.6515,0.34,0.2239,77,389,466,389
12445,6/7/2012,2,1,6,17,0,4,1,1,0.72,0.6515,0.34,0.2537,91,778,869,778
12446,6/7/2012,2,1,6,18,0,4,1,1,0.7,0.6364,0.34,0.2836,110,703,813,703
12447,6/7/2012,2,1,6,19,0,4,1,1,0.7,0.6364,0.34,0.2836,65,537,602,537
12448,6/7/2012,2,1,6,20,0,4,1,1,0.66,0.6212,0.36,0.2985,76,402,478,402
12449,6/7/2012,2,1,6,21,0,4,1,1,0.62,0.6212,0.41,0.3284,30,283,313,283
12450,6/7/2012,2,1,6,22,0,4,1,1,0.6,0.6212,0.46,0.1642,35,193,228,193
12451,6/7/2012,2,1,6,23,0,4,1,1,0.56,0.5303,0.52,0.1343,42,135,177,135
12452,6/8/2012,2,1,6,0,0,5,1,1,0.56,0.5303,0.56,0.1642,18,59,77,59
12453,6/8/2012,2,1,6,1,0,5,1,1,0.56,0.5303,0.56,0.1642,4,25,29,25
12454,6/8/2012,2,1,6,2,0,5,1,1,0.56,0.5303,0.56,0,2,17,19,17
12455,6/8/2012,2,1,6,3,0,5,1,1,0.54,0.5152,0.6,0.0896,0,8,8,8
12456,6/8/2012,2,1,6,4,0,5,1,1,0.52,0.5,0.63,0,1,9,10,9
12457,6/8/2012,2,1,6,5,0,5,1,1,0.5,0.4848,0.72,0.1045,1,28,29,28
12458,6/8/2012,2,1,6,6,0,5,1,1,0.52,0.5,0.68,0.0896,8,131,139,131
12459,6/8/2012,2,1,6,7,0,5,1,1,0.52,0.5,0.72,0.1045,19,409,428,409
12460,6/8/2012,2,1,6,8,0,5,1,1,0.58,0.5455,0.6,0.0896,37,663,700,663
12461,6/8/2012,2,1,6,9,0,5,1,1,0.62,0.6212,0.53,0.1642,47,335,382,335
12462,6/8/2012,2,1,6,10,0,5,1,1,0.66,0.6212,0.47,0.2537,62,187,249,187
12463,6/8/2012,2,1,6,11,0,5,1,1,0.7,0.6364,0.42,0.2537,65,199,264,199
12464,6/8/2012,2,1,6,12,0,5,1,1,0.72,0.6515,0.39,0.3284,89,280,369,280
12465,6/8/2012,2,1,6,13,0,5,1,1,0.74,0.6515,0.37,0.2537,129,287,416,287
12466,6/8/2012,2,1,6,14,0,5,1,1,0.76,0.6667,0.31,0.3881,128,245,373,245
12467,6/8/2012,2,1,6,15,0,5,1,1,0.76,0.6667,0.29,0.2836,98,299,397,299
12468,6/8/2012,2,1,6,16,0,5,1,1,0.76,0.6667,0.29,0.2985,111,412,523,412
12469,6/8/2012,2,1,6,17,0,5,1,1,0.76,0.6667,0.29,0.194,114,679,793,679
12470,6/8/2012,2,1,6,18,0,5,1,1,0.76,0.6667,0.27,0.2239,147,576,723,576
12471,6/8/2012,2,1,6,19,0,5,1,1,0.74,0.6515,0.3,0.2239,95,460,555,460
12472,6/8/2012,2,1,6,20,0,5,1,1,0.72,0.6515,0.32,0.1343,117,291,408,291
12473,6/8/2012,2,1,6,21,0,5,1,1,0.7,0.6364,0.37,0.1343,83,256,339,256
12474,6/8/2012,2,1,6,22,0,5,1,1,0.68,0.6364,0.41,0.1045,61,230,291,230
12475,6/8/2012,2,1,6,23,0,5,1,1,0.64,0.6212,0.57,0.1642,52,163,215,163
12476,6/9/2012,2,1,6,0,0,6,0,1,0.64,0.6212,0.53,0.1045,54,152,206,152
12477,6/9/2012,2,1,6,1,0,6,0,1,0.64,0.6212,0.53,0.0896,34,89,123,89
12478,6/9/2012,2,1,6,2,0,6,0,1,0.64,0.6212,0.5,0.2239,21,68,89,68
12479,6/9/2012,2,1,6,3,0,6,0,1,0.62,0.6212,0.57,0,12,28,40,28
12480,6/9/2012,2,1,6,4,0,6,0,1,0.62,0.6212,0.57,0,2,6,8,6
12481,6/9/2012,2,1,6,5,0,6,0,1,0.6,0.6212,0.56,0.1045,4,15,19,15
12482,6/9/2012,2,1,6,6,0,6,0,1,0.56,0.5303,0.64,0.1045,17,63,80,63
12483,6/9/2012,2,1,6,7,0,6,0,1,0.58,0.5455,0.64,0.1045,26,61,87,61
12484,6/9/2012,2,1,6,8,0,6,0,1,0.62,0.6061,0.61,0.1045,42,202,244,202
12485,6/9/2012,2,1,6,9,0,6,0,1,0.64,0.6212,0.57,0.1642,99,241,340,241
12486,6/9/2012,2,1,6,10,0,6,0,1,0.7,0.6515,0.51,0.1045,168,298,466,298
12487,6/9/2012,2,1,6,11,0,6,0,1,0.76,0.6667,0.35,0,218,351,569,351
12488,6/9/2012,2,1,6,12,0,6,0,1,0.8,0.697,0.29,0.2537,196,335,531,335
12489,6/9/2012,2,1,6,13,0,6,0,1,0.82,0.697,0.24,0.2836,236,349,585,349
12490,6/9/2012,2,1,6,14,0,6,0,1,0.82,0.697,0.23,0.194,239,354,593,354
12491,6/9/2012,2,1,6,15,0,6,0,1,0.84,0.7121,0.2,0.2985,218,337,555,337
12492,6/9/2012,2,1,6,16,0,6,0,1,0.82,0.697,0.24,0.194,219,315,534,315
12493,6/9/2012,2,1,6,17,0,6,0,1,0.84,0.7121,0.24,0,238,257,495,257
12494,6/9/2012,2,1,6,18,0,6,0,1,0.82,0.697,0.24,0.2239,175,276,451,276
12495,6/9/2012,2,1,6,19,0,6,0,1,0.8,0.697,0.29,0.1642,128,232,360,232
12496,6/9/2012,2,1,6,20,0,6,0,1,0.76,0.6667,0.35,0.2239,125,238,363,238
12497,6/9/2012,2,1,6,21,0,6,0,1,0.74,0.6515,0.4,0.194,105,211,316,211
12498,6/9/2012,2,1,6,22,0,6,0,1,0.7,0.6515,0.58,0.1642,63,151,214,151
12499,6/9/2012,2,1,6,23,0,6,0,1,0.68,0.6364,0.61,0.1642,69,161,230,161
12500,6/10/2012,2,1,6,0,0,0,0,1,0.66,0.6212,0.69,0.1045,33,125,158,125
12501,6/10/2012,2,1,6,1,0,0,0,1,0.64,0.6061,0.73,0.1343,32,84,116,84
12502,6/10/2012,2,1,6,2,0,0,0,1,0.64,0.6061,0.69,0.1343,17,56,73,56
12503,6/10/2012,2,1,6,3,0,0,0,1,0.64,0.6061,0.73,0.1045,6,23,29,23
12504,6/10/2012,2,1,6,4,0,0,0,1,0.62,0.5909,0.78,0.0896,1,9,10,9
12505,6/10/2012,2,1,6,5,0,0,0,1,0.62,0.6061,0.69,0.0896,3,10,13,10
12506,6/10/2012,2,1,6,6,0,0,0,1,0.62,0.5909,0.73,0,3,27,30,27
12507,6/10/2012,2,1,6,7,0,0,0,1,0.6,0.5758,0.78,0.1045,21,41,62,41
12508,6/10/2012,2,1,6,8,0,0,0,1,0.64,0.6061,0.73,0.0896,59,122,181,122
12509,6/10/2012,2,1,6,9,0,0,0,1,0.7,0.6515,0.58,0,91,175,266,175
12510,6/10/2012,2,1,6,10,0,0,0,1,0.76,0.6818,0.4,0.1045,148,265,413,265
12511,6/10/2012,2,1,6,11,0,0,0,1,0.76,0.6818,0.45,0.0896,184,315,499,315
12512,6/10/2012,2,1,6,12,0,0,0,1,0.82,0.7121,0.3,0,173,329,502,329
12513,6/10/2012,2,1,6,13,0,0,0,1,0.84,0.7273,0.28,0.1343,204,288,492,288
12514,6/10/2012,2,1,6,14,0,0,0,1,0.84,0.7273,0.3,0.1343,186,314,500,314
12515,6/10/2012,2,1,6,15,0,0,0,1,0.84,0.7273,0.3,0.2239,159,316,475,316
12516,6/10/2012,2,1,6,16,0,0,0,1,0.84,0.7424,0.36,0.2836,173,335,508,335
12517,6/10/2012,2,1,6,17,0,0,0,1,0.82,0.7424,0.41,0.2836,184,337,521,337
12518,6/10/2012,2,1,6,18,0,0,0,1,0.82,0.7273,0.38,0.2239,164,326,490,326
12519,6/10/2012,2,1,6,19,0,0,0,1,0.82,0.7121,0.28,0.2836,115,260,375,260
12520,6/10/2012,2,1,6,20,0,0,0,1,0.76,0.6818,0.48,0.1642,113,250,363,250
12521,6/10/2012,2,1,6,21,0,0,0,1,0.72,0.6818,0.62,0.1642,83,170,253,170
12522,6/10/2012,2,1,6,22,0,0,0,1,0.7,0.6515,0.65,0.1642,42,117,159,117
12523,6/10/2012,2,1,6,23,0,0,0,1,0.72,0.6667,0.58,0.1045,30,80,110,80
12524,6/11/2012,2,1,6,0,0,1,1,1,0.7,0.6515,0.65,0.1045,8,33,41,33
12525,6/11/2012,2,1,6,1,0,1,1,1,0.66,0.6212,0.74,0.1642,9,15,24,15
12526,6/11/2012,2,1,6,2,0,1,1,1,0.66,0.6212,0.74,0.1045,5,12,17,12
12527,6/11/2012,2,1,6,3,0,1,1,1,0.64,0.5909,0.78,0.1045,2,4,6,4
12528,6/11/2012,2,1,6,4,0,1,1,1,0.64,0.5909,0.78,0.1343,0,7,7,7
12529,6/11/2012,2,1,6,5,0,1,1,1,0.64,0.5909,0.78,0.1343,1,36,37,36
12530,6/11/2012,2,1,6,6,0,1,1,1,0.62,0.5758,0.83,0.1045,8,136,144,136
12531,6/11/2012,2,1,6,7,0,1,1,1,0.64,0.5909,0.78,0.1045,25,478,503,478
12532,6/11/2012,2,1,6,8,0,1,1,1,0.66,0.6212,0.74,0.1343,38,613,651,613
12533,6/11/2012,2,1,6,9,0,1,1,1,0.7,0.6515,0.65,0.1343,57,259,316,259
12534,6/11/2012,2,1,6,10,0,1,1,1,0.72,0.6818,0.62,0.1642,52,95,147,95
12535,6/11/2012,2,1,6,11,0,1,1,2,0.76,0.6818,0.48,0.2239,59,143,202,143
12536,6/11/2012,2,1,6,12,0,1,1,2,0.8,0.7273,0.43,0.194,63,198,261,198
12537,6/11/2012,2,1,6,13,0,1,1,2,0.8,0.7121,0.41,0.2985,63,185,248,185
12538,6/11/2012,2,1,6,14,0,1,1,2,0.82,0.7273,0.34,0.2836,66,193,259,193
12539,6/11/2012,2,1,6,15,0,1,1,1,0.8,0.7121,0.41,0.3582,72,187,259,187
12540,6/11/2012,2,1,6,16,0,1,1,2,0.8,0.7121,0.41,0.4179,87,340,427,340
12541,6/11/2012,2,1,6,17,0,1,1,2,0.8,0.7121,0.41,0.3582,85,715,800,715
12542,6/11/2012,2,1,6,18,0,1,1,2,0.8,0.7273,0.43,0.2985,105,726,831,726
12543,6/11/2012,2,1,6,19,0,1,1,2,0.76,0.6818,0.48,0.3284,89,507,596,507
12544,6/11/2012,2,1,6,20,0,1,1,2,0.74,0.6667,0.48,0.2239,61,333,394,333
12545,6/11/2012,2,1,6,21,0,1,1,2,0.72,0.6667,0.58,0.194,32,218,250,218
12546,6/11/2012,2,1,6,22,0,1,1,2,0.72,0.6667,0.58,0.194,22,142,164,142
12547,6/11/2012,2,1,6,23,0,1,1,2,0.7,0.6515,0.58,0.2239,8,72,80,72
12548,6/12/2012,2,1,6,0,0,2,1,2,0.7,0.6515,0.58,0.2239,2,26,28,26
12549,6/12/2012,2,1,6,1,0,2,1,2,0.68,0.6364,0.65,0.1642,5,11,16,11
12550,6/12/2012,2,1,6,2,0,2,1,2,0.68,0.6364,0.65,0.194,0,6,6,6
12551,6/12/2012,2,1,6,3,0,2,1,2,0.66,0.6212,0.69,0.2537,3,9,12,9
12552,6/12/2012,2,1,6,4,0,2,1,3,0.6,0.5455,0.88,0.1642,0,4,4,4
12553,6/12/2012,2,1,6,5,0,2,1,3,0.6,0.5455,0.88,0.1343,1,28,29,28
12554,6/12/2012,2,1,6,6,0,2,1,2,0.6,0.5455,0.88,0.1343,6,130,136,130
12555,6/12/2012,2,1,6,7,0,2,1,3,0.62,0.5606,0.88,0.2537,16,287,303,287
12556,6/12/2012,2,1,6,8,0,2,1,2,0.62,0.5606,0.88,0.2239,15,598,613,598
12557,6/12/2012,2,1,6,9,0,2,1,2,0.64,0.5758,0.89,0.2836,31,254,285,254
12558,6/12/2012,2,1,6,10,0,2,1,3,0.64,0.5758,0.89,0.2836,29,96,125,96
12559,6/12/2012,2,1,6,11,0,2,1,3,0.66,0.6061,0.83,0.3582,8,57,65,57
12560,6/12/2012,2,1,6,12,0,2,1,3,0.66,0.6061,0.83,0.2537,19,76,95,76
12561,6/12/2012,2,1,6,13,0,2,1,3,0.66,0.6061,0.83,0.194,11,48,59,48
12562,6/12/2012,2,1,6,14,0,2,1,3,0.64,0.5758,0.89,0.2537,12,48,60,48
12563,6/12/2012,2,1,6,15,0,2,1,3,0.66,0.5909,0.89,0.194,22,94,116,94
12564,6/12/2012,2,1,6,16,0,2,1,2,0.66,0.5909,0.89,0.2836,30,209,239,209
12565,6/12/2012,2,1,6,17,0,2,1,2,0.66,0.5909,0.89,0.2836,56,625,681,625
12566,6/12/2012,2,1,6,18,0,2,1,1,0.68,0.6364,0.83,0.194,57,596,653,596
12567,6/12/2012,2,1,6,19,0,2,1,1,0.68,0.6364,0.83,0.194,47,444,491,444
12568,6/12/2012,2,1,6,20,0,2,1,1,0.68,0.6364,0.83,0.194,36,350,386,350
12569,6/12/2012,2,1,6,21,0,2,1,1,0.68,0.6364,0.83,0.1045,41,233,274,233
12570,6/12/2012,2,1,6,22,0,2,1,1,0.66,0.5909,0.94,0.1045,19,188,207,188
12571,6/12/2012,2,1,6,23,0,2,1,3,0.66,0.5909,0.94,0.2239,11,78,89,78
12572,6/13/2012,2,1,6,0,0,3,1,2,0.66,0.5909,0.94,0.194,7,27,34,27
12573,6/13/2012,2,1,6,1,0,3,1,1,0.64,0.5909,0.78,0,7,21,28,21
12574,6/13/2012,2,1,6,2,0,3,1,1,0.62,0.5758,0.83,0.1343,0,4,4,4
12575,6/13/2012,2,1,6,3,0,3,1,1,0.62,0.5758,0.83,0.194,1,7,8,7
12576,6/13/2012,2,1,6,4,0,3,1,1,0.6,0.5606,0.83,0.1343,1,9,10,9
12577,6/13/2012,2,1,6,5,0,3,1,1,0.6,0.5606,0.83,0.194,2,38,40,38
12578,6/13/2012,2,1,6,6,0,3,1,1,0.6,0.5606,0.83,0.2239,6,188,194,188
12579,6/13/2012,2,1,6,7,0,3,1,1,0.6,0.5606,0.83,0.2985,25,480,505,480
12580,6/13/2012,2,1,6,8,0,3,1,2,0.62,0.5909,0.73,0.5224,41,672,713,672
12581,6/13/2012,2,1,6,9,0,3,1,2,0.64,0.6061,0.69,0.5821,54,298,352,298
12582,6/13/2012,2,1,6,10,0,3,1,2,0.64,0.6061,0.65,0.4179,64,134,198,134
12583,6/13/2012,2,1,6,11,0,3,1,2,0.66,0.6212,0.54,0.4478,64,182,246,182
12584,6/13/2012,2,1,6,12,0,3,1,2,0.68,0.6364,0.44,0.4179,93,241,334,241
12585,6/13/2012,2,1,6,13,0,3,1,2,0.7,0.6364,0.45,0.3881,52,203,255,203
12586,6/13/2012,2,1,6,14,0,3,1,2,0.72,0.6515,0.37,0.4179,98,222,320,222
12587,6/13/2012,2,1,6,15,0,3,1,1,0.72,0.6515,0.32,0.4925,65,216,281,216
12588,6/13/2012,2,1,6,16,0,3,1,1,0.72,0.6515,0.3,0.4925,72,320,392,320
12589,6/13/2012,2,1,6,17,0,3,1,1,0.72,0.6515,0.32,0.4925,75,782,857,782
12590,6/13/2012,2,1,6,18,0,3,1,1,0.72,0.6515,0.32,0.4478,104,640,744,640
12591,6/13/2012,2,1,6,19,0,3,1,1,0.7,0.6364,0.34,0.3881,123,548,671,548
12592,6/13/2012,2,1,6,20,0,3,1,1,0.68,0.6364,0.36,0.4179,86,362,448,362
12593,6/13/2012,2,1,6,21,0,3,1,1,0.64,0.6212,0.44,0.3582,79,317,396,317
12594,6/13/2012,2,1,6,22,0,3,1,1,0.62,0.6212,0.5,0.2985,29,209,238,209
12595,6/13/2012,2,1,6,23,0,3,1,1,0.62,0.6212,0.5,0.2836,25,128,153,128
12596,6/14/2012,2,1,6,0,0,4,1,1,0.6,0.6212,0.53,0.2985,3,45,48,45
12597,6/14/2012,2,1,6,1,0,4,1,1,0.6,0.6212,0.56,0.2239,4,17,21,17
12598,6/14/2012,2,1,6,2,0,4,1,2,0.62,0.6212,0.53,0.2537,1,8,9,8
12599,6/14/2012,2,1,6,3,0,4,1,2,0.62,0.6212,0.53,0.2836,1,4,5,4
12600,6/14/2012,2,1,6,4,0,4,1,2,0.6,0.6212,0.56,0.2537,0,6,6,6
12601,6/14/2012,2,1,6,5,0,4,1,2,0.6,0.6212,0.56,0.2537,0,40,40,40
12602,6/14/2012,2,1,6,6,0,4,1,1,0.58,0.5455,0.6,0.2836,12,169,181,169
12603,6/14/2012,2,1,6,7,0,4,1,1,0.6,0.6061,0.6,0.2836,26,480,506,480
12604,6/14/2012,2,1,6,8,0,4,1,1,0.6,0.6061,0.64,0.3284,37,682,719,682
12605,6/14/2012,2,1,6,9,0,4,1,1,0.62,0.6061,0.61,0.2239,45,312,357,312
12606,6/14/2012,2,1,6,10,0,4,1,1,0.64,0.6061,0.65,0.4179,47,132,179,132
12607,6/14/2012,2,1,6,11,0,4,1,1,0.66,0.6212,0.57,0.2537,60,168,228,168
12608,6/14/2012,2,1,6,12,0,4,1,2,0.66,0.6212,0.61,0.2239,55,210,265,210
12609,6/14/2012,2,1,6,13,0,4,1,1,0.68,0.6364,0.57,0.1642,71,213,284,213
12610,6/14/2012,2,1,6,14,0,4,1,1,0.7,0.6515,0.54,0.2836,84,214,298,214
12611,6/14/2012,2,1,6,15,0,4,1,1,0.74,0.6667,0.48,0.2985,111,213,324,213
12612,6/14/2012,2,1,6,16,0,4,1,1,0.72,0.6667,0.51,0.2836,70,368,438,368
12613,6/14/2012,2,1,6,17,0,4,1,1,0.72,0.6667,0.48,0.2239,117,750,867,750
12614,6/14/2012,2,1,6,18,0,4,1,1,0.74,0.6667,0.42,0.194,107,716,823,716
12615,6/14/2012,2,1,6,19,0,4,1,1,0.7,0.6515,0.48,0.2537,96,483,579,483
12616,6/14/2012,2,1,6,20,0,4,1,1,0.66,0.6212,0.65,0.2537,84,351,435,351
12617,6/14/2012,2,1,6,21,0,4,1,1,0.64,0.6061,0.65,0.1642,67,270,337,270
12618,6/14/2012,2,1,6,22,0,4,1,2,0.64,0.6061,0.65,0.2239,46,196,242,196
12619,6/14/2012,2,1,6,23,0,4,1,2,0.62,0.6061,0.69,0.1642,36,136,172,136
12620,6/15/2012,2,1,6,0,0,5,1,1,0.6,0.5909,0.73,0.1642,26,68,94,68
12621,6/15/2012,2,1,6,1,0,5,1,1,0.58,0.5455,0.78,0.194,9,42,51,42
12622,6/15/2012,2,1,6,2,0,5,1,1,0.56,0.5303,0.83,0.1045,0,15,15,15
12623,6/15/2012,2,1,6,3,0,5,1,1,0.56,0.5303,0.83,0.1642,2,3,5,3
12624,6/15/2012,2,1,6,4,0,5,1,1,0.56,0.5303,0.83,0.1642,1,13,14,13
12625,6/15/2012,2,1,6,5,0,5,1,1,0.54,0.5152,0.88,0.1045,2,31,33,31
12626,6/15/2012,2,1,6,6,0,5,1,1,0.54,0.5152,0.83,0.1343,9,142,151,142
12627,6/15/2012,2,1,6,7,0,5,1,1,0.56,0.5303,0.83,0.1642,17,413,430,413
12628,6/15/2012,2,1,6,8,0,5,1,1,0.6,0.5909,0.69,0.1642,44,609,653,609
12629,6/15/2012,2,1,6,9,0,5,1,1,0.62,0.6061,0.65,0.1642,58,308,366,308
12630,6/15/2012,2,1,6,10,0,5,1,1,0.64,0.6212,0.57,0.1642,56,160,216,160
12631,6/15/2012,2,1,6,11,0,5,1,1,0.66,0.6212,0.5,0.194,106,180,286,180
12632,6/15/2012,2,1,6,12,0,5,1,1,0.7,0.6364,0.45,0.1642,111,292,403,292
12633,6/15/2012,2,1,6,13,0,5,1,1,0.7,0.6364,0.42,0.2537,121,272,393,272
12634,6/15/2012,2,1,6,14,0,5,1,1,0.72,0.6515,0.39,0.194,121,255,376,255
12635,6/15/2012,2,1,6,15,0,5,1,1,0.72,0.6515,0.39,0.194,107,270,377,270
12636,6/15/2012,2,1,6,16,0,5,1,1,0.72,0.6515,0.37,0.194,132,426,558,426
12637,6/15/2012,2,1,6,17,0,5,1,1,0.74,0.6515,0.37,0.2836,125,698,823,698
12638,6/15/2012,2,1,6,18,0,5,1,1,0.72,0.6515,0.39,0.2239,121,572,693,572
12639,6/15/2012,2,1,6,19,0,5,1,1,0.7,0.6364,0.42,0.1642,98,369,467,369
12640,6/15/2012,2,1,6,20,0,5,1,1,0.68,0.6364,0.44,0.194,89,296,385,296
12641,6/15/2012,2,1,6,21,0,5,1,1,0.66,0.6212,0.5,0.1045,83,250,333,250
12642,6/15/2012,2,1,6,22,0,5,1,1,0.64,0.6212,0.53,0.1343,79,242,321,242
12643,6/15/2012,2,1,6,23,0,5,1,1,0.62,0.6212,0.53,0.2537,46,176,222,176
12644,6/16/2012,2,1,6,0,0,6,0,1,0.58,0.5455,0.56,0.1343,25,112,137,112
12645,6/16/2012,2,1,6,1,0,6,0,1,0.56,0.5303,0.56,0,16,79,95,79
12646,6/16/2012,2,1,6,2,0,6,0,1,0.58,0.5455,0.53,0,12,55,67,55
12647,6/16/2012,2,1,6,3,0,6,0,1,0.56,0.5303,0.6,0.0896,8,19,27,19
12648,6/16/2012,2,1,6,4,0,6,0,1,0.54,0.5152,0.68,0.1343,3,5,8,5
12649,6/16/2012,2,1,6,5,0,6,0,1,0.54,0.5152,0.68,0.1045,2,21,23,21
12650,6/16/2012,2,1,6,6,0,6,0,1,0.54,0.5152,0.68,0.194,11,36,47,36
12651,6/16/2012,2,1,6,7,0,6,0,1,0.54,0.5152,0.68,0.194,10,68,78,68
12652,6/16/2012,2,1,6,8,0,6,0,1,0.58,0.5455,0.64,0.1642,47,157,204,157
12653,6/16/2012,2,1,6,9,0,6,0,1,0.6,0.6061,0.6,0.0896,88,279,367,279
12654,6/16/2012,2,1,6,10,0,6,0,1,0.64,0.6212,0.47,0.194,139,296,435,296
12655,6/16/2012,2,1,6,11,0,6,0,1,0.66,0.6212,0.39,0.1642,213,353,566,353
12656,6/16/2012,2,1,6,12,0,6,0,1,0.68,0.6364,0.41,0.1045,254,349,603,349
12657,6/16/2012,2,1,6,13,0,6,0,1,0.72,0.6515,0.34,0.1642,293,324,617,324
12658,6/16/2012,2,1,6,14,0,6,0,1,0.72,0.6515,0.37,0.2239,264,309,573,309
12659,6/16/2012,2,1,6,15,0,6,0,1,0.74,0.6515,0.35,0.2537,295,288,583,288
12660,6/16/2012,2,1,6,16,0,6,0,2,0.72,0.6515,0.37,0.1045,238,304,542,304
12661,6/16/2012,2,1,6,17,0,6,0,2,0.72,0.6515,0.37,0.2537,244,349,593,349
12662,6/16/2012,2,1,6,18,0,6,0,2,0.72,0.6515,0.37,0.2239,256,315,571,315
12663,6/16/2012,2,1,6,19,0,6,0,2,0.7,0.6364,0.42,0.194,184,277,461,277
12664,6/16/2012,2,1,6,20,0,6,0,2,0.66,0.6212,0.47,0.194,123,229,352,229
12665,6/16/2012,2,1,6,21,0,6,0,2,0.64,0.6212,0.5,0.2239,98,192,290,192
12666,6/16/2012,2,1,6,22,0,6,0,1,0.62,0.6212,0.53,0.2985,91,189,280,189
12667,6/16/2012,2,1,6,23,0,6,0,1,0.6,0.6212,0.53,0.2985,49,134,183,134
12668,6/17/2012,2,1,6,0,0,0,0,1,0.56,0.5303,0.56,0.1343,31,117,148,117
12669,6/17/2012,2,1,6,1,0,0,0,1,0.56,0.5303,0.6,0.1642,21,67,88,67
12670,6/17/2012,2,1,6,2,0,0,0,1,0.56,0.5303,0.56,0.0896,19,55,74,55
12671,6/17/2012,2,1,6,3,0,0,0,1,0.54,0.5152,0.64,0.1045,6,22,28,22
12672,6/17/2012,2,1,6,4,0,0,0,1,0.54,0.5152,0.64,0.0896,2,16,18,16
12673,6/17/2012,2,1,6,5,0,0,0,1,0.54,0.5152,0.68,0.1343,4,13,17,13
12674,6/17/2012,2,1,6,6,0,0,0,1,0.52,0.5,0.72,0.1045,7,16,23,16
12675,6/17/2012,2,1,6,7,0,0,0,1,0.52,0.5,0.72,0.0896,18,30,48,30
12676,6/17/2012,2,1,6,8,0,0,0,1,0.56,0.5303,0.68,0.2537,24,95,119,95
12677,6/17/2012,2,1,6,9,0,0,0,1,0.56,0.5303,0.68,0.1642,91,183,274,183
12678,6/17/2012,2,1,6,10,0,0,0,1,0.58,0.5455,0.64,0,148,288,436,288
12679,6/17/2012,2,1,6,11,0,0,0,1,0.62,0.6212,0.57,0.1045,196,350,546,350
12680,6/17/2012,2,1,6,12,0,0,0,1,0.62,0.6212,0.57,0,260,355,615,355
12681,6/17/2012,2,1,6,13,0,0,0,1,0.64,0.6212,0.53,0.1642,267,347,614,347
12682,6/17/2012,2,1,6,14,0,0,0,1,0.64,0.6212,0.53,0,255,327,582,327
12683,6/17/2012,2,1,6,15,0,0,0,1,0.66,0.6212,0.5,0.2239,203,260,463,260
12684,6/17/2012,2,1,6,16,0,0,0,1,0.66,0.6212,0.54,0.2985,240,340,580,340
12685,6/17/2012,2,1,6,17,0,0,0,1,0.64,0.6212,0.57,0.2239,232,361,593,361
12686,6/17/2012,2,1,6,18,0,0,0,1,0.64,0.6212,0.53,0.194,203,310,513,310
12687,6/17/2012,2,1,6,19,0,0,0,1,0.64,0.6212,0.53,0.1642,146,244,390,244
12688,6/17/2012,2,1,6,20,0,0,0,1,0.62,0.6212,0.57,0.194,101,201,302,201
12689,6/17/2012,2,1,6,21,0,0,0,1,0.62,0.6212,0.57,0.194,76,170,246,170
12690,6/17/2012,2,1,6,22,0,0,0,1,0.6,0.6061,0.6,0.194,55,98,153,98
12691,6/17/2012,2,1,6,23,0,0,0,1,0.58,0.5455,0.64,0.194,29,79,108,79
12692,6/18/2012,2,1,6,0,0,1,1,1,0.56,0.5303,0.73,0.2537,12,28,40,28
12693,6/18/2012,2,1,6,1,0,1,1,1,0.54,0.5152,0.77,0.2239,9,5,14,5
12694,6/18/2012,2,1,6,2,0,1,1,1,0.54,0.5152,0.77,0.2239,3,6,9,6
12695,6/18/2012,2,1,6,3,0,1,1,2,0.52,0.5,0.83,0.2239,1,3,4,3
12696,6/18/2012,2,1,6,4,0,1,1,2,0.54,0.5152,0.77,0.194,0,9,9,9
12697,6/18/2012,2,1,6,5,0,1,1,3,0.52,0.5,0.83,0.1343,1,22,23,22
12698,6/18/2012,2,1,6,6,0,1,1,3,0.52,0.5,0.88,0.1343,0,37,37,37
12699,6/18/2012,2,1,6,7,0,1,1,3,0.52,0.5,0.94,0.2239,10,135,145,135
12700,6/18/2012,2,1,6,8,0,1,1,2,0.54,0.5152,0.83,0.194,27,447,474,447
12701,6/18/2012,2,1,6,9,0,1,1,2,0.54,0.5152,0.83,0.2239,28,222,250,222
12702,6/18/2012,2,1,6,10,0,1,1,3,0.54,0.5152,0.88,0.1045,13,78,91,78
12703,6/18/2012,2,1,6,11,0,1,1,2,0.54,0.5152,0.88,0.1642,25,96,121,96
12704,6/18/2012,2,1,6,12,0,1,1,3,0.56,0.5303,0.78,0.1343,29,139,168,139
12705,6/18/2012,2,1,6,13,0,1,1,2,0.58,0.5455,0.73,0.1343,51,174,225,174
12706,6/18/2012,2,1,6,14,0,1,1,2,0.58,0.5455,0.68,0.194,59,160,219,160
12707,6/18/2012,2,1,6,15,0,1,1,2,0.6,0.5909,0.69,0.194,61,176,237,176
12708,6/18/2012,2,1,6,16,0,1,1,2,0.6,0.5909,0.73,0.194,53,279,332,279
12709,6/18/2012,2,1,6,17,0,1,1,2,0.6,0.5909,0.73,0.194,54,669,723,669
12710,6/18/2012,2,1,6,18,0,1,1,2,0.62,0.6061,0.69,0.1642,47,595,642,595
12711,6/18/2012,2,1,6,19,0,1,1,2,0.62,0.5909,0.73,0.0896,52,411,463,411
12712,6/18/2012,2,1,6,20,0,1,1,2,0.62,0.5909,0.73,0.1343,45,317,362,317
12713,6/18/2012,2,1,6,21,0,1,1,2,0.62,0.5909,0.73,0.1045,35,238,273,238
12714,6/18/2012,2,1,6,22,0,1,1,2,0.62,0.5909,0.73,0.1642,21,143,164,143
12715,6/18/2012,2,1,6,23,0,1,1,3,0.6,0.5758,0.78,0.194,17,57,74,57
12716,6/19/2012,2,1,6,0,0,2,1,2,0.6,0.5758,0.78,0.1642,5,30,35,30
12717,6/19/2012,2,1,6,1,0,2,1,2,0.6,0.5758,0.78,0.1642,1,13,14,13
12718,6/19/2012,2,1,6,2,0,2,1,2,0.6,0.5758,0.78,0.1343,1,14,15,14
12719,6/19/2012,2,1,6,3,0,2,1,2,0.6,0.5758,0.78,0.1045,1,7,8,7
12720,6/19/2012,2,1,6,4,0,2,1,2,0.6,0.5758,0.78,0.1343,1,9,10,9
12721,6/19/2012,2,1,6,5,0,2,1,2,0.6,0.5758,0.78,0.194,3,34,37,34
12722,6/19/2012,2,1,6,6,0,2,1,2,0.6,0.5758,0.78,0.1045,9,152,161,152
12723,6/19/2012,2,1,6,7,0,2,1,2,0.6,0.5758,0.78,0.1343,18,462,480,462
12724,6/19/2012,2,1,6,8,0,2,1,2,0.6,0.5758,0.78,0.1642,40,633,673,633
12725,6/19/2012,2,1,6,9,0,2,1,1,0.64,0.6061,0.73,0.0896,40,288,328,288
12726,6/19/2012,2,1,6,10,0,2,1,1,0.64,0.6061,0.73,0.0896,44,136,180,136
12727,6/19/2012,2,1,6,11,0,2,1,1,0.66,0.6212,0.69,0.1343,56,174,230,174
12728,6/19/2012,2,1,6,12,0,2,1,1,0.7,0.6515,0.65,0.0896,70,222,292,222
12729,6/19/2012,2,1,6,13,0,2,1,1,0.74,0.6818,0.58,0.1343,69,203,272,203
12730,6/19/2012,2,1,6,14,0,2,1,1,0.76,0.7121,0.58,0.1045,61,166,227,166
12731,6/19/2012,2,1,6,15,0,2,1,1,0.78,0.7424,0.59,0.1642,72,187,259,187
12732,6/19/2012,2,1,6,16,0,2,1,1,0.8,0.7576,0.55,0.2239,48,286,334,286
12733,6/19/2012,2,1,6,17,0,2,1,1,0.8,0.7576,0.55,0.194,86,725,811,725
12734,6/19/2012,2,1,6,18,0,2,1,1,0.8,0.7576,0.55,0.1642,91,704,795,704
12735,6/19/2012,2,1,6,19,0,2,1,1,0.8,0.7727,0.59,0.2239,82,432,514,432
12736,6/19/2012,2,1,6,20,0,2,1,1,0.8,0.7576,0.55,0.2537,59,399,458,399
12737,6/19/2012,2,1,6,21,0,2,1,1,0.76,0.7121,0.62,0.1642,37,239,276,239
12738,6/19/2012,2,1,6,22,0,2,1,1,0.72,0.697,0.79,0.0896,51,240,291,240
12739,6/19/2012,2,1,6,23,0,2,1,1,0.72,0.697,0.79,0.1343,23,102,125,102
12740,6/20/2012,2,1,6,0,0,3,1,1,0.7,0.6667,0.79,0.194,5,48,53,48
12741,6/20/2012,2,1,6,1,0,3,1,1,0.68,0.6364,0.79,0.194,7,20,27,20
12742,6/20/2012,2,1,6,2,0,3,1,1,0.66,0.6061,0.83,0.1642,1,5,6,5
12743,6/20/2012,2,1,6,3,0,3,1,1,0.66,0.6061,0.83,0.1343,2,6,8,6
12744,6/20/2012,2,1,6,4,0,3,1,1,0.66,0.6061,0.83,0.0896,1,6,7,6
12745,6/20/2012,2,1,6,5,0,3,1,1,0.66,0.6061,0.83,0.0896,2,37,39,37
12746,6/20/2012,2,1,6,6,0,3,1,2,0.64,0.5758,0.89,0.0896,9,156,165,156
12747,6/20/2012,2,1,6,7,0,3,1,2,0.66,0.5909,0.89,0,20,444,464,444
12748,6/20/2012,2,1,6,8,0,3,1,2,0.7,0.6667,0.79,0.1045,43,600,643,600
12749,6/20/2012,2,1,6,9,0,3,1,2,0.72,0.697,0.74,0,40,276,316,276
12750,6/20/2012,2,1,6,10,0,3,1,1,0.82,0.7727,0.52,0.1343,41,126,167,126
12751,6/20/2012,2,1,6,11,0,3,1,1,0.84,0.7879,0.49,0.194,54,134,188,134
12752,6/20/2012,2,1,6,12,0,3,1,1,0.86,0.803,0.47,0.1642,30,150,180,150
12753,6/20/2012,2,1,6,13,0,3,1,1,0.86,0.7879,0.44,0.1045,48,163,211,163
12754,6/20/2012,2,1,6,14,0,3,1,1,0.88,0.803,0.39,0.194,56,134,190,134
12755,6/20/2012,2,1,6,15,0,3,1,1,0.9,0.8182,0.35,0,36,143,179,143
12756,6/20/2012,2,1,6,16,0,3,1,1,0.9,0.8182,0.35,0.1045,51,284,335,284
12757,6/20/2012,2,1,6,17,0,3,1,1,0.9,0.8182,0.37,0,80,611,691,611
12758,6/20/2012,2,1,6,18,0,3,1,1,0.9,0.8182,0.37,0,81,591,672,591
12759,6/20/2012,2,1,6,19,0,3,1,1,0.88,0.7879,0.37,0.2537,90,449,539,449
12760,6/20/2012,2,1,6,20,0,3,1,1,0.86,0.7727,0.39,0.2239,81,326,407,326
12761,6/20/2012,2,1,6,21,0,3,1,1,0.84,0.7576,0.44,0.0896,42,302,344,302
12762,6/20/2012,2,1,6,22,0,3,1,1,0.82,0.7576,0.46,0.1045,31,226,257,226
12763,6/20/2012,2,1,6,23,0,3,1,1,0.78,0.7424,0.59,0.1045,21,102,123,102
12764,6/21/2012,3,1,6,0,0,4,1,1,0.74,0.697,0.7,0.0896,16,53,69,53
12765,6/21/2012,3,1,6,1,0,4,1,1,0.72,0.697,0.79,0.1343,2,16,18,16
12766,6/21/2012,3,1,6,2,0,4,1,1,0.72,0.697,0.79,0.1045,11,7,18,7
12767,6/21/2012,3,1,6,3,0,4,1,1,0.72,0.697,0.74,0,3,8,11,8
12768,6/21/2012,3,1,6,4,0,4,1,1,0.7,0.6667,0.84,0.0896,1,11,12,11
12769,6/21/2012,3,1,6,5,0,4,1,1,0.7,0.6667,0.84,0.1045,3,37,40,37
12770,6/21/2012,3,1,6,6,0,4,1,2,0.7,0.6667,0.84,0.0896,3,147,150,147
12771,6/21/2012,3,1,6,7,0,4,1,2,0.7,0.6667,0.84,0.0896,26,437,463,437
12772,6/21/2012,3,1,6,8,0,4,1,1,0.74,0.697,0.7,0,27,563,590,563
12773,6/21/2012,3,1,6,9,0,4,1,1,0.8,0.7576,0.55,0.194,32,224,256,224
12774,6/21/2012,3,1,6,10,0,4,1,1,0.84,0.7879,0.49,0.1045,36,114,150,114
12775,6/21/2012,3,1,6,11,0,4,1,1,0.86,0.7879,0.41,0.1343,40,121,161,121
12776,6/21/2012,3,1,6,12,0,4,1,1,0.9,0.8182,0.35,0.194,33,182,215,182
12777,6/21/2012,3,1,6,13,0,4,1,1,0.9,0.8182,0.35,0,31,141,172,141
12778,6/21/2012,3,1,6,14,0,4,1,1,0.88,0.7879,0.37,0.1642,27,149,176,149
12779,6/21/2012,3,1,6,15,0,4,1,1,0.92,0.8333,0.33,0.1642,40,154,194,154
12780,6/21/2012,3,1,6,16,0,4,1,1,0.9,0.8182,0.35,0.1343,37,283,320,283
12781,6/21/2012,3,1,6,17,0,4,1,1,0.88,0.7879,0.37,0,80,535,615,535
12782,6/21/2012,3,1,6,18,0,4,1,1,0.86,0.7879,0.41,0.194,78,562,640,562
12783,6/21/2012,3,1,6,19,0,4,1,1,0.88,0.803,0.39,0.2239,84,415,499,415
12784,6/21/2012,3,1,6,20,0,4,1,1,0.86,0.7879,0.44,0.194,79,357,436,357
12785,6/21/2012,3,1,6,21,0,4,1,1,0.82,0.7727,0.52,0.194,55,256,311,256
12786,6/21/2012,3,1,6,22,0,4,1,1,0.8,0.7879,0.63,0.1642,22,221,243,221
12787,6/21/2012,3,1,6,23,0,4,1,1,0.8,0.7727,0.59,0.0896,12,134,146,134
12788,6/22/2012,3,1,6,0,0,5,1,2,0.76,0.7273,0.7,0.1045,16,77,93,77
12789,6/22/2012,3,1,6,1,0,5,1,1,0.76,0.7424,0.75,0.1642,3,28,31,28
12790,6/22/2012,3,1,6,2,0,5,1,1,0.74,0.7121,0.79,0,0,12,12,12
12791,6/22/2012,3,1,6,3,0,5,1,1,0.74,0.7121,0.79,0,1,6,7,6
12792,6/22/2012,3,1,6,4,0,5,1,2,0.76,0.7273,0.66,0,3,7,10,7
12793,6/22/2012,3,1,6,5,0,5,1,2,0.74,0.697,0.66,0.0896,3,35,38,35
12794,6/22/2012,3,1,6,6,0,5,1,2,0.74,0.697,0.66,0,4,118,122,118
12795,6/22/2012,3,1,6,7,0,5,1,1,0.74,0.6818,0.58,0.1642,19,340,359,340
12796,6/22/2012,3,1,6,8,0,5,1,1,0.76,0.697,0.55,0.1343,49,564,613,564
12797,6/22/2012,3,1,6,9,0,5,1,1,0.76,0.7121,0.58,0.2239,55,278,333,278
12798,6/22/2012,3,1,6,10,0,5,1,1,0.8,0.7424,0.52,0.3582,52,133,185,133
12799,6/22/2012,3,1,6,11,0,5,1,1,0.8,0.7424,0.49,0.1642,76,160,236,160
12800,6/22/2012,3,1,6,12,0,5,1,1,0.84,0.7879,0.49,0.1343,63,191,254,191
12801,6/22/2012,3,1,6,13,0,5,1,1,0.88,0.803,0.39,0.2239,72,228,300,228
12802,6/22/2012,3,1,6,14,0,5,1,1,0.88,0.803,0.39,0.2239,65,198,263,198
12803,6/22/2012,3,1,6,15,0,5,1,1,0.9,0.8182,0.35,0.3582,72,212,284,212
12804,6/22/2012,3,1,6,16,0,5,1,1,0.9,0.803,0.31,0.2239,67,313,380,313
12805,6/22/2012,3,1,6,17,0,5,1,2,0.82,0.7273,0.38,0.1642,95,551,646,551
12806,6/22/2012,3,1,6,18,0,5,1,2,0.8,0.7576,0.55,0.194,62,443,505,443
12807,6/22/2012,3,1,6,19,0,5,1,2,0.76,0.697,0.55,0.5224,45,317,362,317
12808,6/22/2012,3,1,6,20,0,5,1,2,0.76,0.697,0.55,0.5224,31,171,202,171
12809,6/22/2012,3,1,6,21,0,5,1,3,0.68,0.6364,0.65,0.2836,40,177,217,177
12810,6/22/2012,3,1,6,22,0,5,1,1,0.68,0.6364,0.69,0.1343,42,155,197,155
12811,6/22/2012,3,1,6,23,0,5,1,2,0.66,0.6212,0.74,0,29,145,174,145
12812,6/23/2012,3,1,6,0,0,6,0,1,0.64,0.5758,0.83,0,14,102,116,102
12813,6/23/2012,3,1,6,1,0,6,0,1,0.66,0.6061,0.78,0.1343,16,107,123,107
12814,6/23/2012,3,1,6,2,0,6,0,2,0.64,0.5758,0.83,0.194,18,75,93,75
12815,6/23/2012,3,1,6,3,0,6,0,2,0.64,0.5758,0.83,0.0896,10,32,42,32
12816,6/23/2012,3,1,6,4,0,6,0,2,0.64,0.5758,0.83,0.1642,6,13,19,13
12817,6/23/2012,3,1,6,5,0,6,0,2,0.64,0.5758,0.83,0.194,1,11,12,11
12818,6/23/2012,3,1,6,6,0,6,0,1,0.64,0.5758,0.83,0.0896,10,37,47,37
12819,6/23/2012,3,1,6,7,0,6,0,1,0.64,0.5758,0.83,0.1642,19,59,78,59
12820,6/23/2012,3,1,6,8,0,6,0,1,0.68,0.6364,0.69,0.2239,34,133,167,133
12821,6/23/2012,3,1,6,9,0,6,0,1,0.72,0.6818,0.62,0.194,85,247,332,247
12822,6/23/2012,3,1,6,10,0,6,0,1,0.74,0.6818,0.55,0.194,177,317,494,317
12823,6/23/2012,3,1,6,11,0,6,0,1,0.76,0.6818,0.48,0.2239,167,349,516,349
12824,6/23/2012,3,1,6,12,0,6,0,1,0.8,0.7273,0.43,0.194,203,399,602,399
12825,6/23/2012,3,1,6,13,0,6,0,1,0.82,0.7273,0.34,0.194,226,338,564,338
12826,6/23/2012,3,1,6,14,0,6,0,1,0.78,0.6818,0.33,0.2537,238,371,609,371
12827,6/23/2012,3,1,6,15,0,6,0,1,0.84,0.7273,0.3,0.3284,217,266,483,266
12828,6/23/2012,3,1,6,16,0,6,0,1,0.84,0.7121,0.26,0.2985,196,317,513,317
12829,6/23/2012,3,1,6,17,0,6,0,1,0.82,0.7121,0.26,0.2537,214,316,530,316
12830,6/23/2012,3,1,6,18,0,6,0,1,0.82,0.7121,0.26,0.2985,194,287,481,287
12831,6/23/2012,3,1,6,19,0,6,0,1,0.8,0.697,0.27,0.194,185,240,425,240
12832,6/23/2012,3,1,6,20,0,6,0,1,0.78,0.6818,0.31,0.194,158,228,386,228
12833,6/23/2012,3,1,6,21,0,6,0,1,0.76,0.6667,0.33,0.1343,99,223,322,223
12834,6/23/2012,3,1,6,22,0,6,0,1,0.74,0.6515,0.37,0.1045,101,178,279,178
12835,6/23/2012,3,1,6,23,0,6,0,1,0.72,0.6515,0.44,0,69,156,225,156
12836,6/24/2012,3,1,6,0,0,0,0,1,0.7,0.6515,0.51,0,31,132,163,132
12837,6/24/2012,3,1,6,1,0,0,0,2,0.68,0.6364,0.54,0.0896,39,88,127,88
12838,6/24/2012,3,1,6,2,0,0,0,2,0.68,0.6364,0.51,0,34,80,114,80
12839,6/24/2012,3,1,6,3,0,0,0,2,0.66,0.6212,0.65,0.0896,19,41,60,41
12840,6/24/2012,3,1,6,4,0,0,0,2,0.66,0.6212,0.65,0,4,9,13,9
12841,6/24/2012,3,1,6,5,0,0,0,1,0.62,0.6061,0.69,0.1343,1,7,8,7
12842,6/24/2012,3,1,6,6,0,0,0,1,0.64,0.6061,0.65,0.1642,6,19,25,19
12843,6/24/2012,3,1,6,7,0,0,0,1,0.64,0.6061,0.69,0.1045,23,48,71,48
12844,6/24/2012,3,1,6,8,0,0,0,1,0.7,0.6515,0.58,0,38,103,141,103
12845,6/24/2012,3,1,6,9,0,0,0,1,0.72,0.6667,0.51,0,63,169,232,169
12846,6/24/2012,3,1,6,10,0,0,0,1,0.76,0.6818,0.4,0,161,291,452,291
12847,6/24/2012,3,1,6,11,0,0,0,1,0.76,0.6818,0.4,0.1343,215,291,506,291
12848,6/24/2012,3,1,6,12,0,0,0,1,0.8,0.697,0.33,0.2239,227,329,556,329
12849,6/24/2012,3,1,6,13,0,0,0,1,0.8,0.697,0.33,0.2836,237,348,585,348
12850,6/24/2012,3,1,6,14,0,0,0,1,0.84,0.7273,0.3,0.2985,253,298,551,298
12851,6/24/2012,3,1,6,15,0,0,0,1,0.86,0.7424,0.28,0.2239,197,290,487,290
12852,6/24/2012,3,1,6,16,0,0,0,1,0.84,0.7273,0.3,0.2537,181,280,461,280
12853,6/24/2012,3,1,6,17,0,0,0,1,0.84,0.7273,0.32,0.2537,203,329,532,329
12854,6/24/2012,3,1,6,18,0,0,0,1,0.82,0.7273,0.34,0.2537,186,348,534,348
12855,6/24/2012,3,1,6,19,0,0,0,1,0.8,0.7121,0.38,0.2985,176,247,423,247
12856,6/24/2012,3,1,6,20,0,0,0,1,0.78,0.697,0.46,0.2537,108,224,332,224
12857,6/24/2012,3,1,6,21,0,0,0,1,0.76,0.697,0.55,0.2239,76,177,253,177
12858,6/24/2012,3,1,6,22,0,0,0,1,0.74,0.6818,0.55,0.1045,53,125,178,125
12859,6/24/2012,3,1,6,23,0,0,0,1,0.74,0.6818,0.58,0.1045,20,67,87,67
12860,6/25/2012,3,1,6,0,0,1,1,1,0.72,0.6818,0.62,0.2537,31,37,68,37
12861,6/25/2012,3,1,6,1,0,1,1,1,0.7,0.6515,0.65,0.2239,11,20,31,20
12862,6/25/2012,3,1,6,2,0,1,1,1,0.7,0.6515,0.7,0.2239,4,10,14,10
12863,6/25/2012,3,1,6,3,0,1,1,1,0.68,0.6364,0.69,0.2537,1,4,5,4
12864,6/25/2012,3,1,6,4,0,1,1,1,0.66,0.6061,0.78,0.2537,0,4,4,4
12865,6/25/2012,3,1,6,5,0,1,1,1,0.66,0.6212,0.74,0.1642,1,42,43,42
12866,6/25/2012,3,1,6,6,0,1,1,1,0.64,0.5909,0.78,0.1642,11,147,158,147
12867,6/25/2012,3,1,6,7,0,1,1,1,0.66,0.6212,0.74,0.2239,30,455,485,455
12868,6/25/2012,3,1,6,8,0,1,1,1,0.66,0.6212,0.69,0.194,53,555,608,555
12869,6/25/2012,3,1,6,9,0,1,1,1,0.7,0.6515,0.65,0.194,37,231,268,231
12870,6/25/2012,3,1,6,10,0,1,1,1,0.76,0.697,0.55,0.1642,58,126,184,126
12871,6/25/2012,3,1,6,11,0,1,1,1,0.8,0.7273,0.43,0.3284,54,127,181,127
12872,6/25/2012,3,1,6,12,0,1,1,2,0.76,0.6818,0.45,0.2985,74,196,270,196
12873,6/25/2012,3,1,6,13,0,1,1,1,0.72,0.6667,0.51,0.2985,79,181,260,181
12874,6/25/2012,3,1,6,14,0,1,1,1,0.78,0.697,0.43,0.2537,90,161,251,161
12875,6/25/2012,3,1,6,15,0,1,1,1,0.78,0.6818,0.38,0.4627,65,168,233,168
12876,6/25/2012,3,1,6,16,0,1,1,1,0.8,0.697,0.31,0.3881,104,310,414,310
12877,6/25/2012,3,1,6,17,0,1,1,1,0.8,0.6818,0.24,0.4627,76,757,833,757
12878,6/25/2012,3,1,6,18,0,1,1,1,0.76,0.6667,0.27,0.4478,100,691,791,691
12879,6/25/2012,3,1,6,19,0,1,1,1,0.74,0.6515,0.27,0.4627,74,508,582,508
12880,6/25/2012,3,1,6,20,0,1,1,1,0.72,0.6515,0.3,0.4478,100,375,475,375
12881,6/25/2012,3,1,6,21,0,1,1,1,0.68,0.6212,0.3,0.3284,50,281,331,281
12882,6/25/2012,3,1,6,22,0,1,1,1,0.66,0.6212,0.29,0.3881,21,166,187,166
12883,6/25/2012,3,1,6,23,0,1,1,1,0.64,0.6212,0.33,0.3284,15,88,103,88
12884,6/26/2012,3,1,6,0,0,2,1,1,0.62,0.6212,0.33,0.3284,8,29,37,29
12885,6/26/2012,3,1,6,1,0,2,1,1,0.6,0.6212,0.35,0.3881,11,19,30,19
12886,6/26/2012,3,1,6,2,0,2,1,1,0.56,0.5303,0.43,0.2836,2,7,9,7
12887,6/26/2012,3,1,6,3,0,2,1,1,0.54,0.5152,0.45,0.2836,2,7,9,7
12888,6/26/2012,3,1,6,4,0,2,1,1,0.54,0.5152,0.45,0.2985,1,9,10,9
12889,6/26/2012,3,1,6,5,0,2,1,1,0.52,0.5,0.48,0.3881,3,36,39,36
12890,6/26/2012,3,1,6,6,0,2,1,1,0.52,0.5,0.52,0.2985,12,176,188,176
12891,6/26/2012,3,1,6,7,0,2,1,1,0.52,0.5,0.52,0.3582,21,531,552,531
12892,6/26/2012,3,1,6,8,0,2,1,1,0.56,0.5303,0.49,0.3284,34,622,656,622
12893,6/26/2012,3,1,6,9,0,2,1,1,0.58,0.5455,0.46,0.4179,30,298,328,298
12894,6/26/2012,3,1,6,10,0,2,1,1,0.62,0.6212,0.41,0.3582,37,153,190,153
12895,6/26/2012,3,1,6,11,0,2,1,1,0.64,0.6212,0.36,0.4179,46,189,235,189
12896,6/26/2012,3,1,6,12,0,2,1,1,0.66,0.6212,0.34,0.4478,80,228,308,228
12897,6/26/2012,3,1,6,13,0,2,1,1,0.7,0.6364,0.3,0.4627,74,232,306,232
12898,6/26/2012,3,1,6,14,0,2,1,1,0.7,0.6364,0.3,0.4627,81,186,267,186
12899,6/26/2012,3,1,6,15,0,2,1,1,0.72,0.6515,0.28,0.4627,88,229,317,229
12900,6/26/2012,3,1,6,16,0,2,1,1,0.72,0.6364,0.26,0.4925,67,349,416,349
12901,6/26/2012,3,1,6,17,0,2,1,1,0.72,0.6515,0.28,0.4179,104,796,900,796
12902,6/26/2012,3,1,6,18,0,2,1,1,0.72,0.6515,0.28,0.3582,105,719,824,719
12903,6/26/2012,3,1,6,19,0,2,1,1,0.72,0.6515,0.28,0.2239,83,529,612,529
12904,6/26/2012,3,1,6,20,0,2,1,1,0.7,0.6364,0.3,0.2836,88,417,505,417
12905,6/26/2012,3,1,6,21,0,2,1,1,0.68,0.6364,0.34,0.194,61,267,328,267
12906,6/26/2012,3,1,6,22,0,2,1,1,0.66,0.6212,0.34,0.2537,26,219,245,219
12907,6/26/2012,3,1,6,23,0,2,1,1,0.62,0.6212,0.41,0.1343,13,118,131,118
12908,6/27/2012,3,1,6,0,0,3,1,1,0.62,0.6212,0.41,0.194,15,39,54,39
12909,6/27/2012,3,1,6,1,0,3,1,1,0.6,0.6212,0.43,0.1642,5,18,23,18
12910,6/27/2012,3,1,6,2,0,3,1,1,0.56,0.5303,0.49,0.1343,2,12,14,12
12911,6/27/2012,3,1,6,3,0,3,1,1,0.58,0.5455,0.46,0.0896,1,7,8,7
12912,6/27/2012,3,1,6,4,0,3,1,1,0.6,0.6212,0.4,0.2537,0,11,11,11
12913,6/27/2012,3,1,6,5,0,3,1,1,0.6,0.6212,0.43,0.2836,2,34,36,34
12914,6/27/2012,3,1,6,6,0,3,1,1,0.58,0.5455,0.46,0.2836,7,193,200,193
12915,6/27/2012,3,1,6,7,0,3,1,1,0.6,0.6212,0.43,0.3582,29,498,527,498
12916,6/27/2012,3,1,6,8,0,3,1,1,0.62,0.6212,0.43,0.3284,49,638,687,638
12917,6/27/2012,3,1,6,9,0,3,1,1,0.66,0.6212,0.41,0.3582,29,253,282,253
12918,6/27/2012,3,1,6,10,0,3,1,1,0.7,0.6364,0.37,0.2537,34,138,172,138
12919,6/27/2012,3,1,6,11,0,3,1,1,0.74,0.6515,0.3,0.3284,64,145,209,145
12920,6/27/2012,3,1,6,12,0,3,1,1,0.76,0.6667,0.29,0.2985,77,245,322,245
12921,6/27/2012,3,1,6,13,0,3,1,1,0.8,0.697,0.27,0.3284,77,244,321,244
12922,6/27/2012,3,1,6,14,0,3,1,1,0.8,0.6818,0.24,0.3582,78,192,270,192
12923,6/27/2012,3,1,6,15,0,3,1,1,0.8,0.697,0.26,0.4627,61,188,249,188
12924,6/27/2012,3,1,6,16,0,3,1,1,0.82,0.697,0.24,0.4478,55,337,392,337
12925,6/27/2012,3,1,6,17,0,3,1,1,0.82,0.697,0.24,0.3881,113,730,843,730
12926,6/27/2012,3,1,6,18,0,3,1,1,0.8,0.697,0.27,0.3284,85,719,804,719
12927,6/27/2012,3,1,6,19,0,3,1,1,0.78,0.6818,0.29,0.3284,101,542,643,542
12928,6/27/2012,3,1,6,20,0,3,1,1,0.76,0.6667,0.31,0.194,76,369,445,369
12929,6/27/2012,3,1,6,21,0,3,1,1,0.74,0.6515,0.35,0.1343,54,313,367,313
12930,6/27/2012,3,1,6,22,0,3,1,1,0.72,0.6515,0.39,0.0896,52,245,297,245
12931,6/27/2012,3,1,6,23,0,3,1,1,0.68,0.6364,0.47,0.1343,11,148,159,148
12932,6/28/2012,3,1,6,0,0,4,1,1,0.66,0.6212,0.5,0.1045,2,52,54,52
12933,6/28/2012,3,1,6,1,0,4,1,1,0.66,0.6212,0.54,0,11,14,25,14
12934,6/28/2012,3,1,6,2,0,4,1,1,0.66,0.6212,0.5,0.0896,1,12,13,12
12935,6/28/2012,3,1,6,3,0,4,1,1,0.66,0.6212,0.5,0.0896,1,6,7,6
12936,6/28/2012,3,1,6,4,0,4,1,1,0.62,0.6061,0.61,0.1045,0,11,11,11
12937,6/28/2012,3,1,6,5,0,4,1,1,0.62,0.6212,0.57,0.0896,8,39,47,39
12938,6/28/2012,3,1,6,6,0,4,1,1,0.62,0.6212,0.57,0.0896,8,185,193,185
12939,6/28/2012,3,1,6,7,0,4,1,1,0.62,0.6061,0.61,0.1045,24,484,508,484
12940,6/28/2012,3,1,6,8,0,4,1,1,0.66,0.6212,0.5,0.1343,40,577,617,577
12941,6/28/2012,3,1,6,9,0,4,1,1,0.7,0.6515,0.54,0.1642,33,318,351,318
12942,6/28/2012,3,1,6,10,0,4,1,1,0.74,0.6667,0.48,0.194,40,144,184,144
12943,6/28/2012,3,1,6,11,0,4,1,1,0.8,0.697,0.31,0.194,41,170,211,170
12944,6/28/2012,3,1,6,12,0,4,1,1,0.84,0.7121,0.26,0.2836,49,227,276,227
12945,6/28/2012,3,1,6,13,0,4,1,1,0.86,0.7424,0.26,0.2239,31,205,236,205
12946,6/28/2012,3,1,6,14,0,4,1,1,0.86,0.7273,0.25,0.3284,66,188,254,188
12947,6/28/2012,3,1,6,15,0,4,1,1,0.86,0.7273,0.25,0.3284,24,195,219,195
12948,6/28/2012,3,1,6,16,0,4,1,1,0.88,0.7424,0.23,0.194,56,331,387,331
12949,6/28/2012,3,1,6,17,0,4,1,1,0.88,0.7424,0.22,0.194,71,634,705,634
12950,6/28/2012,3,1,6,18,0,4,1,1,0.86,0.7273,0.25,0.2239,100,597,697,597
12951,6/28/2012,3,1,6,19,0,4,1,1,0.84,0.7273,0.3,0.2985,79,492,571,492
12952,6/28/2012,3,1,6,20,0,4,1,1,0.82,0.7273,0.34,0.194,71,399,470,399
12953,6/28/2012,3,1,6,21,0,4,1,1,0.76,0.697,0.55,0.194,89,309,398,309
12954,6/28/2012,3,1,6,22,0,4,1,1,0.76,0.697,0.52,0.1642,50,224,274,224
12955,6/28/2012,3,1,6,23,0,4,1,1,0.74,0.6667,0.48,0.1343,26,145,171,145
12956,6/29/2012,3,1,6,0,0,5,1,1,0.74,0.6667,0.48,0.1343,24,90,114,90
12957,6/29/2012,3,1,6,1,0,5,1,1,0.74,0.6667,0.51,0.1642,9,33,42,33
12958,6/29/2012,3,1,6,2,0,5,1,1,0.72,0.6667,0.58,0.194,3,15,18,15
12959,6/29/2012,3,1,6,3,0,5,1,1,0.72,0.6667,0.58,0.194,3,5,8,5
12960,6/29/2012,3,1,6,4,0,5,1,1,0.7,0.6515,0.65,0.1642,1,9,10,9
12961,6/29/2012,3,1,6,5,0,5,1,1,0.7,0.6515,0.61,0.1045,6,39,45,39
12962,6/29/2012,3,1,6,6,0,5,1,2,0.7,0.6515,0.61,0.1642,15,148,163,148
12963,6/29/2012,3,1,6,7,0,5,1,1,0.7,0.6515,0.61,0.1045,19,361,380,361
12964,6/29/2012,3,1,6,8,0,5,1,2,0.74,0.6818,0.55,0.1045,48,576,624,576
12965,6/29/2012,3,1,6,9,0,5,1,1,0.76,0.697,0.55,0.1642,39,261,300,261
12966,6/29/2012,3,1,6,10,0,5,1,1,0.9,0.8333,0.39,0.2985,32,139,171,139
12967,6/29/2012,3,1,6,11,0,5,1,2,0.9,0.8485,0.42,0.2836,51,137,188,137
12968,6/29/2012,3,1,6,12,0,5,1,2,0.92,0.8788,0.4,0.2537,53,173,226,173
12969,6/29/2012,3,1,6,13,0,5,1,1,0.94,0.8788,0.38,0.194,45,194,239,194
12970,6/29/2012,3,1,6,14,0,5,1,1,0.96,0.9091,0.36,0.2239,49,184,233,184
12971,6/29/2012,3,1,6,15,0,5,1,1,0.96,0.9091,0.36,0,47,183,230,183
12972,6/29/2012,3,1,6,16,0,5,1,1,0.96,0.9091,0.36,0,59,292,351,292
12973,6/29/2012,3,1,6,17,0,5,1,1,0.98,0.9242,0.34,0.194,82,457,539,457
12974,6/29/2012,3,1,6,18,0,5,1,1,0.96,0.8636,0.31,0,50,414,464,414
12975,6/29/2012,3,1,6,19,0,5,1,1,0.9,0.8788,0.47,0.194,60,303,363,303
12976,6/29/2012,3,1,6,20,0,5,1,1,0.92,0.8939,0.42,0.2537,53,255,308,255
12977,6/29/2012,3,1,6,21,0,5,1,2,0.86,0.8333,0.53,0.194,41,195,236,195
12978,6/29/2012,3,1,6,22,0,5,1,3,0.82,0.8333,0.63,0.194,34,129,163,129
12979,6/29/2012,3,1,6,23,0,5,1,3,0.82,0.8333,0.63,0.194,6,42,48,42
12980,6/30/2012,3,1,6,0,0,6,0,3,0.64,0.5758,0.89,0.1642,4,65,69,65
12981,6/30/2012,3,1,6,1,0,6,0,3,0.64,0.5758,0.89,0.2239,3,55,58,55
12982,6/30/2012,3,1,6,2,0,6,0,2,0.64,0.5758,0.89,0,7,54,61,54
12983,6/30/2012,3,1,6,3,0,6,0,2,0.64,0.5758,0.89,0,3,20,23,20
12984,6/30/2012,3,1,6,4,0,6,0,2,0.62,0.5455,0.94,0,3,15,18,15
12985,6/30/2012,3,1,6,5,0,6,0,1,0.64,0.5758,0.89,0.1642,3,7,10,7
12986,6/30/2012,3,1,6,6,0,6,0,1,0.64,0.5758,0.89,0.1642,6,36,42,36
12987,6/30/2012,3,1,6,7,0,6,0,1,0.64,0.5758,0.89,0.1642,10,82,92,82
12988,6/30/2012,3,1,6,8,0,6,0,1,0.64,0.5758,0.89,0.1642,26,168,194,168
12989,6/30/2012,3,1,6,9,0,6,0,1,0.64,0.5758,0.89,0.1642,41,234,275,234
12990,6/30/2012,3,1,6,10,0,6,0,1,0.88,0.7727,0.3,0.2537,96,308,404,308
12991,6/30/2012,3,1,6,11,0,6,0,1,0.88,0.7727,0.3,0.2537,102,350,452,350
12992,6/30/2012,3,1,6,12,0,6,0,1,0.88,0.7727,0.3,0.2537,143,328,471,328
12993,6/30/2012,3,1,6,13,0,6,0,1,0.88,0.7727,0.3,0.2537,105,323,428,323
12994,6/30/2012,3,1,6,14,0,6,0,1,0.88,0.7727,0.3,0.2537,114,295,409,295
12995,6/30/2012,3,1,6,15,0,6,0,1,0.88,0.7727,0.3,0.2537,117,287,404,287
12996,6/30/2012,3,1,6,16,0,6,0,1,0.9,0.7879,0.29,0.1642,109,264,373,264
12997,6/30/2012,3,1,6,17,0,6,0,1,0.88,0.7727,0.32,0.1343,131,231,362,231
12998,6/30/2012,3,1,6,18,0,6,0,1,0.88,0.7879,0.35,0,91,248,339,248
12999,6/30/2012,3,1,6,19,0,6,0,1,0.84,0.7576,0.44,0.2537,134,240,374,240
13000,6/30/2012,3,1,6,20,0,6,0,1,0.82,0.7727,0.52,0.1642,88,204,292,204
13001,6/30/2012,3,1,6,21,0,6,0,1,0.82,0.7727,0.52,0.1642,48,165,213,165
13002,6/30/2012,3,1,6,22,0,6,0,1,0.78,0.7424,0.62,0.1642,38,134,172,134
13003,6/30/2012,3,1,6,23,0,6,0,1,0.78,0.7424,0.62,0.0896,33,119,152,119
13004,7/1/2012,3,1,7,0,0,0,0,1,0.76,0.7273,0.66,0,27,122,149,122
13005,7/1/2012,3,1,7,1,0,0,0,1,0.74,0.697,0.7,0.1343,12,81,93,81
13006,7/1/2012,3,1,7,2,0,0,0,1,0.72,0.697,0.74,0.0896,21,69,90,69
13007,7/1/2012,3,1,7,3,0,0,0,1,0.72,0.7121,0.84,0.1343,6,27,33,27
13008,7/1/2012,3,1,7,4,0,0,0,1,0.7,0.6667,0.79,0.194,0,4,4,4
13009,7/1/2012,3,1,7,5,0,0,0,1,0.68,0.6364,0.79,0.1045,3,7,10,7
13010,7/1/2012,3,1,7,6,0,0,0,1,0.7,0.6667,0.79,0.0896,8,19,27,19
13011,7/1/2012,3,1,7,7,0,0,0,1,0.74,0.697,0.7,0,13,37,50,37
13012,7/1/2012,3,1,7,8,0,0,0,1,0.78,0.7424,0.62,0.1045,36,106,142,106
13013,7/1/2012,3,1,7,9,0,0,0,1,0.82,0.7879,0.56,0,51,168,219,168
13014,7/1/2012,3,1,7,10,0,0,0,1,0.86,0.7879,0.44,0.2985,98,268,366,268
13015,7/1/2012,3,1,7,11,0,0,0,1,0.88,0.803,0.39,0.2239,121,256,377,256
13016,7/1/2012,3,1,7,12,0,0,0,1,0.9,0.8182,0.37,0.2239,114,319,433,319
13017,7/1/2012,3,1,7,13,0,0,0,1,0.92,0.8333,0.33,0.2537,111,309,420,309
13018,7/1/2012,3,1,7,14,0,0,0,1,0.92,0.8333,0.33,0.2537,98,346,444,346
13019,7/1/2012,3,1,7,15,0,0,0,1,0.9,0.8182,0.37,0.2836,101,244,345,244
13020,7/1/2012,3,1,7,16,0,0,0,1,0.92,0.8333,0.33,0.2985,85,228,313,228
13021,7/1/2012,3,1,7,17,0,0,0,1,0.92,0.803,0.26,0.2985,90,323,413,323
13022,7/1/2012,3,1,7,18,0,0,0,1,0.88,0.7727,0.32,0.3582,95,275,370,275
13023,7/1/2012,3,1,7,19,0,0,0,1,0.84,0.7424,0.39,0.1343,103,279,382,279
13024,7/1/2012,3,1,7,20,0,0,0,1,0.84,0.7424,0.39,0.1343,88,244,332,244
13025,7/1/2012,3,1,7,21,0,0,0,1,0.84,0.7424,0.39,0.1343,77,181,258,181
13026,7/1/2012,3,1,7,22,0,0,0,1,0.82,0.7424,0.43,0.1343,41,110,151,110
13027,7/1/2012,3,1,7,23,0,0,0,3,0.78,0.7121,0.52,0.1642,22,88,110,88
13028,7/2/2012,3,1,7,0,0,1,1,2,0.76,0.7121,0.58,0.2239,12,31,43,31
13029,7/2/2012,3,1,7,1,0,1,1,2,0.76,0.7121,0.58,0.194,3,14,17,14
13030,7/2/2012,3,1,7,2,0,1,1,2,0.74,0.6667,0.51,0.2537,1,14,15,14
13031,7/2/2012,3,1,7,3,0,1,1,2,0.72,0.6667,0.54,0.4179,0,5,5,5
13032,7/2/2012,3,1,7,4,0,1,1,2,0.72,0.6667,0.54,0.2985,2,10,12,10
13033,7/2/2012,3,1,7,5,0,1,1,2,0.72,0.6667,0.51,0,3,37,40,37
13034,7/2/2012,3,1,7,6,0,1,1,1,0.7,0.6515,0.58,0.1045,4,132,136,132
13035,7/2/2012,3,1,7,7,0,1,1,1,0.74,0.6667,0.51,0.1045,8,390,398,390
13036,7/2/2012,3,1,7,8,0,1,1,1,0.76,0.697,0.52,0.194,20,548,568,548
13037,7/2/2012,3,1,7,9,0,1,1,1,0.78,0.697,0.46,0.2537,56,239,295,239
13038,7/2/2012,3,1,7,10,0,1,1,1,0.8,0.7273,0.43,0.2537,70,104,174,104
13039,7/2/2012,3,1,7,11,0,1,1,1,0.84,0.7273,0.28,0.2985,67,134,201,134
13040,7/2/2012,3,1,7,12,0,1,1,1,0.84,0.7273,0.32,0.194,74,183,257,183
13041,7/2/2012,3,1,7,13,0,1,1,1,0.86,0.7576,0.34,0.2239,74,162,236,162
13042,7/2/2012,3,1,7,14,0,1,1,1,0.86,0.7576,0.34,0.2239,79,151,230,151
13043,7/2/2012,3,1,7,15,0,1,1,1,0.84,0.7424,0.36,0.194,59,175,234,175
13044,7/2/2012,3,1,7,16,0,1,1,1,0.84,0.7424,0.36,0.2836,61,304,365,304
13045,7/2/2012,3,1,7,17,0,1,1,1,0.84,0.7273,0.32,0.1343,82,665,747,665
13046,7/2/2012,3,1,7,18,0,1,1,1,0.84,0.7273,0.32,0.1642,72,658,730,658
13047,7/2/2012,3,1,7,19,0,1,1,1,0.78,0.697,0.43,0.1343,71,510,581,510
13048,7/2/2012,3,1,7,20,0,1,1,1,0.78,0.697,0.43,0.1343,38,357,395,357
13049,7/2/2012,3,1,7,21,0,1,1,1,0.76,0.6818,0.45,0.1343,17,241,258,241
13050,7/2/2012,3,1,7,22,0,1,1,1,0.74,0.6667,0.51,0.1642,19,169,188,169
13051,7/2/2012,3,1,7,23,0,1,1,1,0.74,0.6667,0.51,0.1045,12,90,102,90
13052,7/3/2012,3,1,7,0,0,2,1,1,0.72,0.6667,0.54,0,9,44,53,44
13053,7/3/2012,3,1,7,1,0,2,1,1,0.72,0.6667,0.58,0,5,9,14,9
13054,7/3/2012,3,1,7,2,0,2,1,1,0.72,0.6667,0.58,0,2,8,10,8
13055,7/3/2012,3,1,7,3,0,2,1,1,0.7,0.6515,0.65,0.1343,0,2,2,2
13056,7/3/2012,3,1,7,4,0,2,1,1,0.68,0.6364,0.65,0.1045,0,6,6,6
13057,7/3/2012,3,1,7,5,0,2,1,1,0.7,0.6515,0.61,0,2,33,35,33
13058,7/3/2012,3,1,7,6,0,2,1,1,0.7,0.6515,0.65,0.1343,5,149,154,149
13059,7/3/2012,3,1,7,7,0,2,1,1,0.74,0.6818,0.58,0,21,462,483,462
13060,7/3/2012,3,1,7,8,0,2,1,1,0.74,0.6818,0.62,0.0896,42,604,646,604
13061,7/3/2012,3,1,7,9,0,2,1,1,0.8,0.7424,0.49,0.1642,46,226,272,226
13062,7/3/2012,3,1,7,10,0,2,1,1,0.82,0.7424,0.43,0.2239,56,153,209,153
13063,7/3/2012,3,1,7,11,0,2,1,1,0.86,0.7576,0.34,0.194,66,151,217,151
13064,7/3/2012,3,1,7,12,0,2,1,1,0.88,0.7576,0.28,0.194,74,198,272,198
13065,7/3/2012,3,1,7,13,0,2,1,1,0.9,0.7727,0.25,0.1343,80,203,283,203
13066,7/3/2012,3,1,7,14,0,2,1,1,0.9,0.7727,0.25,0.194,69,241,310,241
13067,7/3/2012,3,1,7,15,0,2,1,2,0.9,0.7727,0.24,0,71,330,401,330
13068,7/3/2012,3,1,7,16,0,2,1,2,0.9,0.7727,0.24,0.194,90,437,527,437
13069,7/3/2012,3,1,7,17,0,2,1,2,0.86,0.7424,0.3,0.1642,102,620,722,620
13070,7/3/2012,3,1,7,18,0,2,1,2,0.86,0.7424,0.3,0,85,542,627,542
13071,7/3/2012,3,1,7,19,0,2,1,2,0.84,0.7424,0.36,0.1343,66,431,497,431
13072,7/3/2012,3,1,7,20,0,2,1,3,0.76,0.697,0.55,0.4925,80,296,376,296
13073,7/3/2012,3,1,7,21,0,2,1,2,0.7,0.6515,0.7,0.2836,36,160,196,160
13074,7/3/2012,3,1,7,22,0,2,1,1,0.68,0.6364,0.79,0.194,26,151,177,151
13075,7/3/2012,3,1,7,23,0,2,1,1,0.66,0.6061,0.83,0,19,152,171,152
13076,7/4/2012,3,1,7,0,1,3,0,1,0.68,0.6364,0.79,0.0896,19,140,159,140
13077,7/4/2012,3,1,7,1,1,3,0,1,0.68,0.6364,0.74,0,27,96,123,96
13078,7/4/2012,3,1,7,2,1,3,0,1,0.66,0.6061,0.83,0.1343,27,66,93,66
13079,7/4/2012,3,1,7,3,1,3,0,1,0.68,0.6364,0.74,0.194,9,23,32,23
13080,7/4/2012,3,1,7,4,1,3,0,1,0.68,0.6364,0.69,0.2537,5,11,16,11
13081,7/4/2012,3,1,7,5,1,3,0,1,0.66,0.6212,0.69,0,5,14,19,14
13082,7/4/2012,3,1,7,6,1,3,0,1,0.66,0.6212,0.69,0,9,23,32,23
13083,7/4/2012,3,1,7,7,1,3,0,1,0.68,0.6364,0.65,0,10,62,72,62
13084,7/4/2012,3,1,7,8,1,3,0,1,0.7,0.6515,0.61,0.1045,43,110,153,110
13085,7/4/2012,3,1,7,9,1,3,0,1,0.76,0.697,0.52,0,90,203,293,203
13086,7/4/2012,3,1,7,10,1,3,0,1,0.8,0.7273,0.46,0,143,304,447,304
13087,7/4/2012,3,1,7,11,1,3,0,1,0.82,0.7576,0.46,0.1343,164,321,485,321
13088,7/4/2012,3,1,7,12,1,3,0,1,0.86,0.7879,0.41,0.2239,164,330,494,330
13089,7/4/2012,3,1,7,13,1,3,0,1,0.9,0.8182,0.35,0,177,322,499,322
13090,7/4/2012,3,1,7,14,1,3,0,1,0.9,0.8182,0.37,0.1642,190,357,547,357
13091,7/4/2012,3,1,7,15,1,3,0,1,0.92,0.8485,0.35,0.2985,155,299,454,299
13092,7/4/2012,3,1,7,16,1,3,0,1,0.92,0.8485,0.35,0.2537,163,226,389,226
13093,7/4/2012,3,1,7,17,1,3,0,1,0.92,0.8485,0.35,0.2985,161,253,414,253
13094,7/4/2012,3,1,7,18,1,3,0,1,0.9,0.8485,0.42,0.194,159,271,430,271
13095,7/4/2012,3,1,7,19,1,3,0,1,0.86,0.803,0.47,0.2239,177,255,432,255
13096,7/4/2012,3,1,7,20,1,3,0,1,0.86,0.803,0.47,0.2239,237,314,551,314
13097,7/4/2012,3,1,7,21,1,3,0,1,0.84,0.803,0.53,0.1343,222,362,584,362
13098,7/4/2012,3,1,7,22,1,3,0,1,0.82,0.7879,0.56,0.2239,175,327,502,327
13099,7/4/2012,3,1,7,23,1,3,0,2,0.78,0.697,0.43,0.0896,31,152,183,152
13100,7/5/2012,3,1,7,0,0,4,1,1,0.74,0.6667,0.51,0.1045,17,71,88,71
13101,7/5/2012,3,1,7,1,0,4,1,1,0.74,0.6667,0.51,0.2836,6,24,30,24
13102,7/5/2012,3,1,7,2,0,4,1,1,0.74,0.6667,0.51,0,4,14,18,14
13103,7/5/2012,3,1,7,3,0,4,1,1,0.72,0.6667,0.54,0.194,2,5,7,5
13104,7/5/2012,3,1,7,4,0,4,1,1,0.72,0.6667,0.58,0,0,7,7,7
13105,7/5/2012,3,1,7,5,0,4,1,1,0.72,0.6818,0.62,0,1,28,29,28
13106,7/5/2012,3,1,7,6,0,4,1,1,0.72,0.6667,0.58,0,3,130,133,130
13107,7/5/2012,3,1,7,7,0,4,1,1,0.76,0.697,0.55,0,27,316,343,316
13108,7/5/2012,3,1,7,8,0,4,1,1,0.8,0.7424,0.49,0.1343,36,514,550,514
13109,7/5/2012,3,1,7,9,0,4,1,1,0.84,0.7879,0.49,0.2985,47,246,293,246
13110,7/5/2012,3,1,7,10,0,4,1,1,0.86,0.7879,0.44,0.3582,69,117,186,117
13111,7/5/2012,3,1,7,11,0,4,1,1,0.9,0.8182,0.35,0.2985,107,137,244,137
13112,7/5/2012,3,1,7,12,0,4,1,1,0.9,0.8182,0.35,0.3582,88,188,276,188
13113,7/5/2012,3,1,7,13,0,4,1,1,0.92,0.8333,0.33,0.2239,129,181,310,181
13114,7/5/2012,3,1,7,14,0,4,1,1,0.92,0.8333,0.33,0.3284,87,154,241,154
13115,7/5/2012,3,1,7,15,0,4,1,1,0.92,0.8333,0.33,0.3582,71,183,254,183
13116,7/5/2012,3,1,7,16,0,4,1,1,0.92,0.8333,0.33,0.2537,109,324,433,324
13117,7/5/2012,3,1,7,17,0,4,1,1,0.92,0.8485,0.35,0.1642,114,575,689,575
13118,7/5/2012,3,1,7,18,0,4,1,2,0.9,0.8333,0.39,0.3284,96,511,607,511
13119,7/5/2012,3,1,7,19,0,4,1,2,0.88,0.803,0.39,0.2537,128,375,503,375
13120,7/5/2012,3,1,7,20,0,4,1,2,0.86,0.7879,0.41,0.2239,78,243,321,243
13121,7/5/2012,3,1,7,21,0,4,1,1,0.84,0.7727,0.47,0.194,91,232,323,232
13122,7/5/2012,3,1,7,22,0,4,1,1,0.82,0.803,0.59,0.1343,63,162,225,162
13123,7/5/2012,3,1,7,23,0,4,1,1,0.8,0.7576,0.55,0.1642,32,99,131,99
13124,7/6/2012,3,1,7,0,0,5,1,1,0.78,0.7424,0.62,0.1343,39,63,102,63
13125,7/6/2012,3,1,7,1,0,5,1,1,0.78,0.7273,0.55,0.2239,7,22,29,22
13126,7/6/2012,3,1,7,2,0,5,1,1,0.76,0.7121,0.62,0.1343,4,13,17,13
13127,7/6/2012,3,1,7,3,0,5,1,2,0.74,0.697,0.7,0.194,1,6,7,6
13128,7/6/2012,3,1,7,4,0,5,1,1,0.74,0.697,0.66,0.2239,2,4,6,4
13129,7/6/2012,3,1,7,5,0,5,1,1,0.74,0.697,0.66,0.194,4,31,35,31
13130,7/6/2012,3,1,7,6,0,5,1,1,0.74,0.697,0.66,0.194,4,127,131,127
13131,7/6/2012,3,1,7,7,0,5,1,1,0.78,0.697,0.46,0.1343,20,333,353,333
13132,7/6/2012,3,1,7,8,0,5,1,1,0.8,0.7121,0.41,0.1642,28,557,585,557
13133,7/6/2012,3,1,7,9,0,5,1,1,0.82,0.7273,0.36,0.1343,55,249,304,249
13134,7/6/2012,3,1,7,10,0,5,1,1,0.86,0.7424,0.3,0,80,130,210,130
13135,7/6/2012,3,1,7,11,0,5,1,1,0.84,0.7273,0.32,0.0896,92,141,233,141
13136,7/6/2012,3,1,7,12,0,5,1,1,0.88,0.7576,0.28,0.1045,111,220,331,220
13137,7/6/2012,3,1,7,13,0,5,1,1,0.9,0.7879,0.27,0.1045,99,194,293,194
13138,7/6/2012,3,1,7,14,0,5,1,1,0.9,0.803,0.31,0.1642,91,184,275,184
13139,7/6/2012,3,1,7,15,0,5,1,1,0.92,0.8182,0.29,0.194,79,206,285,206
13140,7/6/2012,3,1,7,16,0,5,1,1,0.92,0.8182,0.29,0.1045,69,300,369,300
13141,7/6/2012,3,1,7,17,0,5,1,1,0.92,0.8182,0.29,0,90,486,576,486
13142,7/6/2012,3,1,7,18,0,5,1,1,0.9,0.803,0.33,0.2537,106,454,560,454
13143,7/6/2012,3,1,7,19,0,5,1,1,0.88,0.7879,0.35,0.2239,112,306,418,306
13144,7/6/2012,3,1,7,20,0,5,1,1,0.86,0.7727,0.39,0.1045,91,245,336,245
13145,7/6/2012,3,1,7,21,0,5,1,1,0.82,0.7727,0.52,0.1343,77,223,300,223
13146,7/6/2012,3,1,7,22,0,5,1,1,0.8,0.7576,0.55,0.194,78,210,288,210
13147,7/6/2012,3,1,7,23,0,5,1,1,0.8,0.7879,0.63,0.1045,27,137,164,137
13148,7/7/2012,3,1,7,0,0,6,0,1,0.78,0.7576,0.66,0.1343,35,115,150,115
13149,7/7/2012,3,1,7,1,0,6,0,1,0.76,0.7273,0.7,0.1642,16,55,71,55
13150,7/7/2012,3,1,7,2,0,6,0,1,0.76,0.7424,0.72,0.1642,11,47,58,47
13151,7/7/2012,3,1,7,3,0,6,0,1,0.74,0.7121,0.74,0.1343,12,19,31,19
13152,7/7/2012,3,1,7,4,0,6,0,1,0.74,0.7121,0.74,0.1642,3,13,16,13
13153,7/7/2012,3,1,7,5,0,6,0,1,0.74,0.7121,0.74,0.194,2,12,14,12
13154,7/7/2012,3,1,7,6,0,6,0,1,0.74,0.7121,0.74,0.1045,4,27,31,27
13155,7/7/2012,3,1,7,7,0,6,0,1,0.78,0.7576,0.66,0.1045,8,63,71,63
13156,7/7/2012,3,1,7,8,0,6,0,1,0.82,0.8333,0.63,0.194,32,120,152,120
13157,7/7/2012,3,1,7,9,0,6,0,1,0.84,0.8333,0.59,0.1642,69,187,256,187
13158,7/7/2012,3,1,7,10,0,6,0,1,0.92,0.8636,0.37,0.2239,100,225,325,225
13159,7/7/2012,3,1,7,11,0,6,0,1,0.94,0.8788,0.38,0.194,122,245,367,245
13160,7/7/2012,3,1,7,12,0,6,0,1,0.96,0.8636,0.31,0.3582,124,218,342,218
13161,7/7/2012,3,1,7,13,0,6,0,2,0.96,0.8636,0.31,0.2537,116,244,360,244
13162,7/7/2012,3,1,7,14,0,6,0,2,0.96,0.8636,0.3,0.1343,105,203,308,203
13163,7/7/2012,3,1,7,15,0,6,0,1,0.96,0.8485,0.26,0,113,193,306,193
13164,7/7/2012,3,1,7,16,0,6,0,1,1,0.8636,0.19,0.1642,102,192,294,192
13165,7/7/2012,3,1,7,17,0,6,0,1,0.96,0.8485,0.26,0.1343,103,176,279,176
13166,7/7/2012,3,1,7,18,0,6,0,1,0.94,0.8333,0.29,0.0896,83,194,277,194
13167,7/7/2012,3,1,7,19,0,6,0,1,0.92,0.8333,0.33,0.1343,68,219,287,219
13168,7/7/2012,3,1,7,20,0,6,0,1,0.9,0.8182,0.37,0.1642,79,197,276,197
13169,7/7/2012,3,1,7,21,0,6,0,1,0.88,0.7879,0.37,0.194,51,150,201,150
13170,7/7/2012,3,1,7,22,0,6,0,1,0.84,0.8333,0.59,0.194,56,164,220,164
13171,7/7/2012,3,1,7,23,0,6,0,1,0.84,0.8182,0.56,0.1642,34,114,148,114
13172,7/8/2012,3,1,7,0,0,0,0,1,0.82,0.7879,0.56,0.1343,22,125,147,125
13173,7/8/2012,3,1,7,1,0,0,0,1,0.82,0.7879,0.56,0.1045,25,99,124,99
13174,7/8/2012,3,1,7,2,0,0,0,1,0.82,0.7727,0.52,0.1045,11,59,70,59
13175,7/8/2012,3,1,7,3,0,0,0,1,0.8,0.7727,0.59,0.1045,1,34,35,34
13176,7/8/2012,3,1,7,4,0,0,0,1,0.78,0.7576,0.66,0.1045,2,11,13,11
13177,7/8/2012,3,1,7,5,0,0,0,1,0.78,0.7424,0.62,0,1,5,6,5
13178,7/8/2012,3,1,7,6,0,0,0,1,0.78,0.7727,0.7,0.1343,5,16,21,16
13179,7/8/2012,3,1,7,7,0,0,0,1,0.8,0.803,0.66,0,19,33,52,33
13180,7/8/2012,3,1,7,8,0,0,0,1,0.84,0.803,0.53,0.1343,35,95,130,95
13181,7/8/2012,3,1,7,9,0,0,0,1,0.86,0.8182,0.5,0.1045,70,172,242,172
13182,7/8/2012,3,1,7,10,0,0,0,1,0.9,0.8636,0.45,0,85,234,319,234
13183,7/8/2012,3,1,7,11,0,0,0,1,0.92,0.8939,0.42,0.2985,120,269,389,269
13184,7/8/2012,3,1,7,12,0,0,0,1,0.92,0.8939,0.42,0.194,105,271,376,271
13185,7/8/2012,3,1,7,13,0,0,0,1,0.94,0.8788,0.38,0.2537,118,219,337,219
13186,7/8/2012,3,1,7,14,0,0,0,1,0.96,0.9091,0.36,0.1642,77,235,312,235
13187,7/8/2012,3,1,7,15,0,0,0,3,0.92,0.8939,0.42,0.2836,80,218,298,218
13188,7/8/2012,3,1,7,16,0,0,0,2,0.8,0.803,0.66,0.2239,65,226,291,226
13189,7/8/2012,3,1,7,17,0,0,0,1,0.78,0.7424,0.59,0,68,202,270,202
13190,7/8/2012,3,1,7,18,0,0,0,1,0.78,0.7424,0.62,0.1045,54,199,253,199
13191,7/8/2012,3,1,7,19,0,0,0,1,0.78,0.7424,0.62,0.1642,66,184,250,184
13192,7/8/2012,3,1,7,20,0,0,0,1,0.76,0.7273,0.7,0.0896,79,206,285,206
13193,7/8/2012,3,1,7,21,0,0,0,1,0.76,0.7273,0.7,0.1343,58,149,207,149
13194,7/8/2012,3,1,7,22,0,0,0,3,0.74,0.697,0.7,0.0896,12,110,122,110
13195,7/8/2012,3,1,7,23,0,0,0,3,0.68,0.6364,0.83,0.0896,25,98,123,98
13196,7/9/2012,3,1,7,0,0,1,1,2,0.68,0.6364,0.89,0.0896,6,33,39,33
13197,7/9/2012,3,1,7,1,0,1,1,3,0.7,0.6667,0.89,0.1045,5,13,18,13
13198,7/9/2012,3,1,7,2,0,1,1,3,0.7,0.6667,0.89,0.194,1,4,5,4
13199,7/9/2012,3,1,7,3,0,1,1,3,0.7,0.6667,0.89,0.194,0,5,5,5
13200,7/9/2012,3,1,7,4,0,1,1,3,0.66,0.5909,0.89,0.3881,1,1,2,1
13201,7/9/2012,3,1,7,5,0,1,1,2,0.66,0.6061,0.83,0.2239,1,27,28,27
13202,7/9/2012,3,1,7,6,0,1,1,3,0.64,0.5758,0.89,0.2537,6,86,92,86
13203,7/9/2012,3,1,7,7,0,1,1,3,0.66,0.6061,0.83,0.2239,7,223,230,223
13204,7/9/2012,3,1,7,8,0,1,1,2,0.66,0.6061,0.83,0.1642,26,429,455,429
13205,7/9/2012,3,1,7,9,0,1,1,2,0.66,0.6061,0.83,0.1642,38,325,363,325
13206,7/9/2012,3,1,7,10,0,1,1,2,0.66,0.6061,0.83,0.194,58,117,175,117
13207,7/9/2012,3,1,7,11,0,1,1,2,0.72,0.6818,0.62,0.1343,72,144,216,144
13208,7/9/2012,3,1,7,12,0,1,1,2,0.74,0.6818,0.58,0.1343,61,205,266,205
13209,7/9/2012,3,1,7,13,0,1,1,2,0.76,0.697,0.55,0.2537,67,188,255,188
13210,7/9/2012,3,1,7,14,0,1,1,2,0.74,0.6818,0.55,0.2537,58,184,242,184
13211,7/9/2012,3,1,7,15,0,1,1,2,0.76,0.6818,0.45,0.2239,66,214,280,214
13212,7/9/2012,3,1,7,16,0,1,1,1,0.78,0.697,0.4,0.2836,88,325,413,325
13213,7/9/2012,3,1,7,17,0,1,1,1,0.78,0.697,0.4,0.1642,108,741,849,741
13214,7/9/2012,3,1,7,18,0,1,1,1,0.76,0.6818,0.48,0.1343,82,790,872,790
13215,7/9/2012,3,1,7,19,0,1,1,1,0.74,0.6818,0.55,0.1642,88,543,631,543
13216,7/9/2012,3,1,7,20,0,1,1,2,0.74,0.6818,0.55,0.1045,69,378,447,378
13217,7/9/2012,3,1,7,21,0,1,1,2,0.74,0.6818,0.55,0.0896,33,298,331,298
13218,7/9/2012,3,1,7,22,0,1,1,2,0.72,0.6667,0.58,0.1045,35,189,224,189
13219,7/9/2012,3,1,7,23,0,1,1,2,0.7,0.6515,0.65,0.1045,22,109,131,109
13220,7/10/2012,3,1,7,0,0,2,1,1,0.7,0.6515,0.7,0.0896,16,53,69,53
13221,7/10/2012,3,1,7,1,0,2,1,1,0.7,0.6667,0.74,0.1343,0,15,15,15
13222,7/10/2012,3,1,7,2,0,2,1,1,0.7,0.6667,0.74,0.1343,1,15,16,15
13223,7/10/2012,3,1,7,3,0,2,1,1,0.68,0.6364,0.79,0,0,3,3,3
13224,7/10/2012,3,1,7,4,0,2,1,1,0.68,0.6364,0.79,0.1343,0,4,4,4
13225,7/10/2012,3,1,7,5,0,2,1,1,0.66,0.6061,0.83,0.1343,3,39,42,39
13226,7/10/2012,3,1,7,6,0,2,1,2,0.68,0.6364,0.79,0.1045,4,183,187,183
13227,7/10/2012,3,1,7,7,0,2,1,2,0.7,0.6667,0.74,0.1045,31,489,520,489
13228,7/10/2012,3,1,7,8,0,2,1,1,0.72,0.697,0.74,0.1343,34,615,649,615
13229,7/10/2012,3,1,7,9,0,2,1,1,0.74,0.697,0.66,0.1343,47,284,331,284
13230,7/10/2012,3,1,7,10,0,2,1,1,0.76,0.7121,0.62,0.194,56,134,190,134
13231,7/10/2012,3,1,7,11,0,2,1,1,0.8,0.7273,0.46,0.194,92,157,249,157
13232,7/10/2012,3,1,7,12,0,2,1,1,0.8,0.7121,0.41,0.1343,69,203,272,203
13233,7/10/2012,3,1,7,13,0,2,1,1,0.82,0.7273,0.38,0.194,77,203,280,203
13234,7/10/2012,3,1,7,14,0,2,1,1,0.82,0.7273,0.38,0.1642,71,171,242,171
13235,7/10/2012,3,1,7,15,0,2,1,1,0.8,0.7121,0.41,0.2239,77,188,265,188
13236,7/10/2012,3,1,7,16,0,2,1,1,0.8,0.7273,0.43,0.2239,89,346,435,346
13237,7/10/2012,3,1,7,17,0,2,1,1,0.78,0.7121,0.49,0.194,103,769,872,769
13238,7/10/2012,3,1,7,18,0,2,1,3,0.7,0.6667,0.74,0.2239,70,749,819,749
13239,7/10/2012,3,1,7,19,0,2,1,3,0.7,0.6667,0.74,0.2239,55,359,414,359
13240,7/10/2012,3,1,7,20,0,2,1,3,0.64,0.5758,0.83,0.2239,9,75,84,75
13241,7/10/2012,3,1,7,21,0,2,1,3,0.64,0.5758,0.89,0.1045,7,83,90,83
13242,7/10/2012,3,1,7,22,0,2,1,2,0.64,0.5758,0.83,0.1343,14,125,139,125
13243,7/10/2012,3,1,7,23,0,2,1,2,0.64,0.5758,0.89,0.1045,29,74,103,74
13244,7/11/2012,3,1,7,0,0,3,1,2,0.66,0.6061,0.83,0.1343,6,38,44,38
13245,7/11/2012,3,1,7,1,0,3,1,1,0.64,0.5758,0.89,0,3,11,14,11
13246,7/11/2012,3,1,7,2,0,3,1,1,0.64,0.5758,0.89,0,0,5,5,5
13247,7/11/2012,3,1,7,3,0,3,1,1,0.64,0.5758,0.89,0.1343,0,5,5,5
13248,7/11/2012,3,1,7,4,0,3,1,1,0.64,0.5758,0.89,0.1343,1,6,7,6
13249,7/11/2012,3,1,7,5,0,3,1,1,0.64,0.5758,0.89,0,5,36,41,36
13250,7/11/2012,3,1,7,6,0,3,1,1,0.64,0.5758,0.89,0.1343,17,168,185,168
13251,7/11/2012,3,1,7,7,0,3,1,2,0.66,0.6061,0.83,0.1045,26,471,497,471
13252,7/11/2012,3,1,7,8,0,3,1,2,0.68,0.6364,0.79,0.1642,30,644,674,644
13253,7/11/2012,3,1,7,9,0,3,1,2,0.7,0.6667,0.74,0.1343,30,298,328,298
13254,7/11/2012,3,1,7,10,0,3,1,2,0.72,0.6818,0.62,0.1343,47,148,195,148
13255,7/11/2012,3,1,7,11,0,3,1,2,0.76,0.7121,0.58,0.1343,56,173,229,173
13256,7/11/2012,3,1,7,12,0,3,1,2,0.78,0.697,0.43,0,69,223,292,223
13257,7/11/2012,3,1,7,13,0,3,1,2,0.8,0.7121,0.42,0.1642,65,208,273,208
13258,7/11/2012,3,1,7,14,0,3,1,1,0.8,0.7121,0.41,0.2239,66,175,241,175
13259,7/11/2012,3,1,7,15,0,3,1,1,0.8,0.7121,0.41,0.2537,56,220,276,220
13260,7/11/2012,3,1,7,16,0,3,1,1,0.8,0.7121,0.38,0.194,53,358,411,358
13261,7/11/2012,3,1,7,17,0,3,1,1,0.8,0.697,0.31,0.2239,90,740,830,740
13262,7/11/2012,3,1,7,18,0,3,1,1,0.78,0.6818,0.38,0.2537,79,735,814,735
13263,7/11/2012,3,1,7,19,0,3,1,1,0.74,0.6667,0.48,0.2239,73,560,633,560
13264,7/11/2012,3,1,7,20,0,3,1,1,0.74,0.6667,0.51,0.1642,73,410,483,410
13265,7/11/2012,3,1,7,21,0,3,1,1,0.72,0.6667,0.58,0.2239,69,322,391,322
13266,7/11/2012,3,1,7,22,0,3,1,1,0.72,0.6667,0.58,0.2537,41,203,244,203
13267,7/11/2012,3,1,7,23,0,3,1,2,0.7,0.6515,0.58,0.2537,20,132,152,132
13268,7/12/2012,3,1,7,0,0,4,1,2,0.68,0.6364,0.61,0,1,55,56,55
13269,7/12/2012,3,1,7,1,0,4,1,2,0.66,0.6212,0.61,0,0,21,21,21
13270,7/12/2012,3,1,7,2,0,4,1,2,0.66,0.6212,0.65,0.0896,0,9,9,9
13271,7/12/2012,3,1,7,3,0,4,1,1,0.64,0.6061,0.69,0.1045,0,10,10,10
13272,7/12/2012,3,1,7,4,0,4,1,1,0.64,0.6061,0.73,0.1045,0,5,5,5
13273,7/12/2012,3,1,7,5,0,4,1,1,0.62,0.5909,0.73,0.1045,4,40,44,40
13274,7/12/2012,3,1,7,6,0,4,1,1,0.64,0.6061,0.73,0.0896,7,171,178,171
13275,7/12/2012,3,1,7,7,0,4,1,1,0.64,0.6061,0.73,0.1343,32,480,512,480
13276,7/12/2012,3,1,7,8,0,4,1,1,0.68,0.6364,0.65,0.1343,49,653,702,653
13277,7/12/2012,3,1,7,9,0,4,1,1,0.72,0.6667,0.58,0.1045,42,285,327,285
13278,7/12/2012,3,1,7,10,0,4,1,1,0.74,0.6667,0.48,0.1642,69,145,214,145
13279,7/12/2012,3,1,7,11,0,4,1,1,0.76,0.6818,0.45,0.1045,49,166,215,166
13280,7/12/2012,3,1,7,12,0,4,1,1,0.78,0.6818,0.35,0.1343,71,221,292,221
13281,7/12/2012,3,1,7,13,0,4,1,1,0.8,0.697,0.33,0.2239,52,225,277,225
13282,7/12/2012,3,1,7,14,0,4,1,1,0.78,0.6818,0.33,0.2239,42,167,209,167
13283,7/12/2012,3,1,7,15,0,4,1,1,0.8,0.7121,0.36,0.194,63,208,271,208
13284,7/12/2012,3,1,7,16,0,4,1,1,0.8,0.7121,0.36,0.194,69,370,439,370
13285,7/12/2012,3,1,7,17,0,4,1,1,0.76,0.6818,0.43,0.2239,91,704,795,704
13286,7/12/2012,3,1,7,18,0,4,1,1,0.76,0.6818,0.45,0.1343,86,739,825,739
13287,7/12/2012,3,1,7,19,0,4,1,1,0.74,0.6667,0.48,0.2239,97,532,629,532
13288,7/12/2012,3,1,7,20,0,4,1,1,0.74,0.6667,0.48,0.2239,75,439,514,439
13289,7/12/2012,3,1,7,21,0,4,1,1,0.72,0.6667,0.48,0.2239,44,329,373,329
13290,7/12/2012,3,1,7,22,0,4,1,1,0.72,0.6667,0.51,0.1642,56,262,318,262
13291,7/12/2012,3,1,7,23,0,4,1,2,0.7,0.6515,0.51,0.2239,33,178,211,178
13292,7/13/2012,3,1,7,0,0,5,1,2,0.7,0.6515,0.54,0.1642,19,76,95,76
13293,7/13/2012,3,1,7,1,0,5,1,2,0.68,0.6364,0.54,0.1045,17,42,59,42
13294,7/13/2012,3,1,7,2,0,5,1,2,0.66,0.6212,0.61,0.0896,2,15,17,15
13295,7/13/2012,3,1,7,3,0,5,1,2,0.68,0.6364,0.61,0,2,7,9,7
13296,7/13/2012,3,1,7,4,0,5,1,2,0.66,0.6212,0.61,0,0,11,11,11
13297,7/13/2012,3,1,7,5,0,5,1,2,0.66,0.6364,0.56,0.0896,4,30,34,30
13298,7/13/2012,3,1,7,6,0,5,1,2,0.7,0.6515,0.54,0,7,120,127,120
13299,7/13/2012,3,1,7,7,0,5,1,2,0.7,0.6515,0.54,0,27,353,380,353
13300,7/13/2012,3,1,7,8,0,5,1,2,0.7,0.6515,0.54,0,53,660,713,660
13301,7/13/2012,3,1,7,9,0,5,1,2,0.72,0.6667,0.51,0,70,344,414,344
13302,7/13/2012,3,1,7,10,0,5,1,2,0.74,0.6667,0.48,0,78,190,268,190
13303,7/13/2012,3,1,7,11,0,5,1,2,0.76,0.6818,0.45,0.1343,68,220,288,220
13304,7/13/2012,3,1,7,12,0,5,1,2,0.76,0.6818,0.4,0.1045,125,254,379,254
13305,7/13/2012,3,1,7,13,0,5,1,2,0.8,0.7121,0.38,0.1343,100,274,374,274
13306,7/13/2012,3,1,7,14,0,5,1,2,0.8,0.7121,0.38,0,120,249,369,249
13307,7/13/2012,3,1,7,15,0,5,1,2,0.8,0.7121,0.36,0.1045,92,261,353,261
13308,7/13/2012,3,1,7,16,0,5,1,2,0.8,0.7121,0.36,0.2239,111,381,492,381
13309,7/13/2012,3,1,7,17,0,5,1,2,0.8,0.7121,0.36,0.1642,138,697,835,697
13310,7/13/2012,3,1,7,18,0,5,1,1,0.78,0.697,0.46,0.194,108,523,631,523
13311,7/13/2012,3,1,7,19,0,5,1,1,0.74,0.6667,0.51,0.1642,103,385,488,385
13312,7/13/2012,3,1,7,20,0,5,1,1,0.74,0.6667,0.48,0.1343,95,294,389,294
13313,7/13/2012,3,1,7,21,0,5,1,1,0.72,0.6667,0.54,0,76,223,299,223
13314,7/13/2012,3,1,7,22,0,5,1,1,0.74,0.6667,0.45,0,59,204,263,204
13315,7/13/2012,3,1,7,23,0,5,1,2,0.72,0.6515,0.45,0.1343,37,175,212,175
13316,7/14/2012,3,1,7,0,0,6,0,2,0.72,0.6667,0.48,0.0896,35,156,191,156
13317,7/14/2012,3,1,7,1,0,6,0,2,0.7,0.6515,0.51,0.1045,13,105,118,105
13318,7/14/2012,3,1,7,2,0,6,0,2,0.7,0.6515,0.54,0.1045,10,91,101,91
13319,7/14/2012,3,1,7,3,0,6,0,2,0.7,0.6515,0.54,0.1045,9,31,40,31
13320,7/14/2012,3,1,7,4,0,6,0,3,0.66,0.6212,0.61,0.1045,3,6,9,6
13321,7/14/2012,3,1,7,5,0,6,0,2,0.64,0.6061,0.73,0.1045,0,5,5,5
13322,7/14/2012,3,1,7,6,0,6,0,2,0.64,0.5909,0.78,0.0896,6,29,35,29
13323,7/14/2012,3,1,7,7,0,6,0,1,0.64,0.5909,0.78,0.2836,7,41,48,41
13324,7/14/2012,3,1,7,8,0,6,0,1,0.62,0.5909,0.78,0.2836,33,118,151,118
13325,7/14/2012,3,1,7,9,0,6,0,1,0.66,0.6212,0.74,0.194,82,200,282,200
13326,7/14/2012,3,1,7,10,0,6,0,2,0.72,0.6818,0.7,0.0896,123,278,401,278
13327,7/14/2012,3,1,7,11,0,6,0,2,0.72,0.6818,0.7,0.1045,143,296,439,296
13328,7/14/2012,3,1,7,12,0,6,0,2,0.74,0.697,0.66,0.0896,181,318,499,318
13329,7/14/2012,3,1,7,13,0,6,0,2,0.76,0.7121,0.62,0.0896,219,372,591,372
13330,7/14/2012,3,1,7,14,0,6,0,1,0.8,0.7576,0.55,0.1045,269,363,632,363
13331,7/14/2012,3,1,7,15,0,6,0,1,0.8,0.7576,0.55,0.1642,243,317,560,317
13332,7/14/2012,3,1,7,16,0,6,0,2,0.72,0.697,0.79,0.3582,226,340,566,340
13333,7/14/2012,3,1,7,17,0,6,0,3,0.7,0.6667,0.79,0.1642,199,259,458,259
13334,7/14/2012,3,1,7,18,0,6,0,1,0.72,0.697,0.79,0.1343,108,243,351,243
13335,7/14/2012,3,1,7,19,0,6,0,1,0.72,0.7121,0.84,0.0896,156,275,431,275
13336,7/14/2012,3,1,7,20,0,6,0,1,0.72,0.7121,0.84,0.0896,101,255,356,255
13337,7/14/2012,3,1,7,21,0,6,0,1,0.7,0.6667,0.84,0.2239,69,200,269,200
13338,7/14/2012,3,1,7,22,0,6,0,1,0.7,0.6667,0.79,0.194,65,160,225,160
13339,7/14/2012,3,1,7,23,0,6,0,2,0.68,0.6364,0.83,0.0896,55,156,211,156
13340,7/15/2012,3,1,7,0,0,0,0,1,0.68,0.6364,0.89,0.1642,40,147,187,147
13341,7/15/2012,3,1,7,1,0,0,0,2,0.68,0.6364,0.89,0.1343,49,119,168,119
13342,7/15/2012,3,1,7,2,0,0,0,2,0.68,0.6364,0.89,0.1642,29,86,115,86
13343,7/15/2012,3,1,7,3,0,0,0,2,0.68,0.6364,0.89,0.1642,15,42,57,42
13344,7/15/2012,3,1,7,4,0,0,0,2,0.68,0.6364,0.89,0.1045,8,11,19,11
13345,7/15/2012,3,1,7,5,0,0,0,1,0.68,0.6364,0.89,0.1343,2,7,9,7
13346,7/15/2012,3,1,7,6,0,0,0,1,0.68,0.6364,0.83,0.1343,6,9,15,9
13347,7/15/2012,3,1,7,7,0,0,0,1,0.7,0.6667,0.79,0.0896,17,30,47,30
13348,7/15/2012,3,1,7,8,0,0,0,2,0.7,0.6667,0.84,0.1343,37,96,133,96
13349,7/15/2012,3,1,7,9,0,0,0,2,0.72,0.697,0.79,0,58,163,221,163
13350,7/15/2012,3,1,7,10,0,0,0,1,0.76,0.7273,0.66,0.1343,141,241,382,241
13351,7/15/2012,3,1,7,11,0,0,0,1,0.82,0.7727,0.52,0.1642,170,281,451,281
13352,7/15/2012,3,1,7,12,0,0,0,1,0.84,0.7727,0.47,0.1045,153,336,489,336
13353,7/15/2012,3,1,7,13,0,0,0,1,0.86,0.7879,0.41,0.1045,171,309,480,309
13354,7/15/2012,3,1,7,14,0,0,0,1,0.9,0.8182,0.37,0.2537,162,314,476,314
13355,7/15/2012,3,1,7,15,0,0,0,1,0.86,0.803,0.47,0.1343,182,307,489,307
13356,7/15/2012,3,1,7,16,0,0,0,1,0.86,0.7879,0.41,0.2239,152,343,495,343
13357,7/15/2012,3,1,7,17,0,0,0,1,0.8,0.7727,0.59,0.4925,122,314,436,314
13358,7/15/2012,3,1,7,18,0,0,0,3,0.72,0.697,0.79,0.3582,84,228,312,228
13359,7/15/2012,3,1,7,19,0,0,0,1,0.72,0.7121,0.84,0.2239,109,203,312,203
13360,7/15/2012,3,1,7,20,0,0,0,1,0.72,0.697,0.79,0.2537,95,199,294,199
13361,7/15/2012,3,1,7,21,0,0,0,1,0.72,0.697,0.79,0.0896,59,164,223,164
13362,7/15/2012,3,1,7,22,0,0,0,1,0.72,0.697,0.74,0.1045,34,96,130,96
13363,7/15/2012,3,1,7,23,0,0,0,1,0.72,0.697,0.79,0.1343,25,66,91,66
13364,7/16/2012,3,1,7,0,0,1,1,3,0.72,0.697,0.79,0.1045,11,32,43,32
13365,7/16/2012,3,1,7,1,0,1,1,2,0.7,0.6667,0.74,0.194,1,10,11,10
13366,7/16/2012,3,1,7,2,0,1,1,1,0.7,0.6667,0.74,0.1045,4,11,15,11
13367,7/16/2012,3,1,7,3,0,1,1,1,0.68,0.6364,0.79,0.0896,2,4,6,4
13368,7/16/2012,3,1,7,4,0,1,1,1,0.68,0.6364,0.79,0.1045,1,11,12,11
13369,7/16/2012,3,1,7,5,0,1,1,1,0.66,0.6061,0.78,0.1045,10,40,50,40
13370,7/16/2012,3,1,7,6,0,1,1,1,0.68,0.6364,0.79,0.1343,8,132,140,132
13371,7/16/2012,3,1,7,7,0,1,1,1,0.72,0.6818,0.7,0.0896,24,459,483,459
13372,7/16/2012,3,1,7,8,0,1,1,1,0.74,0.697,0.66,0.1045,48,619,667,619
13373,7/16/2012,3,1,7,9,0,1,1,1,0.76,0.7121,0.62,0.1642,51,297,348,297
13374,7/16/2012,3,1,7,10,0,1,1,1,0.8,0.7727,0.59,0,69,117,186,117
13375,7/16/2012,3,1,7,11,0,1,1,1,0.84,0.803,0.53,0.2239,57,125,182,125
13376,7/16/2012,3,1,7,12,0,1,1,1,0.84,0.7879,0.49,0.1343,79,158,237,158
13377,7/16/2012,3,1,7,13,0,1,1,1,0.84,0.7879,0.49,0.2836,63,176,239,176
13378,7/16/2012,3,1,7,14,0,1,1,1,0.88,0.8182,0.42,0.1045,53,159,212,159
13379,7/16/2012,3,1,7,15,0,1,1,1,0.86,0.803,0.47,0.2537,61,176,237,176
13380,7/16/2012,3,1,7,16,0,1,1,3,0.76,0.7273,0.66,0.5821,77,309,386,309
13381,7/16/2012,3,1,7,17,0,1,1,3,0.76,0.7273,0.66,0.5821,86,669,755,669
13382,7/16/2012,3,1,7,18,0,1,1,1,0.84,0.803,0.53,0,97,697,794,697
13383,7/16/2012,3,1,7,19,0,1,1,1,0.8,0.7879,0.63,0.1343,92,503,595,503
13384,7/16/2012,3,1,7,20,0,1,1,1,0.8,0.7727,0.59,0.1343,66,388,454,388
13385,7/16/2012,3,1,7,21,0,1,1,1,0.76,0.7273,0.66,0.1343,45,283,328,283
13386,7/16/2012,3,1,7,22,0,1,1,1,0.76,0.7121,0.62,0.0896,56,228,284,228
13387,7/16/2012,3,1,7,23,0,1,1,1,0.74,0.7121,0.74,0.0896,27,139,166,139
13388,7/17/2012,3,1,7,0,0,2,1,1,0.72,0.7121,0.84,0.1045,10,43,53,43
13389,7/17/2012,3,1,7,1,0,2,1,1,0.74,0.697,0.7,0,4,21,25,21
13390,7/17/2012,3,1,7,2,0,2,1,1,0.72,0.6818,0.7,0.0896,1,6,7,6
13391,7/17/2012,3,1,7,3,0,2,1,1,0.72,0.6818,0.66,0,0,3,3,3
13392,7/17/2012,3,1,7,4,0,2,1,1,0.72,0.6818,0.62,0,0,7,7,7
13393,7/17/2012,3,1,7,5,0,2,1,1,0.68,0.6364,0.74,0.0896,7,31,38,31
13394,7/17/2012,3,1,7,6,0,2,1,1,0.72,0.6818,0.66,0.1045,16,197,213,197
13395,7/17/2012,3,1,7,7,0,2,1,2,0.74,0.697,0.7,0,26,500,526,500
13396,7/17/2012,3,1,7,8,0,2,1,2,0.8,0.7576,0.55,0,43,618,661,618
13397,7/17/2012,3,1,7,9,0,2,1,2,0.82,0.7727,0.49,0.2239,32,288,320,288
13398,7/17/2012,3,1,7,10,0,2,1,2,0.84,0.7879,0.49,0.194,37,122,159,122
13399,7/17/2012,3,1,7,11,0,2,1,2,0.86,0.803,0.47,0,60,146,206,146
13400,7/17/2012,3,1,7,12,0,2,1,2,0.9,0.8182,0.35,0,80,174,254,174
13401,7/17/2012,3,1,7,13,0,2,1,1,0.92,0.8182,0.31,0.194,53,168,221,168
13402,7/17/2012,3,1,7,14,0,2,1,1,0.94,0.8333,0.29,0.2537,54,160,214,160
13403,7/17/2012,3,1,7,15,0,2,1,1,0.92,0.8182,0.31,0.1642,57,187,244,187
13404,7/17/2012,3,1,7,16,0,2,1,1,0.92,0.8182,0.29,0.1642,64,317,381,317
13405,7/17/2012,3,1,7,17,0,2,1,1,0.92,0.8182,0.29,0,95,675,770,675
13406,7/17/2012,3,1,7,18,0,2,1,1,0.9,0.803,0.33,0.194,60,712,772,712
13407,7/17/2012,3,1,7,19,0,2,1,1,0.88,0.7879,0.35,0.2537,69,478,547,478
13408,7/17/2012,3,1,7,20,0,2,1,1,0.86,0.7576,0.34,0.1642,52,375,427,375
13409,7/17/2012,3,1,7,21,0,2,1,1,0.82,0.7727,0.52,0.1343,50,283,333,283
13410,7/17/2012,3,1,7,22,0,2,1,1,0.8,0.7576,0.55,0.2239,29,215,244,215
13411,7/17/2012,3,1,7,23,0,2,1,1,0.78,0.7424,0.59,0.194,22,139,161,139
13412,7/18/2012,3,1,7,0,0,3,1,1,0.76,0.7273,0.66,0.1642,8,45,53,45
13413,7/18/2012,3,1,7,1,0,3,1,1,0.76,0.7273,0.66,0.1045,2,14,16,14
13414,7/18/2012,3,1,7,2,0,3,1,1,0.74,0.697,0.66,0.1343,3,5,8,5
13415,7/18/2012,3,1,7,3,0,3,1,1,0.74,0.697,0.66,0.1343,2,2,4,2
13416,7/18/2012,3,1,7,4,0,3,1,1,0.72,0.6818,0.7,0.1343,0,6,6,6
13417,7/18/2012,3,1,7,5,0,3,1,1,0.72,0.6818,0.7,0.1642,5,41,46,41
13418,7/18/2012,3,1,7,6,0,3,1,1,0.72,0.6818,0.7,0.1642,10,152,162,152
13419,7/18/2012,3,1,7,7,0,3,1,1,0.74,0.697,0.66,0.1642,23,472,495,472
13420,7/18/2012,3,1,7,8,0,3,1,1,0.78,0.7424,0.62,0.1045,55,624,679,624
13421,7/18/2012,3,1,7,9,0,3,1,1,0.82,0.7879,0.56,0,44,253,297,253
13422,7/18/2012,3,1,7,10,0,3,1,1,0.9,0.8485,0.42,0.194,39,99,138,99
13423,7/18/2012,3,1,7,11,0,3,1,1,0.9,0.8485,0.42,0,47,136,183,136
13424,7/18/2012,3,1,7,12,0,3,1,1,0.92,0.8636,0.37,0.1343,36,166,202,166
13425,7/18/2012,3,1,7,13,0,3,1,1,0.94,0.8485,0.33,0,49,154,203,154
13426,7/18/2012,3,1,7,14,0,3,1,1,0.94,0.8788,0.38,0.3284,54,116,170,116
13427,7/18/2012,3,1,7,15,0,3,1,3,0.92,0.8485,0.35,0.3582,42,152,194,152
13428,7/18/2012,3,1,7,16,0,3,1,1,0.74,0.697,0.66,0.2537,34,190,224,190
13429,7/18/2012,3,1,7,17,0,3,1,1,0.74,0.697,0.7,0.2537,35,335,370,335
13430,7/18/2012,3,1,7,18,0,3,1,2,0.76,0.7121,0.62,0.1343,63,580,643,580
13431,7/18/2012,3,1,7,19,0,3,1,2,0.76,0.7121,0.62,0.1045,78,438,516,438
13432,7/18/2012,3,1,7,20,0,3,1,1,0.74,0.6818,0.62,0.0896,56,310,366,310
13433,7/18/2012,3,1,7,21,0,3,1,1,0.76,0.7121,0.62,0,53,266,319,266
13434,7/18/2012,3,1,7,22,0,3,1,1,0.76,0.7121,0.58,0.0896,42,246,288,246
13435,7/18/2012,3,1,7,23,0,3,1,1,0.76,0.7121,0.58,0.0896,19,112,131,112
13436,7/19/2012,3,1,7,0,0,4,1,1,0.74,0.697,0.66,0.0896,16,50,66,50
13437,7/19/2012,3,1,7,1,0,4,1,1,0.74,0.697,0.66,0.0896,6,19,25,19
13438,7/19/2012,3,1,7,2,0,4,1,1,0.72,0.6818,0.7,0.194,0,7,7,7
13439,7/19/2012,3,1,7,3,0,4,1,1,0.72,0.6818,0.7,0.1045,1,4,5,4
13440,7/19/2012,3,1,7,4,0,4,1,1,0.72,0.6818,0.7,0.1045,0,8,8,8
13441,7/19/2012,3,1,7,5,0,4,1,2,0.72,0.6818,0.7,0.1045,5,35,40,35
13442,7/19/2012,3,1,7,6,0,4,1,1,0.72,0.6818,0.66,0.1343,8,144,152,144
13443,7/19/2012,3,1,7,7,0,4,1,1,0.74,0.6818,0.58,0.2836,23,450,473,450
13444,7/19/2012,3,1,7,8,0,4,1,1,0.76,0.7121,0.58,0.2537,32,625,657,625
13445,7/19/2012,3,1,7,9,0,4,1,2,0.76,0.7121,0.58,0.2836,36,282,318,282
13446,7/19/2012,3,1,7,10,0,4,1,1,0.76,0.7121,0.58,0.194,41,157,198,157
13447,7/19/2012,3,1,7,11,0,4,1,1,0.8,0.7576,0.55,0.1045,54,162,216,162
13448,7/19/2012,3,1,7,12,0,4,1,1,0.84,0.7879,0.49,0.2836,59,215,274,215
13449,7/19/2012,3,1,7,13,0,4,1,1,0.84,0.7727,0.47,0.1343,74,180,254,180
13450,7/19/2012,3,1,7,14,0,4,1,1,0.86,0.7879,0.44,0.0896,46,151,197,151
13451,7/19/2012,3,1,7,15,0,4,1,1,0.84,0.7727,0.47,0.0896,66,226,292,226
13452,7/19/2012,3,1,7,16,0,4,1,1,0.84,0.7727,0.47,0.0896,70,288,358,288
13453,7/19/2012,3,1,7,17,0,4,1,1,0.86,0.7879,0.41,0,93,678,771,678
13454,7/19/2012,3,1,7,18,0,4,1,1,0.86,0.7879,0.41,0.194,93,684,777,684
13455,7/19/2012,3,1,7,19,0,4,1,1,0.84,0.7576,0.44,0.2537,53,480,533,480
13456,7/19/2012,3,1,7,20,0,4,1,1,0.82,0.7727,0.49,0.1642,65,440,505,440
13457,7/19/2012,3,1,7,21,0,4,1,3,0.66,0.5909,0.89,0.2537,38,294,332,294
13458,7/19/2012,3,1,7,22,0,4,1,3,0.66,0.5909,0.89,0.2537,6,62,68,62
13459,7/19/2012,3,1,7,23,0,4,1,3,0.66,0.5909,0.89,0.2239,3,62,65,62
13460,7/20/2012,3,1,7,0,0,5,1,3,0.66,0.5909,0.89,0.0896,2,32,34,32
13461,7/20/2012,3,1,7,1,0,5,1,1,0.66,0.5909,0.89,0.1343,2,9,11,9
13462,7/20/2012,3,1,7,2,0,5,1,2,0.66,0.5909,0.89,0.0896,5,14,19,14
13463,7/20/2012,3,1,7,3,0,5,1,2,0.66,0.5909,0.89,0.1045,7,29,36,29
13464,7/20/2012,3,1,7,4,0,5,1,2,0.66,0.5909,0.89,0.1642,3,6,9,6
13465,7/20/2012,3,1,7,5,0,5,1,2,0.66,0.5909,0.89,0.1343,2,40,42,40
13466,7/20/2012,3,1,7,6,0,5,1,2,0.66,0.5909,0.89,0.1642,3,123,126,123
13467,7/20/2012,3,1,7,7,0,5,1,2,0.66,0.5909,0.89,0.194,14,346,360,346
13468,7/20/2012,3,1,7,8,0,5,1,2,0.68,0.6364,0.83,0.1642,39,652,691,652
13469,7/20/2012,3,1,7,9,0,5,1,2,0.7,0.6667,0.79,0.1343,45,328,373,328
13470,7/20/2012,3,1,7,10,0,5,1,2,0.7,0.6667,0.79,0.1642,51,182,233,182
13471,7/20/2012,3,1,7,11,0,5,1,3,0.72,0.697,0.74,0.194,51,161,212,161
13472,7/20/2012,3,1,7,12,0,5,1,3,0.68,0.6364,0.83,0.1642,41,233,274,233
13473,7/20/2012,3,1,7,13,0,5,1,3,0.68,0.6364,0.83,0.1045,20,136,156,136
13474,7/20/2012,3,1,7,14,0,5,1,3,0.7,0.6667,0.84,0.1642,53,176,229,176
13475,7/20/2012,3,1,7,15,0,5,1,2,0.7,0.6667,0.84,0.2985,47,169,216,169
13476,7/20/2012,3,1,7,16,0,5,1,2,0.68,0.6364,0.83,0.3284,70,366,436,366
13477,7/20/2012,3,1,7,17,0,5,1,2,0.66,0.5909,0.89,0.4179,95,620,715,620
13478,7/20/2012,3,1,7,18,0,5,1,2,0.66,0.6061,0.78,0.3284,73,549,622,549
13479,7/20/2012,3,1,7,19,0,5,1,2,0.64,0.5758,0.83,0.2836,44,358,402,358
13480,7/20/2012,3,1,7,20,0,5,1,3,0.64,0.5758,0.83,0.3881,35,216,251,216
13481,7/20/2012,3,1,7,21,0,5,1,3,0.62,0.5758,0.83,0.3284,14,108,122,108
13482,7/20/2012,3,1,7,22,0,5,1,2,0.62,0.5758,0.83,0.194,13,122,135,122
13483,7/20/2012,3,1,7,23,0,5,1,2,0.62,0.5758,0.83,0.2836,18,148,166,148
13484,7/21/2012,3,1,7,0,0,6,0,3,0.62,0.5758,0.83,0.2836,11,92,103,92
13485,7/21/2012,3,1,7,1,0,6,0,2,0.62,0.5758,0.83,0.2537,10,62,72,62
13486,7/21/2012,3,1,7,2,0,6,0,3,0.6,0.5455,0.88,0.2836,5,55,60,55
13487,7/21/2012,3,1,7,3,0,6,0,3,0.6,0.5455,0.88,0.2537,7,18,25,18
13488,7/21/2012,3,1,7,4,0,6,0,3,0.58,0.5455,0.88,0.2836,11,5,16,5
13489,7/21/2012,3,1,7,5,0,6,0,3,0.58,0.5455,0.88,0.2537,7,10,17,10
13490,7/21/2012,3,1,7,6,0,6,0,3,0.58,0.5455,0.88,0.2537,3,12,15,12
13491,7/21/2012,3,1,7,7,0,6,0,2,0.58,0.5455,0.88,0.2537,8,29,37,29
13492,7/21/2012,3,1,7,8,0,6,0,2,0.58,0.5455,0.83,0.2537,18,94,112,94
13493,7/21/2012,3,1,7,9,0,6,0,2,0.58,0.5455,0.83,0.194,32,175,207,175
13494,7/21/2012,3,1,7,10,0,6,0,3,0.58,0.5455,0.88,0.2537,49,219,268,219
13495,7/21/2012,3,1,7,11,0,6,0,2,0.6,0.5606,0.83,0.2537,80,225,305,225
13496,7/21/2012,3,1,7,12,0,6,0,3,0.6,0.5606,0.83,0.2239,156,301,457,301
13497,7/21/2012,3,1,7,13,0,6,0,3,0.6,0.5606,0.83,0.1642,106,248,354,248
13498,7/21/2012,3,1,7,14,0,6,0,2,0.6,0.5455,0.88,0.2537,121,222,343,222
13499,7/21/2012,3,1,7,15,0,6,0,3,0.6,0.5455,0.88,0.2537,148,232,380,232
13500,7/21/2012,3,1,7,16,0,6,0,3,0.6,0.5455,0.88,0.194,130,196,326,196
13501,7/21/2012,3,1,7,17,0,6,0,3,0.6,0.5455,0.88,0.1642,92,149,241,149
13502,7/21/2012,3,1,7,18,0,6,0,2,0.6,0.5455,0.88,0.194,51,126,177,126
13503,7/21/2012,3,1,7,19,0,6,0,2,0.6,0.5455,0.88,0.1642,67,171,238,171
13504,7/21/2012,3,1,7,20,0,6,0,3,0.6,0.5455,0.88,0.1642,51,163,214,163
13505,7/21/2012,3,1,7,21,0,6,0,2,0.6,0.5455,0.88,0.1642,29,134,163,134
13506,7/21/2012,3,1,7,22,0,6,0,2,0.6,0.5455,0.88,0.1045,40,140,180,140
13507,7/21/2012,3,1,7,23,0,6,0,2,0.6,0.5455,0.88,0,32,117,149,117
13508,7/22/2012,3,1,7,0,0,0,0,2,0.6,0.5455,0.88,0.1045,17,96,113,96
13509,7/22/2012,3,1,7,1,0,0,0,2,0.6,0.5455,0.88,0.1642,31,99,130,99
13510,7/22/2012,3,1,7,2,0,0,0,2,0.6,0.5455,0.88,0.1045,32,90,122,90
13511,7/22/2012,3,1,7,3,0,0,0,2,0.6,0.5455,0.88,0.1045,13,30,43,30
13512,7/22/2012,3,1,7,4,0,0,0,1,0.6,0.5455,0.88,0,6,10,16,10
13513,7/22/2012,3,1,7,5,0,0,0,1,0.6,0.5455,0.88,0,0,6,6,6
13514,7/22/2012,3,1,7,6,0,0,0,2,0.62,0.5758,0.83,0.0896,5,14,19,14
13515,7/22/2012,3,1,7,7,0,0,0,2,0.62,0.5758,0.83,0,13,25,38,25
13516,7/22/2012,3,1,7,8,0,0,0,2,0.64,0.5909,0.78,0,31,122,153,122
13517,7/22/2012,3,1,7,9,0,0,0,2,0.66,0.6212,0.69,0,79,179,258,179
13518,7/22/2012,3,1,7,10,0,0,0,2,0.66,0.6212,0.74,0,114,265,379,265
13519,7/22/2012,3,1,7,11,0,0,0,2,0.66,0.6212,0.74,0,191,314,505,314
13520,7/22/2012,3,1,7,12,0,0,0,2,0.7,0.6515,0.7,0.1045,178,326,504,326
13521,7/22/2012,3,1,7,13,0,0,0,2,0.7,0.6515,0.65,0.0896,238,388,626,388
13522,7/22/2012,3,1,7,14,0,0,0,1,0.72,0.6818,0.66,0.1045,256,360,616,360
13523,7/22/2012,3,1,7,15,0,0,0,1,0.72,0.6818,0.66,0.1045,254,370,624,370
13524,7/22/2012,3,1,7,16,0,0,0,1,0.74,0.697,0.66,0.1045,245,383,628,383
13525,7/22/2012,3,1,7,17,0,0,0,1,0.74,0.697,0.66,0.2239,188,368,556,368
13526,7/22/2012,3,1,7,18,0,0,0,1,0.74,0.697,0.66,0.1642,173,342,515,342
13527,7/22/2012,3,1,7,19,0,0,0,1,0.72,0.6818,0.7,0.1642,180,342,522,342
13528,7/22/2012,3,1,7,20,0,0,0,1,0.7,0.6667,0.74,0.1642,124,254,378,254
13529,7/22/2012,3,1,7,21,0,0,0,1,0.7,0.6667,0.79,0.1045,88,257,345,257
13530,7/22/2012,3,1,7,22,0,0,0,1,0.7,0.6667,0.74,0.194,55,136,191,136
13531,7/22/2012,3,1,7,23,0,0,0,1,0.68,0.6364,0.79,0.1642,33,90,123,90
13532,7/23/2012,3,1,7,0,0,1,1,1,0.66,0.5909,0.89,0.0896,11,36,47,36
13533,7/23/2012,3,1,7,1,0,1,1,1,0.66,0.5909,0.89,0.194,7,20,27,20
13534,7/23/2012,3,1,7,2,0,1,1,2,0.66,0.5909,0.94,0.0896,3,14,17,14
13535,7/23/2012,3,1,7,3,0,1,1,2,0.66,0.5909,0.94,0.0896,0,2,2,2
13536,7/23/2012,3,1,7,4,0,1,1,2,0.66,0.5909,0.94,0.1343,0,8,8,8
13537,7/23/2012,3,1,7,5,0,1,1,2,0.66,0.5909,0.94,0.1343,3,48,51,48
13538,7/23/2012,3,1,7,6,0,1,1,2,0.68,0.6364,0.89,0.0896,9,148,157,148
13539,7/23/2012,3,1,7,7,0,1,1,1,0.7,0.6667,0.84,0.1343,17,404,421,404
13540,7/23/2012,3,1,7,8,0,1,1,1,0.72,0.697,0.79,0.1045,47,691,738,691
13541,7/23/2012,3,1,7,9,0,1,1,2,0.74,0.7121,0.74,0.1343,57,288,345,288
13542,7/23/2012,3,1,7,10,0,1,1,2,0.78,0.7424,0.62,0,63,137,200,137
13543,7/23/2012,3,1,7,11,0,1,1,2,0.8,0.7424,0.52,0.1642,69,129,198,129
13544,7/23/2012,3,1,7,12,0,1,1,2,0.8,0.7424,0.52,0.1642,109,205,314,205
13545,7/23/2012,3,1,7,13,0,1,1,2,0.8,0.7424,0.52,0.1045,64,176,240,176
13546,7/23/2012,3,1,7,14,0,1,1,2,0.78,0.7424,0.59,0.1642,82,189,271,189
13547,7/23/2012,3,1,7,15,0,1,1,1,0.8,0.7576,0.55,0.194,76,205,281,205
13548,7/23/2012,3,1,7,16,0,1,1,1,0.82,0.7727,0.52,0.1343,111,346,457,346
13549,7/23/2012,3,1,7,17,0,1,1,1,0.82,0.7727,0.52,0.1343,87,760,847,760
13550,7/23/2012,3,1,7,18,0,1,1,1,0.82,0.7576,0.46,0.1045,69,672,741,672
13551,7/23/2012,3,1,7,19,0,1,1,1,0.8,0.7424,0.52,0.2537,94,488,582,488
13552,7/23/2012,3,1,7,20,0,1,1,1,0.76,0.7121,0.62,0.1642,56,347,403,347
13553,7/23/2012,3,1,7,21,0,1,1,1,0.76,0.7121,0.62,0.194,45,251,296,251
13554,7/23/2012,3,1,7,22,0,1,1,1,0.74,0.6818,0.62,0.194,40,169,209,169
13555,7/23/2012,3,1,7,23,0,1,1,1,0.72,0.6818,0.66,0.1642,16,98,114,98
13556,7/24/2012,3,1,7,0,0,2,1,1,0.7,0.6667,0.74,0.1343,12,52,64,52
13557,7/24/2012,3,1,7,1,0,2,1,1,0.68,0.6364,0.79,0.1642,7,10,17,10
13558,7/24/2012,3,1,7,2,0,2,1,1,0.66,0.6061,0.83,0.1642,6,10,16,10
13559,7/24/2012,3,1,7,3,0,2,1,1,0.66,0.6061,0.83,0.1642,1,5,6,5
13560,7/24/2012,3,1,7,4,0,2,1,1,0.66,0.6061,0.83,0.0896,0,6,6,6
13561,7/24/2012,3,1,7,5,0,2,1,1,0.66,0.6061,0.83,0.1045,5,45,50,45
13562,7/24/2012,3,1,7,6,0,2,1,1,0.66,0.6061,0.83,0.1343,17,173,190,173
13563,7/24/2012,3,1,7,7,0,2,1,1,0.7,0.6667,0.74,0.1642,24,492,516,492
13564,7/24/2012,3,1,7,8,0,2,1,1,0.74,0.697,0.7,0.194,49,694,743,694
13565,7/24/2012,3,1,7,9,0,2,1,1,0.84,0.803,0.53,0,40,299,339,299
13566,7/24/2012,3,1,7,10,0,2,1,1,0.82,0.7879,0.56,0.2985,62,156,218,156
13567,7/24/2012,3,1,7,11,0,2,1,2,0.84,0.803,0.53,0.3284,45,156,201,156
13568,7/24/2012,3,1,7,12,0,2,1,2,0.82,0.7879,0.56,0.2239,60,169,229,169
13569,7/24/2012,3,1,7,13,0,2,1,2,0.84,0.803,0.53,0.2985,73,200,273,200
13570,7/24/2012,3,1,7,14,0,2,1,2,0.84,0.803,0.53,0.2239,48,196,244,196
13571,7/24/2012,3,1,7,15,0,2,1,1,0.82,0.7727,0.49,0.2985,73,212,285,212
13572,7/24/2012,3,1,7,16,0,2,1,1,0.8,0.7576,0.55,0.2985,86,369,455,369
13573,7/24/2012,3,1,7,17,0,2,1,1,0.8,0.7424,0.52,0.3284,94,775,869,775
13574,7/24/2012,3,1,7,18,0,2,1,1,0.76,0.7121,0.62,0.3284,110,767,877,767
13575,7/24/2012,3,1,7,19,0,2,1,1,0.76,0.7121,0.62,0.1642,109,523,632,523
13576,7/24/2012,3,1,7,20,0,2,1,1,0.74,0.697,0.66,0.1642,85,438,523,438
13577,7/24/2012,3,1,7,21,0,2,1,1,0.74,0.697,0.66,0.2239,53,325,378,325
13578,7/24/2012,3,1,7,22,0,2,1,1,0.74,0.697,0.66,0.2537,43,226,269,226
13579,7/24/2012,3,1,7,23,0,2,1,1,0.74,0.6818,0.58,0.3284,38,154,192,154
13580,7/25/2012,3,1,7,0,0,3,1,1,0.72,0.6667,0.58,0.2985,9,57,66,57
13581,7/25/2012,3,1,7,1,0,3,1,1,0.7,0.6515,0.58,0.194,2,26,28,26
13582,7/25/2012,3,1,7,2,0,3,1,1,0.68,0.6364,0.61,0.2239,1,11,12,11
13583,7/25/2012,3,1,7,3,0,3,1,1,0.66,0.6212,0.65,0.2239,1,11,12,11
13584,7/25/2012,3,1,7,4,0,3,1,1,0.64,0.6061,0.65,0.2239,0,4,4,4
13585,7/25/2012,3,1,7,5,0,3,1,1,0.64,0.6061,0.65,0.1642,5,54,59,54
13586,7/25/2012,3,1,7,6,0,3,1,1,0.64,0.6061,0.65,0.194,11,179,190,179
13587,7/25/2012,3,1,7,7,0,3,1,1,0.66,0.6212,0.5,0.3284,34,473,507,473
13588,7/25/2012,3,1,7,8,0,3,1,1,0.7,0.6364,0.42,0.2537,43,745,788,745
13589,7/25/2012,3,1,7,9,0,3,1,1,0.72,0.6515,0.37,0.2985,65,277,342,277
13590,7/25/2012,3,1,7,10,0,3,1,1,0.74,0.6515,0.37,0,68,163,231,163
13591,7/25/2012,3,1,7,11,0,3,1,1,0.76,0.6667,0.33,0,79,202,281,202
13592,7/25/2012,3,1,7,12,0,3,1,1,0.76,0.6667,0.33,0,77,233,310,233
13593,7/25/2012,3,1,7,13,0,3,1,1,0.78,0.6818,0.31,0.1642,81,231,312,231
13594,7/25/2012,3,1,7,14,0,3,1,1,0.8,0.697,0.29,0.1343,88,159,247,159
13595,7/25/2012,3,1,7,15,0,3,1,1,0.78,0.6818,0.31,0.0896,94,223,317,223
13596,7/25/2012,3,1,7,16,0,3,1,1,0.8,0.697,0.29,0.1642,91,393,484,393
13597,7/25/2012,3,1,7,17,0,3,1,1,0.8,0.697,0.31,0,130,783,913,783
13598,7/25/2012,3,1,7,18,0,3,1,1,0.8,0.697,0.27,0.1343,104,787,891,787
13599,7/25/2012,3,1,7,19,0,3,1,1,0.76,0.6667,0.33,0.1343,116,582,698,582
13600,7/25/2012,3,1,7,20,0,3,1,1,0.74,0.6515,0.4,0.1642,106,461,567,461
13601,7/25/2012,3,1,7,21,0,3,1,1,0.72,0.6515,0.45,0.1343,71,326,397,326
13602,7/25/2012,3,1,7,22,0,3,1,1,0.7,0.6515,0.58,0.1343,55,223,278,223
13603,7/25/2012,3,1,7,23,0,3,1,1,0.68,0.6364,0.57,0.2985,52,187,239,187
13604,7/26/2012,3,1,7,0,0,4,1,1,0.66,0.6212,0.65,0.194,27,65,92,65
13605,7/26/2012,3,1,7,1,0,4,1,1,0.66,0.6212,0.65,0.2239,6,23,29,23
13606,7/26/2012,3,1,7,2,0,4,1,1,0.66,0.6212,0.69,0.2537,5,16,21,16
13607,7/26/2012,3,1,7,3,0,4,1,1,0.66,0.6212,0.69,0.2239,0,8,8,8
13608,7/26/2012,3,1,7,4,0,4,1,1,0.66,0.6212,0.74,0.194,0,4,4,4
13609,7/26/2012,3,1,7,5,0,4,1,1,0.66,0.6212,0.74,0.194,2,40,42,40
13610,7/26/2012,3,1,7,6,0,4,1,1,0.66,0.6061,0.78,0.2537,16,165,181,165
13611,7/26/2012,3,1,7,7,0,4,1,1,0.7,0.6667,0.74,0.2537,17,478,495,478
13612,7/26/2012,3,1,7,8,0,4,1,2,0.7,0.6667,0.74,0.2537,49,680,729,680
13613,7/26/2012,3,1,7,9,0,4,1,2,0.72,0.6818,0.7,0.1343,55,289,344,289
13614,7/26/2012,3,1,7,10,0,4,1,1,0.74,0.697,0.7,0.2239,79,143,222,143
13615,7/26/2012,3,1,7,11,0,4,1,1,0.8,0.803,0.66,0.2239,69,143,212,143
13616,7/26/2012,3,1,7,12,0,4,1,1,0.84,0.8182,0.56,0.2537,73,206,279,206
13617,7/26/2012,3,1,7,13,0,4,1,1,0.86,0.8333,0.53,0.2985,53,189,242,189
13618,7/26/2012,3,1,7,14,0,4,1,1,0.9,0.8788,0.47,0.2537,62,151,213,151
13619,7/26/2012,3,1,7,15,0,4,1,1,0.92,0.8939,0.42,0.2985,65,173,238,173
13620,7/26/2012,3,1,7,16,0,4,1,1,0.94,0.8788,0.38,0.3881,62,312,374,312
13621,7/26/2012,3,1,7,17,0,4,1,1,0.9,0.8636,0.45,0.4179,110,628,738,628
13622,7/26/2012,3,1,7,18,0,4,1,1,0.92,0.8788,0.4,0.3582,73,615,688,615
13623,7/26/2012,3,1,7,19,0,4,1,1,0.9,0.8636,0.45,0.3284,80,534,614,534
13624,7/26/2012,3,1,7,20,0,4,1,1,0.86,0.8182,0.5,0.2537,47,399,446,399
13625,7/26/2012,3,1,7,21,0,4,1,1,0.8,0.7424,0.49,0.6119,35,236,271,236
13626,7/26/2012,3,1,7,22,0,4,1,1,0.8,0.7424,0.49,0.6119,33,201,234,201
13627,7/26/2012,3,1,7,23,0,4,1,1,0.72,0.6818,0.7,0.1343,18,127,145,127
13628,7/27/2012,3,1,7,0,0,5,1,1,0.72,0.6818,0.7,0,14,83,97,83
13629,7/27/2012,3,1,7,1,0,5,1,1,0.72,0.6818,0.7,0.1045,12,42,54,42
13630,7/27/2012,3,1,7,2,0,5,1,1,0.7,0.6667,0.79,0.1343,8,18,26,18
13631,7/27/2012,3,1,7,3,0,5,1,1,0.7,0.6667,0.74,0.1642,3,9,12,9
13632,7/27/2012,3,1,7,4,0,5,1,1,0.7,0.6667,0.79,0,3,5,8,5
13633,7/27/2012,3,1,7,5,0,5,1,1,0.7,0.6667,0.84,0,3,34,37,34
13634,7/27/2012,3,1,7,6,0,5,1,1,0.7,0.6667,0.79,0,10,129,139,129
13635,7/27/2012,3,1,7,7,0,5,1,1,0.72,0.6818,0.7,0.194,13,397,410,397
13636,7/27/2012,3,1,7,8,0,5,1,1,0.76,0.7273,0.66,0.0896,34,642,676,642
13637,7/27/2012,3,1,7,9,0,5,1,1,0.82,0.7727,0.49,0.2836,34,329,363,329
13638,7/27/2012,3,1,7,10,0,5,1,1,0.84,0.7727,0.47,0,85,146,231,146
13639,7/27/2012,3,1,7,11,0,5,1,1,0.84,0.7727,0.47,0.3284,67,184,251,184
13640,7/27/2012,3,1,7,12,0,5,1,1,0.84,0.7879,0.49,0.3582,92,207,299,207
13641,7/27/2012,3,1,7,13,0,5,1,1,0.84,0.7727,0.47,0.2836,83,231,314,231
13642,7/27/2012,3,1,7,14,0,5,1,1,0.86,0.803,0.47,0.2985,105,221,326,221
13643,7/27/2012,3,1,7,15,0,5,1,1,0.86,0.7879,0.41,0.2239,81,242,323,242
13644,7/27/2012,3,1,7,16,0,5,1,1,0.84,0.7727,0.47,0.2239,80,419,499,419
13645,7/27/2012,3,1,7,17,0,5,1,1,0.86,0.7879,0.41,0.2836,101,598,699,598
13646,7/27/2012,3,1,7,18,0,5,1,1,0.82,0.7576,0.46,0.1642,100,522,622,522
13647,7/27/2012,3,1,7,19,0,5,1,1,0.82,0.7727,0.52,0.194,93,423,516,423
13648,7/27/2012,3,1,7,20,0,5,1,1,0.78,0.7424,0.59,0.1045,85,269,354,269
13649,7/27/2012,3,1,7,21,0,5,1,1,0.78,0.7424,0.59,0.1045,71,189,260,189
13650,7/27/2012,3,1,7,22,0,5,1,1,0.78,0.7424,0.59,0.1343,48,151,199,151
13651,7/27/2012,3,1,7,23,0,5,1,1,0.76,0.7273,0.66,0,34,155,189,155
13652,7/28/2012,3,1,7,0,0,6,0,1,0.74,0.6818,0.62,0.1343,21,170,191,170
13653,7/28/2012,3,1,7,1,0,6,0,1,0.72,0.6818,0.7,0.0896,11,69,80,69
13654,7/28/2012,3,1,7,2,0,6,0,1,0.72,0.6818,0.7,0,14,76,90,76
13655,7/28/2012,3,1,7,3,0,6,0,1,0.72,0.6818,0.7,0,10,33,43,33
13656,7/28/2012,3,1,7,4,0,6,0,1,0.7,0.6667,0.79,0.194,1,10,11,10
13657,7/28/2012,3,1,7,5,0,6,0,1,0.68,0.6364,0.79,0.1642,4,10,14,10
13658,7/28/2012,3,1,7,6,0,6,0,1,0.7,0.6515,0.7,0.1045,10,40,50,40
13659,7/28/2012,3,1,7,7,0,6,0,1,0.72,0.6818,0.7,0.1343,18,58,76,58
13660,7/28/2012,3,1,7,8,0,6,0,1,0.74,0.697,0.66,0.1642,36,127,163,127
13661,7/28/2012,3,1,7,9,0,6,0,1,0.78,0.7424,0.59,0.1045,110,227,337,227
13662,7/28/2012,3,1,7,10,0,6,0,1,0.82,0.7727,0.52,0.2239,129,266,395,266
13663,7/28/2012,3,1,7,11,0,6,0,1,0.84,0.7424,0.39,0.2239,162,295,457,295
13664,7/28/2012,3,1,7,12,0,6,0,1,0.84,0.7576,0.41,0.2239,157,330,487,330
13665,7/28/2012,3,1,7,13,0,6,0,1,0.86,0.7879,0.41,0.2836,173,325,498,325
13666,7/28/2012,3,1,7,14,0,6,0,1,0.86,0.7727,0.39,0.2537,186,308,494,308
13667,7/28/2012,3,1,7,15,0,6,0,1,0.88,0.7727,0.32,0.2836,206,291,497,291
13668,7/28/2012,3,1,7,16,0,6,0,1,0.86,0.7727,0.39,0.2239,208,279,487,279
13669,7/28/2012,3,1,7,17,0,6,0,1,0.82,0.7576,0.46,0.194,199,280,479,280
13670,7/28/2012,3,1,7,18,0,6,0,1,0.82,0.7424,0.43,0.2836,151,330,481,330
13671,7/28/2012,3,1,7,19,0,6,0,1,0.68,0.6364,0.83,0,115,223,338,223
13672,7/28/2012,3,1,7,20,0,6,0,1,0.66,0.6061,0.83,0.2239,79,154,233,154
13673,7/28/2012,3,1,7,21,0,6,0,1,0.66,0.6061,0.78,0.0896,94,206,300,206
13674,7/28/2012,3,1,7,22,0,6,0,1,0.66,0.6061,0.78,0.0896,88,188,276,188
13675,7/28/2012,3,1,7,23,0,6,0,1,0.66,0.6061,0.83,0.0896,52,156,208,156
13676,7/29/2012,3,1,7,0,0,0,0,1,0.66,0.5909,0.89,0.1343,59,129,188,129
13677,7/29/2012,3,1,7,1,0,0,0,1,0.66,0.6061,0.83,0.1045,49,109,158,109
13678,7/29/2012,3,1,7,2,0,0,0,1,0.66,0.6212,0.74,0.1343,33,79,112,79
13679,7/29/2012,3,1,7,3,0,0,0,1,0.66,0.6212,0.69,0.2239,18,37,55,37
13680,7/29/2012,3,1,7,4,0,0,0,1,0.64,0.6061,0.69,0.194,2,11,13,11
13681,7/29/2012,3,1,7,5,0,0,0,1,0.62,0.5909,0.78,0.194,3,14,17,14
13682,7/29/2012,3,1,7,6,0,0,0,1,0.64,0.6061,0.73,0.1642,6,12,18,12
13683,7/29/2012,3,1,7,7,0,0,0,1,0.66,0.6212,0.69,0.2537,4,36,40,36
13684,7/29/2012,3,1,7,8,0,0,0,1,0.7,0.6515,0.65,0.2239,37,90,127,90
13685,7/29/2012,3,1,7,9,0,0,0,1,0.72,0.6818,0.62,0.2537,64,162,226,162
13686,7/29/2012,3,1,7,10,0,0,0,1,0.74,0.6818,0.62,0,123,258,381,258
13687,7/29/2012,3,1,7,11,0,0,0,1,0.76,0.697,0.55,0.2239,183,326,509,326
13688,7/29/2012,3,1,7,12,0,0,0,1,0.76,0.697,0.55,0.3284,154,357,511,357
13689,7/29/2012,3,1,7,13,0,0,0,1,0.8,0.7424,0.49,0.2239,181,302,483,302
13690,7/29/2012,3,1,7,14,0,0,0,1,0.8,0.7273,0.46,0.194,231,291,522,291
13691,7/29/2012,3,1,7,15,0,0,0,1,0.8,0.7273,0.43,0.1343,195,306,501,306
13692,7/29/2012,3,1,7,16,0,0,0,1,0.8,0.7273,0.43,0.1343,191,330,521,330
13693,7/29/2012,3,1,7,17,0,0,0,1,0.82,0.7424,0.41,0.1642,164,367,531,367
13694,7/29/2012,3,1,7,18,0,0,0,1,0.8,0.7121,0.41,0.2985,117,302,419,302
13695,7/29/2012,3,1,7,19,0,0,0,1,0.76,0.697,0.55,0.1642,143,300,443,300
13696,7/29/2012,3,1,7,20,0,0,0,1,0.74,0.697,0.66,0.1045,75,228,303,228
13697,7/29/2012,3,1,7,21,0,0,0,1,0.72,0.6818,0.7,0.1343,72,199,271,199
13698,7/29/2012,3,1,7,22,0,0,0,1,0.7,0.6515,0.7,0.1045,31,117,148,117
13699,7/29/2012,3,1,7,23,0,0,0,1,0.7,0.6515,0.7,0,18,82,100,82
13700,7/30/2012,3,1,7,0,0,1,1,1,0.7,0.6667,0.74,0.0896,12,46,58,46
13701,7/30/2012,3,1,7,1,0,1,1,1,0.7,0.6667,0.74,0,4,15,19,15
13702,7/30/2012,3,1,7,2,0,1,1,1,0.68,0.6364,0.74,0,2,6,8,6
13703,7/30/2012,3,1,7,3,0,1,1,1,0.66,0.6061,0.83,0,0,3,3,3
13704,7/30/2012,3,1,7,4,0,1,1,1,0.66,0.6061,0.83,0,0,5,5,5
13705,7/30/2012,3,1,7,5,0,1,1,1,0.66,0.6061,0.83,0.1045,4,43,47,43
13706,7/30/2012,3,1,7,6,0,1,1,1,0.66,0.6061,0.83,0.1642,6,155,161,155
13707,7/30/2012,3,1,7,7,0,1,1,1,0.7,0.6667,0.79,0.0896,14,455,469,455
13708,7/30/2012,3,1,7,8,0,1,1,2,0.72,0.697,0.74,0.1045,31,720,751,720
13709,7/30/2012,3,1,7,9,0,1,1,2,0.74,0.697,0.7,0,34,259,293,259
13710,7/30/2012,3,1,7,10,0,1,1,2,0.74,0.697,0.66,0.2239,54,135,189,135
13711,7/30/2012,3,1,7,11,0,1,1,2,0.78,0.7273,0.55,0.1343,69,146,215,146
13712,7/30/2012,3,1,7,12,0,1,1,2,0.76,0.7121,0.58,0.1045,77,201,278,201
13713,7/30/2012,3,1,7,13,0,1,1,1,0.8,0.7424,0.49,0.1642,57,169,226,169
13714,7/30/2012,3,1,7,14,0,1,1,1,0.8,0.7424,0.49,0.2239,87,167,254,167
13715,7/30/2012,3,1,7,15,0,1,1,1,0.8,0.7424,0.49,0.2537,51,185,236,185
13716,7/30/2012,3,1,7,16,0,1,1,1,0.8,0.7424,0.49,0.2836,88,337,425,337
13717,7/30/2012,3,1,7,17,0,1,1,1,0.76,0.697,0.55,0.3284,62,765,827,765
13718,7/30/2012,3,1,7,18,0,1,1,1,0.76,0.7121,0.58,0.4179,77,735,812,735
13719,7/30/2012,3,1,7,19,0,1,1,1,0.82,0.7727,0.52,0.1642,81,584,665,584
13720,7/30/2012,3,1,7,20,0,1,1,1,0.72,0.6818,0.7,0.2239,78,384,462,384
13721,7/30/2012,3,1,7,21,0,1,1,1,0.72,0.6818,0.7,0.194,71,251,322,251
13722,7/30/2012,3,1,7,22,0,1,1,2,0.7,0.6667,0.74,0.2239,47,183,230,183
13723,7/30/2012,3,1,7,23,0,1,1,1,0.7,0.6667,0.74,0.194,34,116,150,116
13724,7/31/2012,3,1,7,0,0,2,1,1,0.68,0.6364,0.79,0.1343,11,27,38,27
13725,7/31/2012,3,1,7,1,0,2,1,1,0.66,0.6061,0.83,0.1343,3,18,21,18
13726,7/31/2012,3,1,7,2,0,2,1,1,0.66,0.6061,0.83,0.1343,0,8,8,8
13727,7/31/2012,3,1,7,3,0,2,1,1,0.66,0.6061,0.83,0.0896,1,5,6,5
13728,7/31/2012,3,1,7,4,0,2,1,1,0.66,0.6061,0.83,0.0896,0,6,6,6
13729,7/31/2012,3,1,7,5,0,2,1,1,0.66,0.6061,0.83,0.1642,5,40,45,40
13730,7/31/2012,3,1,7,6,0,2,1,1,0.64,0.5758,0.89,0.1642,2,192,194,192
13731,7/31/2012,3,1,7,7,0,2,1,1,0.68,0.6364,0.83,0.2239,21,492,513,492
13732,7/31/2012,3,1,7,8,0,2,1,1,0.7,0.6667,0.79,0.1343,30,730,760,730
13733,7/31/2012,3,1,7,9,0,2,1,1,0.72,0.6818,0.7,0.1045,31,302,333,302
13734,7/31/2012,3,1,7,10,0,2,1,1,0.72,0.6818,0.66,0,73,154,227,154
13735,7/31/2012,3,1,7,11,0,2,1,1,0.76,0.7121,0.58,0,54,170,224,170
13736,7/31/2012,3,1,7,12,0,2,1,1,0.8,0.7273,0.46,0,50,198,248,198
13737,7/31/2012,3,1,7,13,0,2,1,1,0.8,0.7576,0.55,0.2836,69,219,288,219
13738,7/31/2012,3,1,7,14,0,2,1,1,0.8,0.7576,0.55,0.2836,72,188,260,188
13739,7/31/2012,3,1,7,15,0,2,1,1,0.76,0.7121,0.62,0.1343,29,115,144,115
13740,7/31/2012,3,1,7,16,0,2,1,1,0.76,0.7121,0.58,0.2239,66,336,402,336
13741,7/31/2012,3,1,7,17,0,2,1,1,0.78,0.7121,0.52,0.2239,94,726,820,726
13742,7/31/2012,3,1,7,18,0,2,1,1,0.76,0.697,0.55,0.2836,99,758,857,758
13743,7/31/2012,3,1,7,19,0,2,1,3,0.74,0.6818,0.62,0.3582,90,524,614,524
13744,7/31/2012,3,1,7,20,0,2,1,3,0.7,0.6515,0.7,0.194,55,397,452,397
13745,7/31/2012,3,1,7,21,0,2,1,1,0.68,0.6364,0.79,0.194,60,292,352,292
13746,7/31/2012,3,1,7,22,0,2,1,1,0.68,0.6364,0.74,0.2537,33,224,257,224
13747,7/31/2012,3,1,7,23,0,2,1,2,0.66,0.6061,0.83,0.1642,20,127,147,127
13748,8/1/2012,3,1,8,0,0,3,1,1,0.68,0.6364,0.79,0.1642,3,44,47,44
13749,8/1/2012,3,1,8,1,0,3,1,1,0.66,0.6061,0.83,0.0896,5,28,33,28
13750,8/1/2012,3,1,8,2,0,3,1,1,0.64,0.5758,0.83,0.1045,0,13,13,13
13751,8/1/2012,3,1,8,3,0,3,1,1,0.64,0.5758,0.83,0.1045,0,7,7,7
13752,8/1/2012,3,1,8,4,0,3,1,2,0.64,0.5909,0.78,0.1343,1,3,4,3
13753,8/1/2012,3,1,8,5,0,3,1,2,0.64,0.5909,0.78,0.1343,3,46,49,46
13754,8/1/2012,3,1,8,6,0,3,1,1,0.64,0.5909,0.78,0.1343,6,179,185,179
13755,8/1/2012,3,1,8,7,0,3,1,2,0.64,0.5758,0.83,0.1343,19,468,487,468
13756,8/1/2012,3,1,8,8,0,3,1,2,0.66,0.6061,0.78,0.194,32,649,681,649
13757,8/1/2012,3,1,8,9,0,3,1,2,0.68,0.6364,0.74,0.0896,34,316,350,316
13758,8/1/2012,3,1,8,10,0,3,1,1,0.72,0.6818,0.66,0.0896,61,175,236,175
13759,8/1/2012,3,1,8,11,0,3,1,1,0.76,0.7121,0.58,0.0896,54,180,234,180
13760,8/1/2012,3,1,8,12,0,3,1,1,0.8,0.7424,0.49,0.1045,75,209,284,209
13761,8/1/2012,3,1,8,13,0,3,1,1,0.8,0.7424,0.52,0.1642,59,221,280,221
13762,8/1/2012,3,1,8,14,0,3,1,1,0.82,0.7576,0.46,0.1642,88,175,263,175
13763,8/1/2012,3,1,8,15,0,3,1,1,0.82,0.7576,0.46,0.1642,89,206,295,206
13764,8/1/2012,3,1,8,16,0,3,1,1,0.8,0.7576,0.55,0.2836,93,386,479,386
13765,8/1/2012,3,1,8,17,0,3,1,1,0.8,0.7424,0.49,0.1642,103,734,837,734
13766,8/1/2012,3,1,8,18,0,3,1,3,0.76,0.7121,0.62,0.2239,105,786,891,786
13767,8/1/2012,3,1,8,19,0,3,1,1,0.74,0.697,0.66,0.2537,88,564,652,564
13768,8/1/2012,3,1,8,20,0,3,1,1,0.74,0.697,0.66,0.1642,65,448,513,448
13769,8/1/2012,3,1,8,21,0,3,1,1,0.72,0.6818,0.7,0.1343,36,284,320,284
13770,8/1/2012,3,1,8,22,0,3,1,1,0.72,0.6818,0.7,0.1045,37,251,288,251
13771,8/1/2012,3,1,8,23,0,3,1,1,0.7,0.6667,0.74,0,18,134,152,134
13772,8/2/2012,3,1,8,0,0,4,1,1,0.7,0.6667,0.74,0,8,55,63,55
13773,8/2/2012,3,1,8,1,0,4,1,1,0.68,0.6364,0.79,0.1045,6,36,42,36
13774,8/2/2012,3,1,8,2,0,4,1,1,0.66,0.6061,0.83,0.0896,3,8,11,8
13775,8/2/2012,3,1,8,3,0,4,1,1,0.66,0.6061,0.83,0,0,6,6,6
13776,8/2/2012,3,1,8,4,0,4,1,1,0.66,0.6061,0.83,0,0,9,9,9
13777,8/2/2012,3,1,8,5,0,4,1,1,0.66,0.5909,0.89,0.1343,4,37,41,37
13778,8/2/2012,3,1,8,6,0,4,1,1,0.66,0.6061,0.83,0,6,177,183,177
13779,8/2/2012,3,1,8,7,0,4,1,1,0.7,0.6667,0.79,0,21,452,473,452
13780,8/2/2012,3,1,8,8,0,4,1,1,0.72,0.697,0.74,0.1045,21,718,739,718
13781,8/2/2012,3,1,8,9,0,4,1,1,0.76,0.7273,0.66,0.1045,31,312,343,312
13782,8/2/2012,3,1,8,10,0,4,1,1,0.8,0.7576,0.55,0,51,130,181,130
13783,8/2/2012,3,1,8,11,0,4,1,1,0.82,0.7727,0.52,0.1045,59,167,226,167
13784,8/2/2012,3,1,8,12,0,4,1,1,0.84,0.7576,0.44,0.1343,56,230,286,230
13785,8/2/2012,3,1,8,13,0,4,1,1,0.86,0.7879,0.44,0.2239,98,212,310,212
13786,8/2/2012,3,1,8,14,0,4,1,1,0.86,0.7879,0.41,0.1343,54,171,225,171
13787,8/2/2012,3,1,8,15,0,4,1,1,0.78,0.7424,0.62,0.4627,68,202,270,202
13788,8/2/2012,3,1,8,16,0,4,1,1,0.82,0.7576,0.46,0.194,71,335,406,335
13789,8/2/2012,3,1,8,17,0,4,1,1,0.82,0.7727,0.52,0.2537,90,775,865,775
13790,8/2/2012,3,1,8,18,0,4,1,1,0.8,0.7727,0.59,0.2239,86,681,767,681
13791,8/2/2012,3,1,8,19,0,4,1,1,0.8,0.7879,0.63,0.1642,98,509,607,509
13792,8/2/2012,3,1,8,20,0,4,1,1,0.78,0.7576,0.66,0,51,376,427,376
13793,8/2/2012,3,1,8,21,0,4,1,1,0.76,0.7273,0.66,0.2239,41,301,342,301
13794,8/2/2012,3,1,8,22,0,4,1,1,0.74,0.697,0.7,0.194,35,227,262,227
13795,8/2/2012,3,1,8,23,0,4,1,1,0.72,0.6818,0.7,0.2537,25,152,177,152
13796,8/3/2012,3,1,8,0,0,5,1,1,0.72,0.6818,0.7,0.194,15,56,71,56
13797,8/3/2012,3,1,8,1,0,5,1,1,0.7,0.6667,0.74,0.194,11,32,43,32
13798,8/3/2012,3,1,8,2,0,5,1,1,0.68,0.6364,0.79,0.2239,0,14,14,14
13799,8/3/2012,3,1,8,3,0,5,1,1,0.68,0.6364,0.79,0.2239,1,5,6,5
13800,8/3/2012,3,1,8,4,0,5,1,1,0.66,0.6061,0.83,0.2537,1,11,12,11
13801,8/3/2012,3,1,8,5,0,5,1,1,0.66,0.6061,0.83,0.1642,2,35,37,35
13802,8/3/2012,3,1,8,6,0,5,1,1,0.66,0.6061,0.83,0.2239,5,158,163,158
13803,8/3/2012,3,1,8,7,0,5,1,1,0.7,0.6667,0.74,0.1045,25,396,421,396
13804,8/3/2012,3,1,8,8,0,5,1,1,0.72,0.6818,0.7,0.1343,32,636,668,636
13805,8/3/2012,3,1,8,9,0,5,1,2,0.74,0.697,0.66,0.1045,69,327,396,327
13806,8/3/2012,3,1,8,10,0,5,1,2,0.8,0.7424,0.52,0.194,82,167,249,167
13807,8/3/2012,3,1,8,11,0,5,1,2,0.84,0.7879,0.49,0.2836,77,186,263,186
13808,8/3/2012,3,1,8,12,0,5,1,2,0.86,0.8182,0.5,0.2985,95,243,338,243
13809,8/3/2012,3,1,8,13,0,5,1,2,0.86,0.803,0.47,0.2836,98,247,345,247
13810,8/3/2012,3,1,8,14,0,5,1,2,0.86,0.7879,0.44,0.2537,102,229,331,229
13811,8/3/2012,3,1,8,15,0,5,1,1,0.88,0.8182,0.42,0.2537,112,268,380,268
13812,8/3/2012,3,1,8,16,0,5,1,2,0.86,0.7879,0.41,0.2239,112,380,492,380
13813,8/3/2012,3,1,8,17,0,5,1,2,0.84,0.803,0.53,0.2836,95,646,741,646
13814,8/3/2012,3,1,8,18,0,5,1,2,0.82,0.803,0.59,0.2537,98,573,671,573
13815,8/3/2012,3,1,8,19,0,5,1,2,0.8,0.7879,0.63,0.2239,81,388,469,388
13816,8/3/2012,3,1,8,20,0,5,1,2,0.78,0.7576,0.66,0.2239,89,300,389,300
13817,8/3/2012,3,1,8,21,0,5,1,2,0.76,0.7273,0.66,0.194,54,224,278,224
13818,8/3/2012,3,1,8,22,0,5,1,1,0.76,0.7273,0.7,0.2537,46,156,202,156
13819,8/3/2012,3,1,8,23,0,5,1,1,0.74,0.7121,0.79,0.1343,26,170,196,170
13820,8/4/2012,3,1,8,0,0,6,0,1,0.74,0.7121,0.79,0.1642,24,137,161,137
13821,8/4/2012,3,1,8,1,0,6,0,1,0.72,0.7121,0.84,0.194,23,99,122,99
13822,8/4/2012,3,1,8,2,0,6,0,1,0.72,0.7121,0.84,0.1343,20,64,84,64
13823,8/4/2012,3,1,8,3,0,6,0,1,0.72,0.7121,0.84,0.1343,11,19,30,19
13824,8/4/2012,3,1,8,4,0,6,0,1,0.72,0.697,0.79,0.194,2,11,13,11
13825,8/4/2012,3,1,8,5,0,6,0,1,0.7,0.6667,0.84,0.2239,1,16,17,16
13826,8/4/2012,3,1,8,6,0,6,0,1,0.7,0.6667,0.84,0.2239,12,37,49,37
13827,8/4/2012,3,1,8,7,0,6,0,1,0.72,0.697,0.77,0.1642,18,49,67,49
13828,8/4/2012,3,1,8,8,0,6,0,1,0.74,0.7273,0.72,0.194,49,132,181,132
13829,8/4/2012,3,1,8,9,0,6,0,1,0.78,0.7576,0.65,0.2239,61,217,278,217
13830,8/4/2012,3,1,8,10,0,6,0,1,0.82,0.7727,0.57,0.194,108,288,396,288
13831,8/4/2012,3,1,8,11,0,6,0,1,0.86,0.803,0.47,0.2537,155,315,470,315
13832,8/4/2012,3,1,8,12,0,6,0,1,0.86,0.7879,0.4,0.3582,222,325,547,325
13833,8/4/2012,3,1,8,13,0,6,0,1,0.88,0.8182,0.42,0.2985,195,332,527,332
13834,8/4/2012,3,1,8,14,0,6,0,1,0.88,0.803,0.4,0.3881,183,289,472,289
13835,8/4/2012,3,1,8,15,0,6,0,1,0.88,0.8182,0.42,0.4179,205,284,489,284
13836,8/4/2012,3,1,8,16,0,6,0,1,0.9,0.8182,0.39,0.2985,197,253,450,253
13837,8/4/2012,3,1,8,17,0,6,0,1,0.88,0.7879,0.37,0.2985,179,313,492,313
13838,8/4/2012,3,1,8,18,0,6,0,1,0.86,0.7879,0.41,0.3284,169,321,490,321
13839,8/4/2012,3,1,8,19,0,6,0,1,0.82,0.7727,0.52,0.3582,133,264,397,264
13840,8/4/2012,3,1,8,20,0,6,0,1,0.82,0.7727,0.52,0.2985,117,195,312,195
13841,8/4/2012,3,1,8,21,0,6,0,1,0.8,0.7727,0.59,0.2537,96,193,289,193
13842,8/4/2012,3,1,8,22,0,6,0,1,0.76,0.7273,0.66,0.2836,104,165,269,165
13843,8/4/2012,3,1,8,23,0,6,0,1,0.76,0.7273,0.66,0.2985,61,161,222,161
13844,8/5/2012,3,1,8,0,0,0,0,1,0.74,0.697,0.7,0.2836,32,121,153,121
13845,8/5/2012,3,1,8,1,0,0,0,1,0.74,0.697,0.7,0.2537,8,79,87,79
13846,8/5/2012,3,1,8,2,0,0,0,1,0.74,0.697,0.7,0.2985,5,68,73,68
13847,8/5/2012,3,1,8,3,0,0,0,1,0.72,0.697,0.74,0.2537,9,32,41,32
13848,8/5/2012,3,1,8,4,0,0,0,1,0.72,0.697,0.74,0.2537,3,11,14,11
13849,8/5/2012,3,1,8,5,0,0,0,1,0.72,0.697,0.74,0.2537,1,18,19,18
13850,8/5/2012,3,1,8,6,0,0,0,1,0.72,0.697,0.79,0.2537,7,12,19,12
13851,8/5/2012,3,1,8,7,0,0,0,1,0.74,0.7121,0.74,0.2985,18,50,68,50
13852,8/5/2012,3,1,8,8,0,0,0,1,0.76,0.7273,0.66,0.3284,27,81,108,81
13853,8/5/2012,3,1,8,9,0,0,0,1,0.8,0.7727,0.59,0.3582,61,168,229,168
13854,8/5/2012,3,1,8,10,0,0,0,1,0.8,0.7727,0.59,0.4179,111,253,364,253
13855,8/5/2012,3,1,8,11,0,0,0,1,0.82,0.7879,0.56,0.4179,155,282,437,282
13856,8/5/2012,3,1,8,12,0,0,0,1,0.86,0.803,0.47,0.5224,161,330,491,330
13857,8/5/2012,3,1,8,13,0,0,0,1,0.88,0.8182,0.44,0.4627,208,315,523,315
13858,8/5/2012,3,1,8,14,0,0,0,1,0.9,0.8485,0.42,0.4627,161,365,526,365
13859,8/5/2012,3,1,8,15,0,0,0,1,0.9,0.8182,0.37,0.5224,164,286,450,286
13860,8/5/2012,3,1,8,16,0,0,0,1,0.82,0.7576,0.46,0.2537,143,278,421,278
13861,8/5/2012,3,1,8,17,0,0,0,1,0.82,0.7576,0.46,0.2537,122,260,382,260
13862,8/5/2012,3,1,8,18,0,0,0,3,0.7,0.6667,0.74,0.1343,75,154,229,154
13863,8/5/2012,3,1,8,19,0,0,0,1,0.7,0.6667,0.84,0.2239,46,139,185,139
13864,8/5/2012,3,1,8,20,0,0,0,1,0.7,0.6667,0.84,0.1045,53,140,193,140
13865,8/5/2012,3,1,8,21,0,0,0,1,0.72,0.697,0.79,0.1045,51,157,208,157
13866,8/5/2012,3,1,8,22,0,0,0,1,0.72,0.697,0.79,0.0896,57,100,157,100
13867,8/5/2012,3,1,8,23,0,0,0,2,0.72,0.697,0.79,0.1642,29,58,87,58
13868,8/6/2012,3,1,8,0,0,1,1,2,0.72,0.697,0.79,0,9,24,33,24
13869,8/6/2012,3,1,8,1,0,1,1,1,0.72,0.697,0.79,0.0896,1,10,11,10
13870,8/6/2012,3,1,8,2,0,1,1,2,0.72,0.697,0.79,0.1343,0,5,5,5
13871,8/6/2012,3,1,8,3,0,1,1,3,0.72,0.697,0.79,0.0896,0,5,5,5
13872,8/6/2012,3,1,8,4,0,1,1,2,0.72,0.697,0.74,0.1343,3,8,11,8
13873,8/6/2012,3,1,8,5,0,1,1,1,0.7,0.6667,0.79,0.194,2,23,25,23
13874,8/6/2012,3,1,8,6,0,1,1,2,0.7,0.6667,0.79,0.2239,4,137,141,137
13875,8/6/2012,3,1,8,7,0,1,1,3,0.72,0.6818,0.7,0.194,14,393,407,393
13876,8/6/2012,3,1,8,8,0,1,1,2,0.7,0.6667,0.79,0,27,578,605,578
13877,8/6/2012,3,1,8,9,0,1,1,3,0.7,0.6667,0.79,0.1642,28,248,276,248
13878,8/6/2012,3,1,8,10,0,1,1,1,0.74,0.697,0.7,0.2239,54,159,213,159
13879,8/6/2012,3,1,8,11,0,1,1,1,0.76,0.7273,0.66,0.1343,108,152,260,152
13880,8/6/2012,3,1,8,12,0,1,1,2,0.78,0.7273,0.55,0.0896,72,213,285,213
13881,8/6/2012,3,1,8,13,0,1,1,1,0.8,0.7424,0.49,0.2239,85,204,289,204
13882,8/6/2012,3,1,8,14,0,1,1,1,0.82,0.7576,0.46,0,99,188,287,188
13883,8/6/2012,3,1,8,15,0,1,1,1,0.82,0.7576,0.46,0.1343,91,183,274,183
13884,8/6/2012,3,1,8,16,0,1,1,1,0.84,0.7576,0.41,0.1045,88,363,451,363
13885,8/6/2012,3,1,8,17,0,1,1,1,0.82,0.7424,0.41,0,112,746,858,746
13886,8/6/2012,3,1,8,18,0,1,1,1,0.82,0.7424,0.41,0.1343,100,743,843,743
13887,8/6/2012,3,1,8,19,0,1,1,1,0.78,0.7424,0.59,0.194,109,531,640,531
13888,8/6/2012,3,1,8,20,0,1,1,1,0.76,0.7273,0.66,0.1642,89,368,457,368
13889,8/6/2012,3,1,8,21,0,1,1,1,0.74,0.697,0.7,0.194,72,245,317,245
13890,8/6/2012,3,1,8,22,0,1,1,1,0.74,0.697,0.7,0.0896,50,157,207,157
13891,8/6/2012,3,1,8,23,0,1,1,1,0.72,0.697,0.74,0.194,16,97,113,97
13892,8/7/2012,3,1,8,0,0,2,1,1,0.7,0.6667,0.84,0.194,15,32,47,32
13893,8/7/2012,3,1,8,1,0,2,1,1,0.7,0.6667,0.84,0.1343,2,16,18,16
13894,8/7/2012,3,1,8,2,0,2,1,1,0.7,0.6667,0.84,0.1343,6,7,13,7
13895,8/7/2012,3,1,8,3,0,2,1,1,0.7,0.6667,0.84,0,0,6,6,6
13896,8/7/2012,3,1,8,4,0,2,1,1,0.68,0.6364,0.83,0.1343,2,7,9,7
13897,8/7/2012,3,1,8,5,0,2,1,1,0.7,0.6667,0.79,0.1045,3,33,36,33
13898,8/7/2012,3,1,8,6,0,2,1,2,0.7,0.6667,0.79,0.194,3,176,179,176
13899,8/7/2012,3,1,8,7,0,2,1,2,0.7,0.6667,0.74,0.1343,21,481,502,481
13900,8/7/2012,3,1,8,8,0,2,1,2,0.7,0.6515,0.7,0.1642,41,664,705,664
13901,8/7/2012,3,1,8,9,0,2,1,2,0.7,0.6667,0.74,0.1343,44,283,327,283
13902,8/7/2012,3,1,8,10,0,2,1,2,0.74,0.697,0.7,0.1343,89,161,250,161
13903,8/7/2012,3,1,8,11,0,2,1,2,0.76,0.7273,0.66,0.0896,84,130,214,130
13904,8/7/2012,3,1,8,12,0,2,1,2,0.8,0.7576,0.55,0.1343,86,197,283,197
13905,8/7/2012,3,1,8,13,0,2,1,2,0.8,0.7424,0.52,0.194,68,185,253,185
13906,8/7/2012,3,1,8,14,0,2,1,2,0.82,0.7576,0.46,0,76,185,261,185
13907,8/7/2012,3,1,8,15,0,2,1,1,0.8,0.7424,0.52,0,100,206,306,206
13908,8/7/2012,3,1,8,16,0,2,1,3,0.76,0.7273,0.66,0.2836,101,344,445,344
13909,8/7/2012,3,1,8,17,0,2,1,2,0.78,0.7424,0.62,0.1343,125,743,868,743
13910,8/7/2012,3,1,8,18,0,2,1,2,0.76,0.7121,0.62,0.1642,103,711,814,711
13911,8/7/2012,3,1,8,19,0,2,1,2,0.76,0.7273,0.66,0.1045,104,506,610,506
13912,8/7/2012,3,1,8,20,0,2,1,2,0.74,0.697,0.7,0.1343,74,374,448,374
13913,8/7/2012,3,1,8,21,0,2,1,2,0.72,0.697,0.74,0,70,247,317,247
13914,8/7/2012,3,1,8,22,0,2,1,1,0.72,0.697,0.74,0.1045,43,181,224,181
13915,8/7/2012,3,1,8,23,0,2,1,1,0.72,0.697,0.79,0,18,120,138,120
13916,8/8/2012,3,1,8,0,0,3,1,1,0.7,0.6667,0.84,0,12,46,58,46
13917,8/8/2012,3,1,8,1,0,3,1,1,0.72,0.697,0.79,0,3,20,23,20
13918,8/8/2012,3,1,8,2,0,3,1,1,0.7,0.6667,0.84,0,1,5,6,5
13919,8/8/2012,3,1,8,3,0,3,1,1,0.7,0.6667,0.84,0,1,6,7,6
13920,8/8/2012,3,1,8,4,0,3,1,1,0.7,0.6667,0.84,0,1,6,7,6
13921,8/8/2012,3,1,8,5,0,3,1,2,0.68,0.6364,0.89,0.1642,3,40,43,40
13922,8/8/2012,3,1,8,6,0,3,1,2,0.7,0.6667,0.84,0.1642,4,169,173,169
13923,8/8/2012,3,1,8,7,0,3,1,2,0.7,0.6667,0.84,0.1642,24,458,482,458
13924,8/8/2012,3,1,8,8,0,3,1,2,0.74,0.7273,0.72,0.0896,48,689,737,689
13925,8/8/2012,3,1,8,9,0,3,1,2,0.76,0.7273,0.66,0,33,308,341,308
13926,8/8/2012,3,1,8,10,0,3,1,2,0.8,0.7424,0.52,0.1343,63,151,214,151
13927,8/8/2012,3,1,8,11,0,3,1,2,0.8,0.7424,0.52,0,80,159,239,159
13928,8/8/2012,3,1,8,12,0,3,1,2,0.8,0.7424,0.52,0,63,217,280,217
13929,8/8/2012,3,1,8,13,0,3,1,2,0.8,0.7424,0.52,0,101,212,313,212
13930,8/8/2012,3,1,8,14,0,3,1,2,0.8,0.7424,0.52,0.2537,63,173,236,173
13931,8/8/2012,3,1,8,15,0,3,1,2,0.84,0.7576,0.44,0.194,110,168,278,168
13932,8/8/2012,3,1,8,16,0,3,1,2,0.8,0.7424,0.49,0.2836,113,328,441,328
13933,8/8/2012,3,1,8,17,0,3,1,2,0.8,0.7576,0.55,0.2836,107,751,858,751
13934,8/8/2012,3,1,8,18,0,3,1,2,0.78,0.7273,0.55,0.1642,117,745,862,745
13935,8/8/2012,3,1,8,19,0,3,1,1,0.76,0.7273,0.66,0.2239,119,567,686,567
13936,8/8/2012,3,1,8,20,0,3,1,1,0.74,0.697,0.66,0.194,76,424,500,424
13937,8/8/2012,3,1,8,21,0,3,1,1,0.74,0.697,0.66,0.1045,70,311,381,311
13938,8/8/2012,3,1,8,22,0,3,1,1,0.72,0.697,0.74,0.1045,35,198,233,198
13939,8/8/2012,3,1,8,23,0,3,1,1,0.72,0.6818,0.7,0.1343,16,120,136,120
13940,8/9/2012,3,1,8,0,0,4,1,1,0.72,0.697,0.74,0.194,16,51,67,51
13941,8/9/2012,3,1,8,1,0,4,1,1,0.7,0.6667,0.79,0.1343,5,23,28,23
13942,8/9/2012,3,1,8,2,0,4,1,1,0.7,0.6667,0.84,0.0896,2,12,14,12
13943,8/9/2012,3,1,8,3,0,4,1,1,0.68,0.6364,0.83,0.0896,1,5,6,5
13944,8/9/2012,3,1,8,4,0,4,1,2,0.68,0.6364,0.89,0.1343,0,10,10,10
13945,8/9/2012,3,1,8,5,0,4,1,2,0.66,0.5909,0.94,0,4,37,41,37
13946,8/9/2012,3,1,8,6,0,4,1,1,0.66,0.6061,0.83,0.1642,5,162,167,162
13947,8/9/2012,3,1,8,7,0,4,1,2,0.7,0.6667,0.84,0.1642,24,451,475,451
13948,8/9/2012,3,1,8,8,0,4,1,1,0.72,0.697,0.74,0.1045,28,670,698,670
13949,8/9/2012,3,1,8,9,0,4,1,1,0.76,0.7273,0.66,0.1642,54,299,353,299
13950,8/9/2012,3,1,8,10,0,4,1,1,0.8,0.7576,0.55,0.2239,72,133,205,133
13951,8/9/2012,3,1,8,11,0,4,1,1,0.84,0.7576,0.44,0,94,166,260,166
13952,8/9/2012,3,1,8,12,0,4,1,1,0.84,0.7576,0.44,0.1045,85,192,277,192
13953,8/9/2012,3,1,8,13,0,4,1,1,0.86,0.7879,0.41,0.1045,80,201,281,201
13954,8/9/2012,3,1,8,14,0,4,1,1,0.88,0.7727,0.32,0.2239,86,161,247,161
13955,8/9/2012,3,1,8,15,0,4,1,1,0.88,0.7727,0.32,0.2239,63,204,267,204
13956,8/9/2012,3,1,8,16,0,4,1,1,0.86,0.7727,0.39,0.2537,97,320,417,320
13957,8/9/2012,3,1,8,17,0,4,1,1,0.86,0.7576,0.36,0.2537,111,699,810,699
13958,8/9/2012,3,1,8,18,0,4,1,2,0.82,0.7576,0.46,0.2537,78,733,811,733
13959,8/9/2012,3,1,8,19,0,4,1,1,0.8,0.7576,0.55,0.194,90,533,623,533
13960,8/9/2012,3,1,8,20,0,4,1,1,0.7,0.6515,0.54,0.2836,91,387,478,387
13961,8/9/2012,3,1,8,21,0,4,1,2,0.7,0.6515,0.58,0.1642,50,286,336,286
13962,8/9/2012,3,1,8,22,0,4,1,2,0.66,0.6212,0.69,0.2239,41,218,259,218
13963,8/9/2012,3,1,8,23,0,4,1,1,0.66,0.6212,0.74,0,19,137,156,137
13964,8/10/2012,3,1,8,0,0,5,1,1,0.7,0.6515,0.65,0.0896,17,68,85,68
13965,8/10/2012,3,1,8,1,0,5,1,1,0.7,0.6515,0.65,0.1045,6,35,41,35
13966,8/10/2012,3,1,8,2,0,5,1,1,0.7,0.6667,0.74,0.1642,6,14,20,14
13967,8/10/2012,3,1,8,3,0,5,1,2,0.72,0.697,0.79,0.194,3,6,9,6
13968,8/10/2012,3,1,8,4,0,5,1,3,0.7,0.6667,0.84,0.2836,0,7,7,7
13969,8/10/2012,3,1,8,5,0,5,1,3,0.7,0.6667,0.84,0.2836,4,29,33,29
13970,8/10/2012,3,1,8,6,0,5,1,3,0.64,0.5758,0.89,0.2985,3,41,44,41
13971,8/10/2012,3,1,8,7,0,5,1,3,0.64,0.5758,0.89,0.1045,5,128,133,128
13972,8/10/2012,3,1,8,8,0,5,1,3,0.62,0.5455,0.91,0.1642,7,112,119,112
13973,8/10/2012,3,1,8,9,0,5,1,2,0.64,0.5758,0.89,0,21,199,220,199
13974,8/10/2012,3,1,8,10,0,5,1,1,0.66,0.5909,0.89,0.1045,27,166,193,166
13975,8/10/2012,3,1,8,11,0,5,1,3,0.68,0.6364,0.79,0.1343,73,178,251,178
13976,8/10/2012,3,1,8,12,0,5,1,2,0.74,0.697,0.66,0.3582,75,240,315,240
13977,8/10/2012,3,1,8,13,0,5,1,2,0.76,0.7121,0.58,0.3582,66,224,290,224
13978,8/10/2012,3,1,8,14,0,5,1,1,0.76,0.7121,0.58,0.3582,71,236,307,236
13979,8/10/2012,3,1,8,15,0,5,1,1,0.8,0.7424,0.52,0.4478,100,224,324,224
13980,8/10/2012,3,1,8,16,0,5,1,1,0.78,0.7273,0.55,0.2985,96,371,467,371
13981,8/10/2012,3,1,8,17,0,5,1,1,0.8,0.7424,0.52,0.2836,111,619,730,619
13982,8/10/2012,3,1,8,18,0,5,1,1,0.76,0.7121,0.62,0.2985,88,552,640,552
13983,8/10/2012,3,1,8,19,0,5,1,1,0.76,0.7121,0.62,0.2836,98,394,492,394
13984,8/10/2012,3,1,8,20,0,5,1,1,0.74,0.697,0.66,0.2985,55,315,370,315
13985,8/10/2012,3,1,8,21,0,5,1,1,0.74,0.697,0.66,0.2537,50,236,286,236
13986,8/10/2012,3,1,8,22,0,5,1,1,0.72,0.697,0.74,0.2836,50,168,218,168
13987,8/10/2012,3,1,8,23,0,5,1,1,0.72,0.6818,0.7,0.2836,33,159,192,159
13988,8/11/2012,3,1,8,0,0,6,0,1,0.7,0.6515,0.7,0.2836,38,142,180,142
13989,8/11/2012,3,1,8,1,0,6,0,1,0.66,0.6212,0.74,0.2239,32,84,116,84
13990,8/11/2012,3,1,8,2,0,6,0,3,0.64,0.5909,0.78,0.194,19,66,85,66
13991,8/11/2012,3,1,8,3,0,6,0,3,0.62,0.5758,0.83,0.1642,2,19,21,19
13992,8/11/2012,3,1,8,4,0,6,0,1,0.62,0.5758,0.83,0.1045,3,7,10,7
13993,8/11/2012,3,1,8,5,0,6,0,1,0.62,0.5606,0.88,0.1045,2,9,11,9
13994,8/11/2012,3,1,8,6,0,6,0,2,0.62,0.5606,0.88,0.1045,5,18,23,18
13995,8/11/2012,3,1,8,7,0,6,0,1,0.64,0.5758,0.83,0.0896,8,54,62,54
13996,8/11/2012,3,1,8,8,0,6,0,1,0.66,0.6061,0.83,0.1045,30,132,162,132
13997,8/11/2012,3,1,8,9,0,6,0,1,0.68,0.6364,0.79,0.194,54,217,271,217
13998,8/11/2012,3,1,8,10,0,6,0,1,0.72,0.6818,0.62,0.0896,125,282,407,282
13999,8/11/2012,3,1,8,11,0,6,0,1,0.74,0.697,0.66,0.1642,203,296,499,296
14000,8/11/2012,3,1,8,12,0,6,0,1,0.76,0.7121,0.58,0.2239,214,332,546,332
14001,8/11/2012,3,1,8,13,0,6,0,1,0.8,0.7424,0.49,0.3582,228,341,569,341
14002,8/11/2012,3,1,8,14,0,6,0,1,0.8,0.7424,0.49,0.2985,248,290,538,290
14003,8/11/2012,3,1,8,15,0,6,0,1,0.8,0.7273,0.46,0.2836,246,316,562,316
14004,8/11/2012,3,1,8,16,0,6,0,1,0.8,0.7273,0.46,0.2985,227,304,531,304
14005,8/11/2012,3,1,8,17,0,6,0,3,0.74,0.697,0.66,0.3582,220,292,512,292
14006,8/11/2012,3,1,8,18,0,6,0,2,0.7,0.6667,0.74,0.2985,107,193,300,193
14007,8/11/2012,3,1,8,19,0,6,0,2,0.66,0.5909,0.89,0.1045,97,178,275,178
14008,8/11/2012,3,1,8,20,0,6,0,3,0.66,0.5909,0.89,0.4179,31,129,160,129
14009,8/11/2012,3,1,8,21,0,6,0,2,0.66,0.5909,0.89,0.1642,26,102,128,102
14010,8/11/2012,3,1,8,22,0,6,0,2,0.66,0.5909,0.89,0.1642,40,128,168,128
14011,8/11/2012,3,1,8,23,0,6,0,3,0.66,0.6061,0.78,0.1642,42,121,163,121
14012,8/12/2012,3,1,8,0,0,0,0,2,0.64,0.6061,0.73,0.1343,24,96,120,96
14013,8/12/2012,3,1,8,1,0,0,0,1,0.62,0.5909,0.78,0.1343,21,92,113,92
14014,8/12/2012,3,1,8,2,0,0,0,1,0.64,0.6061,0.69,0.1343,19,67,86,67
14015,8/12/2012,3,1,8,3,0,0,0,1,0.62,0.5909,0.73,0.0896,11,37,48,37
14016,8/12/2012,3,1,8,4,0,0,0,1,0.64,0.6061,0.69,0.0896,2,8,10,8
14017,8/12/2012,3,1,8,5,0,0,0,1,0.64,0.6212,0.61,0.194,1,9,10,9
14018,8/12/2012,3,1,8,6,0,0,0,1,0.64,0.6061,0.65,0.1642,2,14,16,14
14019,8/12/2012,3,1,8,7,0,0,0,1,0.64,0.6061,0.65,0.1343,9,30,39,30
14020,8/12/2012,3,1,8,8,0,0,0,1,0.66,0.6212,0.54,0.2239,35,84,119,84
14021,8/12/2012,3,1,8,9,0,0,0,1,0.7,0.6515,0.48,0.2239,64,153,217,153
14022,8/12/2012,3,1,8,10,0,0,0,1,0.7,0.6515,0.51,0.1642,88,240,328,240
14023,8/12/2012,3,1,8,11,0,0,0,1,0.74,0.6667,0.42,0.1642,167,282,449,282
14024,8/12/2012,3,1,8,12,0,0,0,1,0.74,0.6667,0.42,0.194,163,342,505,342
14025,8/12/2012,3,1,8,13,0,0,0,1,0.78,0.697,0.4,0,178,365,543,365
14026,8/12/2012,3,1,8,14,0,0,0,1,0.76,0.6818,0.4,0.194,213,366,579,366
14027,8/12/2012,3,1,8,15,0,0,0,1,0.76,0.6818,0.4,0.1343,235,342,577,342
14028,8/12/2012,3,1,8,16,0,0,0,1,0.76,0.6818,0.4,0.1045,213,300,513,300
14029,8/12/2012,3,1,8,17,0,0,0,1,0.8,0.697,0.33,0,186,319,505,319
14030,8/12/2012,3,1,8,18,0,0,0,1,0.78,0.6818,0.35,0.1045,164,327,491,327
14031,8/12/2012,3,1,8,19,0,0,0,1,0.74,0.6515,0.4,0.1343,148,317,465,317
14032,8/12/2012,3,1,8,20,0,0,0,1,0.72,0.6515,0.45,0,96,204,300,204
14033,8/12/2012,3,1,8,21,0,0,0,1,0.72,0.6667,0.51,0.0896,78,142,220,142
14034,8/12/2012,3,1,8,22,0,0,0,1,0.7,0.6515,0.58,0.1343,40,141,181,141
14035,8/12/2012,3,1,8,23,0,0,0,1,0.68,0.6364,0.61,0,25,85,110,85
14036,8/13/2012,3,1,8,0,0,1,1,1,0.66,0.6212,0.65,0.1045,14,33,47,33
14037,8/13/2012,3,1,8,1,0,1,1,1,0.66,0.6212,0.65,0.0896,3,11,14,11
14038,8/13/2012,3,1,8,2,0,1,1,1,0.64,0.6061,0.69,0.1045,1,8,9,8
14039,8/13/2012,3,1,8,3,0,1,1,1,0.64,0.6061,0.69,0,1,5,6,5
14040,8/13/2012,3,1,8,4,0,1,1,1,0.64,0.6061,0.69,0.1045,0,11,11,11
14041,8/13/2012,3,1,8,5,0,1,1,1,0.64,0.6061,0.69,0.1045,3,33,36,33
14042,8/13/2012,3,1,8,6,0,1,1,1,0.62,0.5909,0.73,0.0896,4,155,159,155
14043,8/13/2012,3,1,8,7,0,1,1,1,0.66,0.6212,0.65,0.1343,11,425,436,425
14044,8/13/2012,3,1,8,8,0,1,1,2,0.72,0.6667,0.51,0.0896,25,648,673,648
14045,8/13/2012,3,1,8,9,0,1,1,2,0.74,0.6667,0.45,0,40,265,305,265
14046,8/13/2012,3,1,8,10,0,1,1,2,0.76,0.6818,0.4,0,88,111,199,111
14047,8/13/2012,3,1,8,11,0,1,1,1,0.76,0.6818,0.4,0.0896,94,151,245,151
14048,8/13/2012,3,1,8,12,0,1,1,1,0.78,0.697,0.4,0.194,96,180,276,180
14049,8/13/2012,3,1,8,13,0,1,1,1,0.78,0.697,0.4,0.1642,79,175,254,175
14050,8/13/2012,3,1,8,14,0,1,1,1,0.8,0.697,0.33,0.1045,85,163,248,163
14051,8/13/2012,3,1,8,15,0,1,1,1,0.82,0.7273,0.34,0.2239,80,194,274,194
14052,8/13/2012,3,1,8,16,0,1,1,1,0.8,0.7121,0.36,0.0896,116,348,464,348
14053,8/13/2012,3,1,8,17,0,1,1,1,0.8,0.7121,0.36,0.1642,102,716,818,716
14054,8/13/2012,3,1,8,18,0,1,1,1,0.76,0.697,0.52,0.2836,103,709,812,709
14055,8/13/2012,3,1,8,19,0,1,1,1,0.74,0.6818,0.58,0.1642,88,467,555,467
14056,8/13/2012,3,1,8,20,0,1,1,1,0.74,0.6818,0.62,0.2239,58,374,432,374
14057,8/13/2012,3,1,8,21,0,1,1,1,0.72,0.6818,0.66,0.194,44,246,290,246
14058,8/13/2012,3,1,8,22,0,1,1,1,0.72,0.6818,0.62,0.3284,44,148,192,148
14059,8/13/2012,3,1,8,23,0,1,1,1,0.7,0.6515,0.7,0.2239,28,100,128,100
14060,8/14/2012,3,1,8,0,0,2,1,1,0.7,0.6667,0.74,0.2239,12,48,60,48
14061,8/14/2012,3,1,8,1,0,2,1,1,0.68,0.6364,0.79,0.2537,8,19,27,19
14062,8/14/2012,3,1,8,2,0,2,1,2,0.68,0.6364,0.83,0.194,2,9,11,9
14063,8/14/2012,3,1,8,3,0,2,1,2,0.68,0.6364,0.83,0.194,0,3,3,3
14064,8/14/2012,3,1,8,4,0,2,1,2,0.68,0.6364,0.83,0.194,0,5,5,5
14065,8/14/2012,3,1,8,5,0,2,1,2,0.68,0.6364,0.89,0.194,1,35,36,35
14066,8/14/2012,3,1,8,6,0,2,1,3,0.64,0.5758,0.83,0.194,1,63,64,63
14067,8/14/2012,3,1,8,7,0,2,1,2,0.66,0.6061,0.83,0.0896,1,178,179,178
14068,8/14/2012,3,1,8,8,0,2,1,2,0.66,0.5909,0.89,0.0896,27,591,618,591
14069,8/14/2012,3,1,8,9,0,2,1,2,0.7,0.6667,0.74,0,48,354,402,354
14070,8/14/2012,3,1,8,10,0,2,1,1,0.7,0.6667,0.79,0.1045,53,155,208,155
14071,8/14/2012,3,1,8,11,0,2,1,1,0.74,0.6818,0.62,0,69,127,196,127
14072,8/14/2012,3,1,8,12,0,2,1,1,0.78,0.7121,0.49,0.1343,93,207,300,207
14073,8/14/2012,3,1,8,13,0,2,1,1,0.8,0.7273,0.46,0.0896,83,203,286,203
14074,8/14/2012,3,1,8,14,0,2,1,1,0.82,0.7424,0.41,0.2239,80,175,255,175
14075,8/14/2012,3,1,8,15,0,2,1,1,0.82,0.7576,0.46,0.2239,84,199,283,199
14076,8/14/2012,3,1,8,16,0,2,1,1,0.82,0.7424,0.43,0.2239,95,363,458,363
14077,8/14/2012,3,1,8,17,0,2,1,3,0.76,0.7273,0.66,0.2537,78,734,812,734
14078,8/14/2012,3,1,8,18,0,2,1,1,0.76,0.7121,0.62,0.2836,97,757,854,757
14079,8/14/2012,3,1,8,19,0,2,1,1,0.76,0.7273,0.66,0.194,94,533,627,533
14080,8/14/2012,3,1,8,20,0,2,1,1,0.74,0.7121,0.74,0.2239,65,371,436,371
14081,8/14/2012,3,1,8,21,0,2,1,1,0.74,0.6818,0.62,0.2239,56,252,308,252
14082,8/14/2012,3,1,8,22,0,2,1,1,0.72,0.6818,0.66,0.0896,28,161,189,161
14083,8/14/2012,3,1,8,23,0,2,1,1,0.72,0.6818,0.66,0.1642,53,114,167,114
14084,8/15/2012,3,1,8,0,0,3,1,1,0.7,0.6515,0.61,0.194,8,52,60,52
14085,8/15/2012,3,1,8,1,0,3,1,1,0.7,0.6515,0.61,0,6,31,37,31
14086,8/15/2012,3,1,8,2,0,3,1,1,0.68,0.6364,0.65,0,1,7,8,7
14087,8/15/2012,3,1,8,3,0,3,1,1,0.66,0.6212,0.74,0.1045,1,10,11,10
14088,8/15/2012,3,1,8,4,0,3,1,1,0.64,0.5758,0.83,0.1045,0,4,4,4
14089,8/15/2012,3,1,8,5,0,3,1,1,0.64,0.5909,0.78,0.1045,4,35,39,35
14090,8/15/2012,3,1,8,6,0,3,1,1,0.64,0.5909,0.78,0.1045,12,160,172,160
14091,8/15/2012,3,1,8,7,0,3,1,2,0.66,0.6212,0.69,0.194,25,467,492,467
14092,8/15/2012,3,1,8,8,0,3,1,2,0.7,0.6515,0.65,0.2836,40,642,682,642
14093,8/15/2012,3,1,8,9,0,3,1,2,0.72,0.6818,0.62,0.194,57,310,367,310
14094,8/15/2012,3,1,8,10,0,3,1,2,0.72,0.6818,0.62,0.194,70,163,233,163
14095,8/15/2012,3,1,8,11,0,3,1,2,0.74,0.6818,0.58,0.194,80,155,235,155
14096,8/15/2012,3,1,8,12,0,3,1,1,0.74,0.6818,0.55,0.2239,77,230,307,230
14097,8/15/2012,3,1,8,13,0,3,1,2,0.78,0.7121,0.49,0.194,88,206,294,206
14098,8/15/2012,3,1,8,14,0,3,1,2,0.76,0.697,0.52,0.2985,94,161,255,161
14099,8/15/2012,3,1,8,15,0,3,1,1,0.76,0.697,0.52,0.2537,70,196,266,196
14100,8/15/2012,3,1,8,16,0,3,1,1,0.76,0.6818,0.48,0.194,91,340,431,340
14101,8/15/2012,3,1,8,17,0,3,1,1,0.74,0.6818,0.55,0.2836,102,749,851,749
14102,8/15/2012,3,1,8,18,0,3,1,1,0.74,0.6667,0.51,0.2239,80,768,848,768
14103,8/15/2012,3,1,8,19,0,3,1,1,0.7,0.6515,0.61,0.1343,124,525,649,525
14104,8/15/2012,3,1,8,20,0,3,1,1,0.7,0.6515,0.61,0.1343,72,355,427,355
14105,8/15/2012,3,1,8,21,0,3,1,1,0.7,0.6515,0.61,0.194,49,266,315,266
14106,8/15/2012,3,1,8,22,0,3,1,1,0.7,0.6515,0.61,0.1642,29,197,226,197
14107,8/15/2012,3,1,8,23,0,3,1,1,0.68,0.6364,0.65,0.1045,18,120,138,120
14108,8/16/2012,3,1,8,0,0,4,1,1,0.66,0.6212,0.69,0,13,63,76,63
14109,8/16/2012,3,1,8,1,0,4,1,1,0.64,0.6061,0.73,0,3,18,21,18
14110,8/16/2012,3,1,8,2,0,4,1,1,0.64,0.6061,0.69,0.194,0,15,15,15
14111,8/16/2012,3,1,8,3,0,4,1,1,0.62,0.5909,0.73,0.2537,0,4,4,4
14112,8/16/2012,3,1,8,4,0,4,1,1,0.62,0.5909,0.73,0.2239,2,3,5,3
14113,8/16/2012,3,1,8,5,0,4,1,1,0.6,0.5758,0.78,0.1642,7,30,37,30
14114,8/16/2012,3,1,8,6,0,4,1,1,0.6,0.5758,0.78,0.1642,3,162,165,162
14115,8/16/2012,3,1,8,7,0,4,1,1,0.64,0.6061,0.69,0.2239,16,448,464,448
14116,8/16/2012,3,1,8,8,0,4,1,1,0.68,0.6364,0.61,0.194,33,649,682,649
14117,8/16/2012,3,1,8,9,0,4,1,1,0.72,0.6667,0.54,0.1045,41,296,337,296
14118,8/16/2012,3,1,8,10,0,4,1,1,0.74,0.6667,0.48,0.1343,78,121,199,121
14119,8/16/2012,3,1,8,11,0,4,1,1,0.76,0.6667,0.37,0.0896,83,191,274,191
14120,8/16/2012,3,1,8,12,0,4,1,1,0.8,0.697,0.33,0.1045,96,247,343,247
14121,8/16/2012,3,1,8,13,0,4,1,1,0.8,0.697,0.31,0.2239,81,219,300,219
14122,8/16/2012,3,1,8,14,0,4,1,1,0.82,0.7121,0.32,0,72,176,248,176
14123,8/16/2012,3,1,8,15,0,4,1,1,0.8,0.697,0.33,0.2537,63,197,260,197
14124,8/16/2012,3,1,8,16,0,4,1,1,0.82,0.7121,0.32,0.2239,79,340,419,340
14125,8/16/2012,3,1,8,17,0,4,1,1,0.82,0.7273,0.34,0.194,130,767,897,767
14126,8/16/2012,3,1,8,18,0,4,1,1,0.8,0.7121,0.36,0,109,723,832,723
14127,8/16/2012,3,1,8,19,0,4,1,1,0.76,0.6818,0.4,0.1045,119,558,677,558
14128,8/16/2012,3,1,8,20,0,4,1,1,0.76,0.6818,0.4,0.0896,100,414,514,414
14129,8/16/2012,3,1,8,21,0,4,1,1,0.74,0.6667,0.48,0.194,83,273,356,273
14130,8/16/2012,3,1,8,22,0,4,1,1,0.72,0.6667,0.51,0.1642,69,185,254,185
14131,8/16/2012,3,1,8,23,0,4,1,1,0.7,0.6515,0.54,0.1045,58,168,226,168
14132,8/17/2012,3,1,8,0,0,5,1,1,0.68,0.2424,0.57,0.1642,21,67,88,67
14133,8/17/2012,3,1,8,1,0,5,1,1,0.66,0.2424,0.65,0.1045,16,38,54,38
14134,8/17/2012,3,1,8,2,0,5,1,1,0.66,0.2424,0.61,0.1343,4,15,19,15
14135,8/17/2012,3,1,8,3,0,5,1,1,0.64,0.2424,0.65,0.1045,0,6,6,6
14136,8/17/2012,3,1,8,4,0,5,1,1,0.64,0.2424,0.73,0.1642,0,9,9,9
14137,8/17/2012,3,1,8,5,0,5,1,1,0.64,0.2424,0.73,0.1045,2,34,36,34
14138,8/17/2012,3,1,8,6,0,5,1,1,0.62,0.2424,0.78,0.1343,6,151,157,151
14139,8/17/2012,3,1,8,7,0,5,1,1,0.64,0.2424,0.73,0.1045,11,368,379,368
14140,8/17/2012,3,1,8,8,0,5,1,1,0.68,0.2424,0.65,0.1343,43,625,668,625
14141,8/17/2012,3,1,8,9,0,5,1,1,0.7,0.2424,0.58,0.1045,58,320,378,320
14142,8/17/2012,3,1,8,10,0,5,1,1,0.74,0.2424,0.55,0.1642,82,149,231,149
14143,8/17/2012,3,1,8,11,0,5,1,1,0.76,0.2424,0.52,0.2836,98,205,303,205
14144,8/17/2012,3,1,8,12,0,5,1,1,0.82,0.2424,0.41,0.2239,110,255,365,255
14145,8/17/2012,3,1,8,13,0,5,1,1,0.84,0.2424,0.36,0.3881,103,254,357,254
14146,8/17/2012,3,1,8,14,0,5,1,1,0.86,0.2424,0.34,0.4179,128,200,328,200
14147,8/17/2012,3,1,8,15,0,5,1,1,0.86,0.2424,0.3,0.4627,127,256,383,256
14148,8/17/2012,3,1,8,16,0,5,1,2,0.84,0.2424,0.32,0.4478,116,372,488,372
14149,8/17/2012,3,1,8,17,0,5,1,1,0.82,0.2424,0.36,0.3284,144,647,791,647
14150,8/17/2012,3,1,8,18,0,5,1,2,0.82,0.2424,0.38,0.2537,108,561,669,561
14151,8/17/2012,3,1,8,19,0,5,1,2,0.74,0.2424,0.55,0.3881,88,403,491,403
14152,8/17/2012,3,1,8,20,0,5,1,2,0.72,0.2424,0.58,0.2239,97,262,359,262
14153,8/17/2012,3,1,8,21,0,5,1,2,0.68,0.2424,0.69,0.2985,57,198,255,198
14154,8/17/2012,3,1,8,22,0,5,1,3,0.66,0.2424,0.83,0.194,43,170,213,170
14155,8/17/2012,3,1,8,23,0,5,1,3,0.64,0.2424,0.83,0.2239,21,100,121,100
14156,8/18/2012,3,1,8,0,0,6,0,2,0.64,0.5758,0.83,0.2239,6,99,105,99
14157,8/18/2012,3,1,8,1,0,6,0,3,0.62,0.5455,0.94,0.1642,14,78,92,78
14158,8/18/2012,3,1,8,2,0,6,0,3,0.62,0.5606,0.88,0.1642,4,39,43,39
14159,8/18/2012,3,1,8,3,0,6,0,1,0.62,0.5606,0.88,0.194,7,23,30,23
14160,8/18/2012,3,1,8,4,0,6,0,1,0.62,0.5909,0.73,0.2239,5,8,13,8
14161,8/18/2012,3,1,8,5,0,6,0,1,0.6,0.5758,0.78,0.2537,2,7,9,7
14162,8/18/2012,3,1,8,6,0,6,0,1,0.6,0.5606,0.83,0.2239,4,23,27,23
14163,8/18/2012,3,1,8,7,0,6,0,1,0.6,0.5606,0.83,0.2239,12,52,64,52
14164,8/18/2012,3,1,8,8,0,6,0,1,0.64,0.6061,0.69,0.2537,28,161,189,161
14165,8/18/2012,3,1,8,9,0,6,0,1,0.66,0.6212,0.65,0.2836,81,211,292,211
14166,8/18/2012,3,1,8,10,0,6,0,1,0.7,0.6515,0.54,0.1642,166,314,480,314
14167,8/18/2012,3,1,8,11,0,6,0,1,0.72,0.6667,0.51,0,180,356,536,356
14168,8/18/2012,3,1,8,12,0,6,0,1,0.76,0.6667,0.37,0.194,266,388,654,388
14169,8/18/2012,3,1,8,13,0,6,0,1,0.74,0.6515,0.4,0.194,289,355,644,355
14170,8/18/2012,3,1,8,14,0,6,0,1,0.76,0.6667,0.37,0.2836,242,356,598,356
14171,8/18/2012,3,1,8,15,0,6,0,1,0.76,0.6667,0.37,0.2239,250,346,596,346
14172,8/18/2012,3,1,8,16,0,6,0,1,0.76,0.6667,0.37,0.2537,287,354,641,354
14173,8/18/2012,3,1,8,17,0,6,0,1,0.76,0.6667,0.37,0.2239,256,379,635,379
14174,8/18/2012,3,1,8,18,0,6,0,1,0.74,0.6515,0.37,0.1642,225,329,554,329
14175,8/18/2012,3,1,8,19,0,6,0,1,0.7,0.6364,0.45,0.1642,164,324,488,324
14176,8/18/2012,3,1,8,20,0,6,0,1,0.7,0.6364,0.45,0.1045,99,242,341,242
14177,8/18/2012,3,1,8,21,0,6,0,1,0.66,0.6212,0.61,0,90,248,338,248
14178,8/18/2012,3,1,8,22,0,6,0,1,0.66,0.6212,0.61,0,90,171,261,171
14179,8/18/2012,3,1,8,23,0,6,0,1,0.64,0.6061,0.65,0.0896,60,175,235,175
14180,8/19/2012,3,1,8,0,0,0,0,1,0.66,0.6212,0.57,0.0896,44,143,187,143
14181,8/19/2012,3,1,8,1,0,0,0,1,0.64,0.6061,0.65,0,29,102,131,102
14182,8/19/2012,3,1,8,2,0,0,0,2,0.62,0.6061,0.69,0.0896,16,103,119,103
14183,8/19/2012,3,1,8,3,0,0,0,2,0.62,0.6061,0.61,0.1642,21,34,55,34
14184,8/19/2012,3,1,8,4,0,0,0,2,0.62,0.6061,0.65,0.1642,4,22,26,22
14185,8/19/2012,3,1,8,5,0,0,0,2,0.6,0.5909,0.73,0.1343,3,8,11,8
14186,8/19/2012,3,1,8,6,0,0,0,2,0.62,0.6061,0.69,0.1045,5,15,20,15
14187,8/19/2012,3,1,8,7,0,0,0,2,0.62,0.6061,0.69,0.1343,12,29,41,29
14188,8/19/2012,3,1,8,8,0,0,0,2,0.64,0.6061,0.69,0.1045,34,90,124,90
14189,8/19/2012,3,1,8,9,0,0,0,2,0.66,0.6212,0.74,0,86,184,270,184
14190,8/19/2012,3,1,8,10,0,0,0,2,0.68,0.6364,0.69,0,138,287,425,287
14191,8/19/2012,3,1,8,11,0,0,0,3,0.64,0.5909,0.78,0.1642,83,189,272,189
14192,8/19/2012,3,1,8,12,0,0,0,3,0.64,0.6061,0.73,0,112,186,298,186
14193,8/19/2012,3,1,8,13,0,0,0,3,0.64,0.5758,0.83,0.1343,50,112,162,112
14194,8/19/2012,3,1,8,14,0,0,0,3,0.64,0.6061,0.73,0,41,108,149,108
14195,8/19/2012,3,1,8,15,0,0,0,2,0.64,0.6061,0.65,0,89,187,276,187
14196,8/19/2012,3,1,8,16,0,0,0,2,0.66,0.6212,0.65,0,97,259,356,259
14197,8/19/2012,3,1,8,17,0,0,0,2,0.64,0.5909,0.78,0.1045,76,267,343,267
14198,8/19/2012,3,1,8,18,0,0,0,2,0.64,0.5909,0.78,0.1045,86,291,377,291
14199,8/19/2012,3,1,8,19,0,0,0,2,0.64,0.6061,0.73,0.1343,72,269,341,269
14200,8/19/2012,3,1,8,20,0,0,0,2,0.64,0.6061,0.73,0.194,61,213,274,213
14201,8/19/2012,3,1,8,21,0,0,0,3,0.62,0.5909,0.78,0.0896,36,154,190,154
14202,8/19/2012,3,1,8,22,0,0,0,2,0.62,0.5909,0.78,0.1642,6,50,56,50
14203,8/19/2012,3,1,8,23,0,0,0,2,0.62,0.5909,0.73,0,7,39,46,39
14204,8/20/2012,3,1,8,0,0,1,1,2,0.6,0.5606,0.83,0.1045,1,25,26,25
14205,8/20/2012,3,1,8,1,0,1,1,1,0.6,0.5606,0.83,0.1642,0,10,10,10
14206,8/20/2012,3,1,8,2,0,1,1,1,0.6,0.5606,0.83,0.1642,0,5,5,5
14207,8/20/2012,3,1,8,3,0,1,1,1,0.6,0.5455,0.88,0.1045,0,3,3,3
14208,8/20/2012,3,1,8,4,0,1,1,2,0.6,0.5606,0.83,0.0896,0,7,7,7
14209,8/20/2012,3,1,8,5,0,1,1,2,0.6,0.5606,0.83,0,2,35,37,35
14210,8/20/2012,3,1,8,6,0,1,1,2,0.6,0.5758,0.78,0.1343,6,155,161,155
14211,8/20/2012,3,1,8,7,0,1,1,2,0.62,0.5909,0.78,0.1343,15,427,442,427
14212,8/20/2012,3,1,8,8,0,1,1,2,0.62,0.5909,0.73,0.1045,37,618,655,618
14213,8/20/2012,3,1,8,9,0,1,1,2,0.64,0.6061,0.69,0,55,302,357,302
14214,8/20/2012,3,1,8,10,0,1,1,2,0.64,0.6061,0.69,0.0896,69,124,193,124
14215,8/20/2012,3,1,8,11,0,1,1,1,0.66,0.6212,0.65,0.1045,90,151,241,151
14216,8/20/2012,3,1,8,12,0,1,1,2,0.66,0.6212,0.61,0.1045,66,216,282,216
14217,8/20/2012,3,1,8,13,0,1,1,1,0.7,0.6515,0.58,0.1343,97,194,291,194
14218,8/20/2012,3,1,8,14,0,1,1,1,0.72,0.6667,0.54,0.1642,87,188,275,188
14219,8/20/2012,3,1,8,15,0,1,1,1,0.72,0.6667,0.54,0.2537,102,207,309,207
14220,8/20/2012,3,1,8,16,0,1,1,1,0.72,0.6667,0.54,0.2537,103,357,460,357
14221,8/20/2012,3,1,8,17,0,1,1,1,0.7,0.6515,0.58,0.2836,83,810,893,810
14222,8/20/2012,3,1,8,18,0,1,1,2,0.62,0.5909,0.78,0.2537,89,726,815,726
14223,8/20/2012,3,1,8,19,0,1,1,2,0.62,0.5909,0.78,0.194,33,266,299,266
14224,8/20/2012,3,1,8,20,0,1,1,2,0.62,0.5758,0.83,0.2836,30,231,261,231
14225,8/20/2012,3,1,8,21,0,1,1,1,0.6,0.5606,0.83,0,26,219,245,219
14226,8/20/2012,3,1,8,22,0,1,1,2,0.6,0.5606,0.83,0,25,136,161,136
14227,8/20/2012,3,1,8,23,0,1,1,2,0.6,0.5606,0.83,0,10,92,102,92
14228,8/21/2012,3,1,8,0,0,2,1,2,0.6,0.5606,0.83,0.0896,7,52,59,52
14229,8/21/2012,3,1,8,1,0,2,1,2,0.6,0.5606,0.83,0.1343,11,22,33,22
14230,8/21/2012,3,1,8,2,0,2,1,2,0.58,0.5455,0.88,0.2836,1,7,8,7
14231,8/21/2012,3,1,8,3,0,2,1,1,0.56,0.5303,0.88,0,0,3,3,3
14232,8/21/2012,3,1,8,4,0,2,1,1,0.56,0.5303,0.88,0,0,4,4,4
14233,8/21/2012,3,1,8,5,0,2,1,1,0.56,0.5303,0.83,0.0896,4,30,34,30
14234,8/21/2012,3,1,8,6,0,2,1,1,0.56,0.5303,0.83,0.1045,5,164,169,164
14235,8/21/2012,3,1,8,7,0,2,1,1,0.6,0.5758,0.78,0.1045,19,500,519,500
14236,8/21/2012,3,1,8,8,0,2,1,1,0.6,0.5758,0.78,0.1343,27,696,723,696
14237,8/21/2012,3,1,8,9,0,2,1,1,0.64,0.6061,0.69,0,47,281,328,281
14238,8/21/2012,3,1,8,10,0,2,1,1,0.66,0.6212,0.61,0.1045,58,120,178,120
14239,8/21/2012,3,1,8,11,0,2,1,1,0.7,0.6515,0.54,0,61,195,256,195
14240,8/21/2012,3,1,8,12,0,2,1,1,0.72,0.6515,0.45,0,79,226,305,226
14241,8/21/2012,3,1,8,13,0,2,1,1,0.74,0.6515,0.4,0,76,255,331,255
14242,8/21/2012,3,1,8,14,0,2,1,1,0.76,0.6667,0.37,0.0896,110,192,302,192
14243,8/21/2012,3,1,8,15,0,2,1,1,0.76,0.6667,0.37,0,76,226,302,226
14244,8/21/2012,3,1,8,16,0,2,1,1,0.76,0.6667,0.37,0,109,358,467,358
14245,8/21/2012,3,1,8,17,0,2,1,1,0.74,0.6667,0.51,0.2836,92,786,878,786
14246,8/21/2012,3,1,8,18,0,2,1,1,0.72,0.6667,0.54,0.2239,93,532,625,532
14247,8/21/2012,3,1,8,19,0,2,1,3,0.62,0.5909,0.73,0.1045,56,420,476,420
14248,8/21/2012,3,1,8,20,0,2,1,1,0.64,0.6061,0.73,0,62,296,358,296
14249,8/21/2012,3,1,8,21,0,2,1,1,0.64,0.6061,0.73,0,41,239,280,239
14250,8/21/2012,3,1,8,22,0,2,1,1,0.64,0.5909,0.78,0,24,208,232,208
14251,8/21/2012,3,1,8,23,0,2,1,1,0.62,0.5758,0.83,0,23,113,136,113
14252,8/22/2012,3,1,8,0,0,3,1,1,0.62,0.5758,0.83,0.1045,9,46,55,46
14253,8/22/2012,3,1,8,1,0,3,1,1,0.62,0.5909,0.78,0,1,20,21,20
14254,8/22/2012,3,1,8,2,0,3,1,1,0.62,0.5909,0.78,0,7,10,17,10
14255,8/22/2012,3,1,8,3,0,3,1,1,0.62,0.5909,0.78,0,0,7,7,7
14256,8/22/2012,3,1,8,4,0,3,1,1,0.58,0.5455,0.83,0.1045,1,7,8,7
14257,8/22/2012,3,1,8,5,0,3,1,1,0.6,0.5758,0.78,0,2,38,40,38
14258,8/22/2012,3,1,8,6,0,3,1,1,0.62,0.5909,0.73,0,12,175,187,175
14259,8/22/2012,3,1,8,7,0,3,1,1,0.62,0.5909,0.78,0,16,537,553,537
14260,8/22/2012,3,1,8,8,0,3,1,1,0.64,0.6061,0.73,0.0896,37,703,740,703
14261,8/22/2012,3,1,8,9,0,3,1,1,0.68,0.6364,0.65,0,41,335,376,335
14262,8/22/2012,3,1,8,10,0,3,1,1,0.7,0.6515,0.61,0.0896,66,159,225,159
14263,8/22/2012,3,1,8,11,0,3,1,1,0.72,0.6667,0.58,0.0896,71,196,267,196
14264,8/22/2012,3,1,8,12,0,3,1,1,0.74,0.6667,0.51,0,59,253,312,253
14265,8/22/2012,3,1,8,13,0,3,1,1,0.76,0.6818,0.48,0.1045,74,242,316,242
14266,8/22/2012,3,1,8,14,0,3,1,1,0.76,0.6818,0.45,0.1045,82,184,266,184
14267,8/22/2012,3,1,8,15,0,3,1,1,0.76,0.6818,0.48,0.1343,94,222,316,222
14268,8/22/2012,3,1,8,16,0,3,1,3,0.74,0.6818,0.55,0.2239,102,358,460,358
14269,8/22/2012,3,1,8,17,0,3,1,3,0.74,0.6818,0.55,0.2239,72,711,783,711
14270,8/22/2012,3,1,8,18,0,3,1,3,0.66,0.6212,0.61,0.2239,91,592,683,592
14271,8/22/2012,3,1,8,19,0,3,1,2,0.66,0.6212,0.74,0,56,524,580,524
14272,8/22/2012,3,1,8,20,0,3,1,1,0.64,0.6061,0.73,0.194,59,332,391,332
14273,8/22/2012,3,1,8,21,0,3,1,1,0.64,0.6061,0.73,0,60,291,351,291
14274,8/22/2012,3,1,8,22,0,3,1,1,0.64,0.6061,0.73,0,55,226,281,226
14275,8/22/2012,3,1,8,23,0,3,1,1,0.64,0.5758,0.83,0,27,113,140,113
14276,8/23/2012,3,1,8,0,0,4,1,1,0.64,0.5909,0.78,0,9,51,60,51
14277,8/23/2012,3,1,8,1,0,4,1,1,0.62,0.5758,0.83,0,10,15,25,15
14278,8/23/2012,3,1,8,2,0,4,1,1,0.62,0.5758,0.83,0,9,11,20,11
14279,8/23/2012,3,1,8,3,0,4,1,1,0.62,0.5758,0.83,0.0896,3,6,9,6
14280,8/23/2012,3,1,8,4,0,4,1,1,0.62,0.5758,0.83,0,0,6,6,6
14281,8/23/2012,3,1,8,5,0,4,1,1,0.62,0.5758,0.83,0,1,36,37,36
14282,8/23/2012,3,1,8,6,0,4,1,2,0.6,0.5455,0.88,0.0896,14,178,192,178
14283,8/23/2012,3,1,8,7,0,4,1,2,0.62,0.5758,0.83,0.0896,18,463,481,463
14284,8/23/2012,3,1,8,8,0,4,1,2,0.66,0.6212,0.74,0.0896,45,662,707,662
14285,8/23/2012,3,1,8,9,0,4,1,2,0.7,0.6515,0.7,0,58,354,412,354
14286,8/23/2012,3,1,8,10,0,4,1,1,0.74,0.6818,0.58,0.0896,76,157,233,157
14287,8/23/2012,3,1,8,11,0,4,1,1,0.76,0.6818,0.48,0.0896,86,192,278,192
14288,8/23/2012,3,1,8,12,0,4,1,1,0.78,0.6818,0.38,0,97,235,332,235
14289,8/23/2012,3,1,8,13,0,4,1,1,0.82,0.7273,0.38,0.0896,93,253,346,253
14290,8/23/2012,3,1,8,14,0,4,1,1,0.78,0.697,0.46,0.2239,114,191,305,191
14291,8/23/2012,3,1,8,15,0,4,1,1,0.78,0.697,0.46,0.1343,104,201,305,201
14292,8/23/2012,3,1,8,16,0,4,1,1,0.76,0.6818,0.48,0.1642,121,344,465,344
14293,8/23/2012,3,1,8,17,0,4,1,1,0.76,0.6818,0.45,0.2239,111,709,820,709
14294,8/23/2012,3,1,8,18,0,4,1,1,0.74,0.6667,0.48,0.2239,130,811,941,811
14295,8/23/2012,3,1,8,19,0,4,1,1,0.72,0.6667,0.51,0.0896,96,537,633,537
14296,8/23/2012,3,1,8,20,0,4,1,1,0.7,0.6515,0.61,0.1045,70,404,474,404
14297,8/23/2012,3,1,8,21,0,4,1,1,0.7,0.6515,0.61,0.1343,53,276,329,276
14298,8/23/2012,3,1,8,22,0,4,1,2,0.68,0.6364,0.61,0.1045,21,177,198,177
14299,8/23/2012,3,1,8,23,0,4,1,2,0.66,0.6212,0.69,0,24,133,157,133
14300,8/24/2012,3,1,8,0,0,5,1,2,0.66,0.6212,0.69,0,27,84,111,84
14301,8/24/2012,3,1,8,1,0,5,1,2,0.64,0.6061,0.73,0,5,37,42,37
14302,8/24/2012,3,1,8,2,0,5,1,1,0.66,0.6212,0.69,0,1,15,16,15
14303,8/24/2012,3,1,8,3,0,5,1,1,0.64,0.6061,0.73,0,2,6,8,6
14304,8/24/2012,3,1,8,4,0,5,1,2,0.64,0.6061,0.73,0,2,6,8,6
14305,8/24/2012,3,1,8,5,0,5,1,1,0.64,0.5909,0.78,0,1,37,38,37
14306,8/24/2012,3,1,8,6,0,5,1,2,0.62,0.5758,0.83,0,9,142,151,142
14307,8/24/2012,3,1,8,7,0,5,1,2,0.64,0.5909,0.78,0,13,412,425,412
14308,8/24/2012,3,1,8,8,0,5,1,2,0.66,0.6212,0.74,0,41,703,744,703
14309,8/24/2012,3,1,8,9,0,5,1,2,0.72,0.6667,0.58,0,58,331,389,331
14310,8/24/2012,3,1,8,10,0,5,1,2,0.76,0.6818,0.48,0,78,184,262,184
14311,8/24/2012,3,1,8,11,0,5,1,2,0.76,0.6818,0.48,0.1045,69,212,281,212
14312,8/24/2012,3,1,8,12,0,5,1,2,0.76,0.6818,0.45,0.0896,95,276,371,276
14313,8/24/2012,3,1,8,13,0,5,1,2,0.8,0.7121,0.41,0.1045,79,272,351,272
14314,8/24/2012,3,1,8,14,0,5,1,1,0.78,0.697,0.43,0.1045,109,229,338,229
14315,8/24/2012,3,1,8,15,0,5,1,2,0.76,0.6818,0.48,0.1343,99,251,350,251
14316,8/24/2012,3,1,8,16,0,5,1,2,0.76,0.6818,0.48,0.1343,101,414,515,414
14317,8/24/2012,3,1,8,17,0,5,1,2,0.74,0.6667,0.51,0.2239,117,695,812,695
14318,8/24/2012,3,1,8,18,0,5,1,2,0.72,0.6818,0.62,0.194,109,627,736,627
14319,8/24/2012,3,1,8,19,0,5,1,2,0.72,0.6667,0.58,0.1642,106,430,536,430
14320,8/24/2012,3,1,8,20,0,5,1,2,0.7,0.6515,0.65,0.2239,66,297,363,297
14321,8/24/2012,3,1,8,21,0,5,1,2,0.7,0.6515,0.61,0.1642,58,248,306,248
14322,8/24/2012,3,1,8,22,0,5,1,2,0.7,0.6515,0.61,0,42,209,251,209
14323,8/24/2012,3,1,8,23,0,5,1,2,0.68,0.6364,0.69,0.0896,38,140,178,140
14324,8/25/2012,3,1,8,0,0,6,0,2,0.7,0.6515,0.61,0,21,114,135,114
14325,8/25/2012,3,1,8,1,0,6,0,2,0.68,0.6364,0.69,0,15,100,115,100
14326,8/25/2012,3,1,8,2,0,6,0,2,0.66,0.6212,0.74,0.0896,18,61,79,61
14327,8/25/2012,3,1,8,3,0,6,0,1,0.66,0.6212,0.69,0.0896,7,31,38,31
14328,8/25/2012,3,1,8,4,0,6,0,2,0.66,0.6212,0.69,0.1045,3,9,12,9
14329,8/25/2012,3,1,8,5,0,6,0,2,0.64,0.6061,0.73,0.1642,4,10,14,10
14330,8/25/2012,3,1,8,6,0,6,0,2,0.64,0.5909,0.78,0.1642,5,25,30,25
14331,8/25/2012,3,1,8,7,0,6,0,2,0.64,0.5909,0.78,0.194,14,88,102,88
14332,8/25/2012,3,1,8,8,0,6,0,2,0.66,0.6212,0.74,0.2537,29,133,162,133
14333,8/25/2012,3,1,8,9,0,6,0,2,0.68,0.6364,0.69,0.2836,60,228,288,228
14334,8/25/2012,3,1,8,10,0,6,0,2,0.7,0.6515,0.65,0.2985,148,294,442,294
14335,8/25/2012,3,1,8,11,0,6,0,2,0.72,0.6818,0.62,0.2836,143,314,457,314
14336,8/25/2012,3,1,8,12,0,6,0,3,0.72,0.6667,0.54,0.3881,217,367,584,367
14337,8/25/2012,3,1,8,13,0,6,0,2,0.72,0.6667,0.51,0.3582,186,331,517,331
14338,8/25/2012,3,1,8,14,0,6,0,3,0.66,0.6212,0.65,0.2537,150,332,482,332
14339,8/25/2012,3,1,8,15,0,6,0,2,0.64,0.6061,0.73,0.3284,79,154,233,154
14340,8/25/2012,3,1,8,16,0,6,0,2,0.66,0.6212,0.74,0.2985,174,260,434,260
14341,8/25/2012,3,1,8,17,0,6,0,2,0.66,0.6212,0.74,0.3284,132,271,403,271
14342,8/25/2012,3,1,8,18,0,6,0,2,0.66,0.6212,0.69,0.4627,122,261,383,261
14343,8/25/2012,3,1,8,19,0,6,0,2,0.64,0.5909,0.78,0.2985,97,257,354,257
14344,8/25/2012,3,1,8,20,0,6,0,3,0.62,0.5758,0.83,0.2537,65,176,241,176
14345,8/25/2012,3,1,8,21,0,6,0,1,0.62,0.5758,0.83,0.3582,60,148,208,148
14346,8/25/2012,3,1,8,22,0,6,0,1,0.62,0.5758,0.83,0.3582,46,136,182,136
14347,8/25/2012,3,1,8,23,0,6,0,2,0.62,0.5758,0.83,0.2537,34,124,158,124
14348,8/26/2012,3,1,8,0,0,0,0,1,0.64,0.5758,0.89,0.2537,23,111,134,111
14349,8/26/2012,3,1,8,1,0,0,0,1,0.64,0.5758,0.89,0.194,18,116,134,116
14350,8/26/2012,3,1,8,2,0,0,0,2,0.64,0.5758,0.89,0.2239,12,104,116,104
14351,8/26/2012,3,1,8,3,0,0,0,2,0.64,0.5758,0.89,0.2537,11,42,53,42
14352,8/26/2012,3,1,8,4,0,0,0,2,0.64,0.5758,0.89,0.194,5,11,16,11
14353,8/26/2012,3,1,8,5,0,0,0,1,0.64,0.5758,0.89,0.194,3,13,16,13
14354,8/26/2012,3,1,8,6,0,0,0,1,0.62,0.5606,0.88,0.2985,5,16,21,16
14355,8/26/2012,3,1,8,7,0,0,0,1,0.64,0.5758,0.89,0.194,11,23,34,23
14356,8/26/2012,3,1,8,8,0,0,0,1,0.68,0.6364,0.79,0.2836,21,112,133,112
14357,8/26/2012,3,1,8,9,0,0,0,1,0.68,0.6364,0.79,0.2537,67,196,263,196
14358,8/26/2012,3,1,8,10,0,0,0,1,0.74,0.697,0.66,0.3881,127,258,385,258
14359,8/26/2012,3,1,8,11,0,0,0,1,0.74,0.697,0.66,0.3582,150,332,482,332
14360,8/26/2012,3,1,8,12,0,0,0,3,0.72,0.697,0.74,0.3582,225,401,626,401
14361,8/26/2012,3,1,8,13,0,0,0,3,0.66,0.6061,0.78,0.4179,166,375,541,375
14362,8/26/2012,3,1,8,14,0,0,0,1,0.64,0.5758,0.89,0.1045,125,252,377,252
14363,8/26/2012,3,1,8,15,0,0,0,3,0.64,0.5758,0.89,0.2836,132,259,391,259
14364,8/26/2012,3,1,8,16,0,0,0,3,0.64,0.5758,0.89,0.2836,57,116,173,116
14365,8/26/2012,3,1,8,17,0,0,0,1,0.64,0.5758,0.89,0.2239,61,172,233,172
14366,8/26/2012,3,1,8,18,0,0,0,2,0.64,0.5758,0.89,0.0896,77,187,264,187
14367,8/26/2012,3,1,8,19,0,0,0,2,0.64,0.5758,0.89,0.1642,80,212,292,212
14368,8/26/2012,3,1,8,20,0,0,0,1,0.64,0.5758,0.89,0.1642,40,171,211,171
14369,8/26/2012,3,1,8,21,0,0,0,1,0.64,0.5758,0.83,0.1343,26,140,166,140
14370,8/26/2012,3,1,8,22,0,0,0,1,0.62,0.5606,0.88,0.0896,20,94,114,94
14371,8/26/2012,3,1,8,23,0,0,0,1,0.62,0.5758,0.83,0.0896,21,59,80,59
14372,8/27/2012,3,1,8,0,0,1,1,1,0.62,0.5758,0.83,0,4,28,32,28
14373,8/27/2012,3,1,8,1,0,1,1,1,0.62,0.5606,0.88,0.0896,3,4,7,4
14374,8/27/2012,3,1,8,2,0,1,1,1,0.62,0.5606,0.88,0.1343,0,8,8,8
14375,8/27/2012,3,1,8,3,0,1,1,1,0.62,0.5606,0.88,0.0896,1,3,4,3
14376,8/27/2012,3,1,8,4,0,1,1,1,0.62,0.5758,0.83,0,1,11,12,11
14377,8/27/2012,3,1,8,5,0,1,1,1,0.62,0.5606,0.88,0,4,32,36,32
14378,8/27/2012,3,1,8,6,0,1,1,1,0.62,0.5606,0.88,0,4,141,145,141
14379,8/27/2012,3,1,8,7,0,1,1,1,0.66,0.6061,0.83,0,15,418,433,418
14380,8/27/2012,3,1,8,8,0,1,1,1,0.66,0.6061,0.83,0.0896,29,670,699,670
14381,8/27/2012,3,1,8,9,0,1,1,1,0.66,0.6061,0.83,0.1045,40,302,342,302
14382,8/27/2012,3,1,8,10,0,1,1,1,0.72,0.697,0.74,0.1343,63,143,206,143
14383,8/27/2012,3,1,8,11,0,1,1,1,0.74,0.697,0.66,0.194,47,182,229,182
14384,8/27/2012,3,1,8,12,0,1,1,1,0.76,0.7121,0.62,0,69,214,283,214
14385,8/27/2012,3,1,8,13,0,1,1,1,0.76,0.7121,0.57,0.1642,77,211,288,211
14386,8/27/2012,3,1,8,14,0,1,1,1,0.8,0.7424,0.49,0.0896,66,180,246,180
14387,8/27/2012,3,1,8,15,0,1,1,1,0.8,0.7576,0.55,0.2985,77,205,282,205
14388,8/27/2012,3,1,8,16,0,1,1,1,0.8,0.7576,0.55,0.2537,77,367,444,367
14389,8/27/2012,3,1,8,17,0,1,1,1,0.8,0.7273,0.46,0.2239,101,744,845,744
14390,8/27/2012,3,1,8,18,0,1,1,1,0.78,0.7121,0.52,0.2537,83,751,834,751
14391,8/27/2012,3,1,8,19,0,1,1,1,0.74,0.697,0.7,0.2239,74,499,573,499
14392,8/27/2012,3,1,8,20,0,1,1,1,0.74,0.697,0.7,0.194,50,366,416,366
14393,8/27/2012,3,1,8,21,0,1,1,1,0.72,0.697,0.74,0.194,39,239,278,239
14394,8/27/2012,3,1,8,22,0,1,1,1,0.7,0.6667,0.84,0.194,30,131,161,131
14395,8/27/2012,3,1,8,23,0,1,1,1,0.7,0.6667,0.84,0.1642,35,79,114,79
14396,8/28/2012,3,1,8,0,0,2,1,1,0.7,0.6667,0.84,0.2537,9,29,38,29
14397,8/28/2012,3,1,8,1,0,2,1,1,0.68,0.6364,0.89,0.194,4,17,21,17
14398,8/28/2012,3,1,8,2,0,2,1,1,0.68,0.6364,0.83,0.2537,2,13,15,13
14399,8/28/2012,3,1,8,3,0,2,1,1,0.66,0.5909,0.89,0.1343,0,4,4,4
14400,8/28/2012,3,1,8,4,0,2,1,1,0.66,0.6061,0.83,0.1343,2,6,8,6
14401,8/28/2012,3,1,8,5,0,2,1,2,0.66,0.6061,0.83,0.0896,3,39,42,39
14402,8/28/2012,3,1,8,6,0,2,1,2,0.66,0.5909,0.89,0.1045,3,144,147,144
14403,8/28/2012,3,1,8,7,0,2,1,2,0.66,0.6061,0.83,0.1045,14,255,269,255
14404,8/28/2012,3,1,8,8,0,2,1,2,0.66,0.6212,0.85,0.1045,25,668,693,668
14405,8/28/2012,3,1,8,9,0,2,1,2,0.7,0.6667,0.79,0.1642,44,351,395,351
14406,8/28/2012,3,1,8,10,0,2,1,1,0.74,0.6818,0.62,0.2537,39,165,204,165
14407,8/28/2012,3,1,8,11,0,2,1,1,0.78,0.7273,0.55,0.2537,47,171,218,171
14408,8/28/2012,3,1,8,12,0,2,1,1,0.8,0.7424,0.49,0.2836,56,241,297,241
14409,8/28/2012,3,1,8,13,0,2,1,1,0.82,0.7424,0.43,0.2985,56,232,288,232
14410,8/28/2012,3,1,8,14,0,2,1,1,0.84,0.7424,0.38,0.3284,72,179,251,179
14411,8/28/2012,3,1,8,15,0,2,1,1,0.82,0.7273,0.34,0.2985,59,258,317,258
14412,8/28/2012,3,1,8,16,0,2,1,1,0.82,0.7121,0.33,0.3284,84,396,480,396
14413,8/28/2012,3,1,8,17,0,2,1,1,0.8,0.697,0.35,0.3881,90,774,864,774
14414,8/28/2012,3,1,8,18,0,2,1,1,0.78,0.697,0.4,0.2537,82,736,818,736
14415,8/28/2012,3,1,8,19,0,2,1,1,0.74,0.6667,0.45,0.1642,82,515,597,515
14416,8/28/2012,3,1,8,20,0,2,1,1,0.72,0.6667,0.48,0.1045,87,348,435,348
14417,8/28/2012,3,1,8,21,0,2,1,1,0.72,0.6667,0.48,0.0896,38,276,314,276
14418,8/28/2012,3,1,8,22,0,2,1,1,0.7,0.6515,0.54,0,20,196,216,196
14419,8/28/2012,3,1,8,23,0,2,1,1,0.68,0.6364,0.57,0,17,92,109,92
14420,8/29/2012,3,1,8,0,0,3,1,1,0.66,0.6212,0.69,0,8,39,47,39
14421,8/29/2012,3,1,8,1,0,3,1,1,0.64,0.6061,0.69,0.1343,2,12,14,12
14422,8/29/2012,3,1,8,2,0,3,1,1,0.62,0.5909,0.73,0.1343,2,4,6,4
14423,8/29/2012,3,1,8,3,0,3,1,1,0.62,0.5909,0.73,0.1045,0,9,9,9
14424,8/29/2012,3,1,8,4,0,3,1,1,0.6,0.5909,0.73,0.2239,2,8,10,8
14425,8/29/2012,3,1,8,5,0,3,1,1,0.6,0.5909,0.73,0.194,3,37,40,37
14426,8/29/2012,3,1,8,6,0,3,1,1,0.6,0.5909,0.73,0.194,6,175,181,175
14427,8/29/2012,3,1,8,7,0,3,1,1,0.64,0.6061,0.65,0.0896,23,531,554,531
14428,8/29/2012,3,1,8,8,0,3,1,1,0.66,0.6212,0.61,0.1642,28,780,808,780
14429,8/29/2012,3,1,8,9,0,3,1,1,0.7,0.6515,0.51,0.194,40,308,348,308
14430,8/29/2012,3,1,8,10,0,3,1,1,0.72,0.6667,0.48,0.1642,34,144,178,144
14431,8/29/2012,3,1,8,11,0,3,1,1,0.72,0.6515,0.45,0,67,186,253,186
14432,8/29/2012,3,1,8,12,0,3,1,1,0.76,0.6818,0.4,0,79,281,360,281
14433,8/29/2012,3,1,8,13,0,3,1,1,0.74,0.6667,0.42,0,68,232,300,232
14434,8/29/2012,3,1,8,14,0,3,1,1,0.76,0.6818,0.4,0.0896,87,214,301,214
14435,8/29/2012,3,1,8,15,0,3,1,1,0.76,0.6818,0.4,0.194,96,242,338,242
14436,8/29/2012,3,1,8,16,0,3,1,1,0.76,0.6667,0.37,0.1343,104,389,493,389
14437,8/29/2012,3,1,8,17,0,3,1,1,0.78,0.6818,0.35,0.2239,108,762,870,762
14438,8/29/2012,3,1,8,18,0,3,1,1,0.74,0.6667,0.42,0.1642,119,693,812,693
14439,8/29/2012,3,1,8,19,0,3,1,1,0.7,0.6515,0.54,0.194,120,523,643,523
14440,8/29/2012,3,1,8,20,0,3,1,1,0.68,0.6364,0.57,0,49,378,427,378
14441,8/29/2012,3,1,8,21,0,3,1,1,0.66,0.6212,0.54,0.1045,48,265,313,265
14442,8/29/2012,3,1,8,22,0,3,1,1,0.66,0.6212,0.54,0,50,185,235,185
14443,8/29/2012,3,1,8,23,0,3,1,1,0.66,0.6212,0.57,0,34,123,157,123
14444,8/30/2012,3,1,8,0,0,4,1,1,0.64,0.6061,0.69,0,14,51,65,51
14445,8/30/2012,3,1,8,1,0,4,1,1,0.64,0.6061,0.65,0,6,17,23,17
14446,8/30/2012,3,1,8,2,0,4,1,1,0.62,0.5909,0.73,0,3,14,17,14
14447,8/30/2012,3,1,8,3,0,4,1,1,0.62,0.5909,0.73,0,0,5,5,5
14448,8/30/2012,3,1,8,4,0,4,1,1,0.62,0.5909,0.73,0,4,4,8,4
14449,8/30/2012,3,1,8,5,0,4,1,1,0.62,0.5909,0.73,0,2,33,35,33
14450,8/30/2012,3,1,8,6,0,4,1,1,0.6,0.5606,0.83,0.1642,8,155,163,155
14451,8/30/2012,3,1,8,7,0,4,1,1,0.64,0.6061,0.73,0,31,501,532,501
14452,8/30/2012,3,1,8,8,0,4,1,1,0.66,0.6212,0.65,0,53,701,754,701
14453,8/30/2012,3,1,8,9,0,4,1,1,0.7,0.6515,0.58,0,57,339,396,339
14454,8/30/2012,3,1,8,10,0,4,1,1,0.72,0.6667,0.54,0,73,161,234,161
14455,8/30/2012,3,1,8,11,0,4,1,1,0.76,0.6818,0.4,0.0896,85,191,276,191
14456,8/30/2012,3,1,8,12,0,4,1,1,0.76,0.6818,0.45,0.1343,73,221,294,221
14457,8/30/2012,3,1,8,13,0,4,1,1,0.76,0.6818,0.48,0.1045,76,214,290,214
14458,8/30/2012,3,1,8,14,0,4,1,1,0.76,0.6818,0.48,0.1343,74,199,273,199
14459,8/30/2012,3,1,8,15,0,4,1,1,0.8,0.7273,0.46,0.1642,99,239,338,239
14460,8/30/2012,3,1,8,16,0,4,1,1,0.8,0.7273,0.43,0.1642,77,405,482,405
14461,8/30/2012,3,1,8,17,0,4,1,1,0.82,0.7273,0.34,0.2239,93,751,844,751
14462,8/30/2012,3,1,8,18,0,4,1,1,0.8,0.7121,0.38,0.1343,109,744,853,744
14463,8/30/2012,3,1,8,19,0,4,1,1,0.76,0.6818,0.48,0.1343,78,532,610,532
14464,8/30/2012,3,1,8,20,0,4,1,1,0.74,0.6818,0.58,0.1642,68,403,471,403
14465,8/30/2012,3,1,8,21,0,4,1,1,0.72,0.6818,0.66,0.1343,32,275,307,275
14466,8/30/2012,3,1,8,22,0,4,1,1,0.7,0.6515,0.7,0,38,253,291,253
14467,8/30/2012,3,1,8,23,0,4,1,1,0.7,0.6667,0.74,0.1045,19,133,152,133
14468,8/31/2012,3,1,8,0,0,5,1,1,0.68,0.6364,0.83,0.1642,13,69,82,69
14469,8/31/2012,3,1,8,1,0,5,1,1,0.68,0.6364,0.83,0.1642,8,24,32,24
14470,8/31/2012,3,1,8,2,0,5,1,1,0.66,0.5909,0.89,0.1343,9,11,20,11
14471,8/31/2012,3,1,8,3,0,5,1,1,0.66,0.5909,0.89,0.1045,3,2,5,2
14472,8/31/2012,3,1,8,4,0,5,1,1,0.64,0.5758,0.89,0.1343,0,7,7,7
14473,8/31/2012,3,1,8,5,0,5,1,1,0.64,0.5758,0.89,0.1642,2,27,29,27
14474,8/31/2012,3,1,8,6,0,5,1,2,0.64,0.5758,0.89,0.1642,7,101,108,101
14475,8/31/2012,3,1,8,7,0,5,1,2,0.64,0.5758,0.89,0.0896,21,400,421,400
14476,8/31/2012,3,1,8,8,0,5,1,2,0.7,0.6667,0.74,0,36,654,690,654
14477,8/31/2012,3,1,8,9,0,5,1,1,0.74,0.697,0.7,0,61,337,398,337
14478,8/31/2012,3,1,8,10,0,5,1,1,0.76,0.7121,0.62,0.0896,59,197,256,197
14479,8/31/2012,3,1,8,11,0,5,1,1,0.86,0.7424,0.28,0.2985,88,221,309,221
14480,8/31/2012,3,1,8,12,0,5,1,1,0.86,0.7424,0.26,0.2537,120,290,410,290
14481,8/31/2012,3,1,8,13,0,5,1,1,0.88,0.7576,0.27,0.3284,97,271,368,271
14482,8/31/2012,3,1,8,14,0,5,1,1,0.9,0.7727,0.25,0.2239,112,324,436,324
14483,8/31/2012,3,1,8,15,0,5,1,1,0.9,0.7879,0.27,0.2985,109,417,526,417
14484,8/31/2012,3,1,8,16,0,5,1,1,0.9,0.7879,0.27,0.2537,111,417,528,417
14485,8/31/2012,3,1,8,17,0,5,1,1,0.88,0.7727,0.32,0.1642,129,488,617,488
14486,8/31/2012,3,1,8,18,0,5,1,1,0.86,0.7576,0.36,0.2537,87,459,546,459
14487,8/31/2012,3,1,8,19,0,5,1,1,0.8,0.7424,0.49,0.1343,91,361,452,361
14488,8/31/2012,3,1,8,20,0,5,1,1,0.8,0.7424,0.49,0.1343,102,254,356,254
14489,8/31/2012,3,1,8,21,0,5,1,1,0.76,0.7121,0.58,0.194,71,232,303,232
14490,8/31/2012,3,1,8,22,0,5,1,1,0.76,0.7121,0.58,0.194,65,212,277,212
14491,8/31/2012,3,1,8,23,0,5,1,1,0.74,0.6818,0.62,0.1045,32,142,174,142
14492,9/1/2012,3,1,9,0,0,6,0,1,0.74,0.6818,0.62,0.1045,22,146,168,146
14493,9/1/2012,3,1,9,1,0,6,0,1,0.72,0.697,0.74,0.1343,11,68,79,68
14494,9/1/2012,3,1,9,2,0,6,0,1,0.7,0.6515,0.7,0.1642,8,61,69,61
14495,9/1/2012,3,1,9,3,0,6,0,1,0.7,0.6515,0.7,0.1045,6,29,35,29
14496,9/1/2012,3,1,9,4,0,6,0,1,0.7,0.6515,0.7,0,3,9,12,9
14497,9/1/2012,3,1,9,5,0,6,0,1,0.68,0.6364,0.79,0,2,20,22,20
14498,9/1/2012,3,1,9,6,0,6,0,1,0.68,0.6364,0.79,0,13,23,36,23
14499,9/1/2012,3,1,9,7,0,6,0,2,0.74,0.6818,0.58,0.1343,8,58,66,58
14500,9/1/2012,3,1,9,8,0,6,0,2,0.76,0.7121,0.58,0.2537,28,134,162,134
14501,9/1/2012,3,1,9,9,0,6,0,2,0.76,0.7121,0.58,0.194,62,175,237,175
14502,9/1/2012,3,1,9,10,0,6,0,2,0.78,0.7273,0.55,0.194,128,289,417,289
14503,9/1/2012,3,1,9,11,0,6,0,2,0.8,0.7576,0.55,0.2239,219,273,492,273
14504,9/1/2012,3,1,9,12,0,6,0,2,0.8,0.7576,0.55,0.1642,187,284,471,284
14505,9/1/2012,3,1,9,13,0,6,0,2,0.82,0.7727,0.52,0.0896,237,267,504,267
14506,9/1/2012,3,1,9,14,0,6,0,2,0.86,0.7879,0.44,0.1642,240,274,514,274
14507,9/1/2012,3,1,9,15,0,6,0,2,0.86,0.7879,0.44,0.2836,257,306,563,306
14508,9/1/2012,3,1,9,16,0,6,0,2,0.84,0.7879,0.49,0.1642,209,253,462,253
14509,9/1/2012,3,1,9,17,0,6,0,2,0.82,0.7727,0.52,0,205,258,463,258
14510,9/1/2012,3,1,9,18,0,6,0,2,0.82,0.7727,0.52,0,184,258,442,258
14511,9/1/2012,3,1,9,19,0,6,0,3,0.78,0.7424,0.62,0,157,235,392,235
14512,9/1/2012,3,1,9,20,0,6,0,3,0.76,0.7273,0.67,0.2537,67,140,207,140
14513,9/1/2012,3,1,9,21,0,6,0,3,0.64,0.5758,0.89,0,21,83,104,83
14514,9/1/2012,3,1,9,22,0,6,0,2,0.66,0.5909,0.89,0,21,57,78,57
14515,9/1/2012,3,1,9,23,0,6,0,1,0.66,0.5909,0.89,0.0896,57,88,145,88
14516,9/2/2012,3,1,9,0,0,0,0,2,0.66,0.5909,0.89,0.0896,27,72,99,72
14517,9/2/2012,3,1,9,1,0,0,0,1,0.66,0.5909,0.89,0,15,58,73,58
14518,9/2/2012,3,1,9,2,0,0,0,1,0.66,0.5909,0.89,0,28,56,84,56
14519,9/2/2012,3,1,9,3,0,0,0,1,0.66,0.5909,0.89,0.0896,9,33,42,33
14520,9/2/2012,3,1,9,4,0,0,0,1,0.66,0.5909,0.89,0,7,15,22,15
14521,9/2/2012,3,1,9,5,0,0,0,1,0.66,0.5909,0.89,0,2,10,12,10
14522,9/2/2012,3,1,9,6,0,0,0,2,0.66,0.5909,0.89,0,2,13,15,13
14523,9/2/2012,3,1,9,7,0,0,0,1,0.66,0.5909,0.94,0.0896,13,29,42,29
14524,9/2/2012,3,1,9,8,0,0,0,1,0.68,0.6364,0.89,0.0896,30,99,129,99
14525,9/2/2012,3,1,9,9,0,0,0,2,0.7,0.6667,0.84,0,88,144,232,144
14526,9/2/2012,3,1,9,10,0,0,0,2,0.72,0.697,0.79,0,158,230,388,230
14527,9/2/2012,3,1,9,11,0,0,0,2,0.74,0.697,0.7,0,226,263,489,263
14528,9/2/2012,3,1,9,12,0,0,0,3,0.74,0.697,0.7,0,248,297,545,297
14529,9/2/2012,3,1,9,13,0,0,0,3,0.72,0.697,0.74,0.0896,263,230,493,230
14530,9/2/2012,3,1,9,14,0,0,0,3,0.72,0.697,0.79,0.0896,249,208,457,208
14531,9/2/2012,3,1,9,15,0,0,0,3,0.74,0.7121,0.74,0.1343,179,176,355,176
14532,9/2/2012,3,1,9,16,0,0,0,1,0.74,0.697,0.7,0,222,252,474,252
14533,9/2/2012,3,1,9,17,0,0,0,1,0.76,0.7273,0.66,0.0896,219,284,503,284
14534,9/2/2012,3,1,9,18,0,0,0,1,0.74,0.7121,0.74,0,227,273,500,273
14535,9/2/2012,3,1,9,19,0,0,0,2,0.7,0.6667,0.84,0.2239,140,152,292,152
14536,9/2/2012,3,1,9,20,0,0,0,2,0.7,0.6667,0.84,0.1642,63,41,104,41
14537,9/2/2012,3,1,9,21,0,0,0,1,0.7,0.6515,0.7,0.1642,79,92,171,92
14538,9/2/2012,3,1,9,22,0,0,0,3,0.68,0.6364,0.83,0.1343,66,100,166,100
14539,9/2/2012,3,1,9,23,0,0,0,3,0.66,0.5909,0.89,0.0896,53,70,123,70
14540,9/3/2012,3,1,9,0,1,1,0,2,0.66,0.5909,0.94,0,42,62,104,62
14541,9/3/2012,3,1,9,1,1,1,0,2,0.68,0.6364,0.89,0.1642,18,37,55,37
14542,9/3/2012,3,1,9,2,1,1,0,1,0.66,0.5909,0.89,0.1045,10,30,40,30
14543,9/3/2012,3,1,9,3,1,1,0,1,0.66,0.5909,0.89,0.1343,6,22,28,22
14544,9/3/2012,3,1,9,4,1,1,0,1,0.66,0.5909,0.89,0.0896,6,5,11,5
14545,9/3/2012,3,1,9,5,1,1,0,1,0.66,0.5909,0.89,0,1,3,4,3
14546,9/3/2012,3,1,9,6,1,1,0,1,0.66,0.5909,0.94,0,3,12,15,12
14547,9/3/2012,3,1,9,7,1,1,0,1,0.68,0.6364,0.85,0,6,37,43,37
14548,9/3/2012,3,1,9,8,1,1,0,2,0.7,0.6667,0.84,0.1045,36,91,127,91
14549,9/3/2012,3,1,9,9,1,1,0,2,0.7,0.6667,0.84,0.1343,71,158,229,158
14550,9/3/2012,3,1,9,10,1,1,0,2,0.74,0.7121,0.74,0.2239,135,224,359,224
14551,9/3/2012,3,1,9,11,1,1,0,2,0.74,0.697,0.7,0.2836,187,272,459,272
14552,9/3/2012,3,1,9,12,1,1,0,2,0.76,0.7121,0.62,0.2985,191,352,543,352
14553,9/3/2012,3,1,9,13,1,1,0,2,0.76,0.7273,0.66,0.2537,209,357,566,357
14554,9/3/2012,3,1,9,14,1,1,0,1,0.74,0.697,0.7,0.2985,163,349,512,349
14555,9/3/2012,3,1,9,15,1,1,0,1,0.74,0.697,0.7,0.2239,168,281,449,281
14556,9/3/2012,3,1,9,16,1,1,0,1,0.74,0.697,0.7,0.2239,165,335,500,335
14557,9/3/2012,3,1,9,17,1,1,0,1,0.74,0.697,0.7,0.1343,181,317,498,317
14558,9/3/2012,3,1,9,18,1,1,0,1,0.74,0.697,0.66,0.1642,145,337,482,337
14559,9/3/2012,3,1,9,19,1,1,0,1,0.72,0.697,0.74,0.194,73,301,374,301
14560,9/3/2012,3,1,9,20,1,1,0,1,0.72,0.6818,0.76,0.1045,78,183,261,183
14561,9/3/2012,3,1,9,21,1,1,0,1,0.72,0.6818,0.76,0.1045,42,142,184,142
14562,9/3/2012,3,1,9,22,1,1,0,2,0.7,0.6667,0.84,0.1343,17,104,121,104
14563,9/3/2012,3,1,9,23,1,1,0,2,0.7,0.6667,0.84,0.2537,12,58,70,58
14564,9/4/2012,3,1,9,0,0,2,1,2,0.7,0.6667,0.84,0.2537,10,19,29,19
14565,9/4/2012,3,1,9,1,0,2,1,1,0.68,0.6364,0.82,0.1343,15,9,24,9
14566,9/4/2012,3,1,9,2,0,2,1,1,0.68,0.6364,0.82,0.1343,1,4,5,4
14567,9/4/2012,3,1,9,3,0,2,1,2,0.66,0.5909,0.89,0.0896,1,9,10,9
14568,9/4/2012,3,1,9,4,0,2,1,2,0.66,0.5909,0.89,0,0,8,8,8
14569,9/4/2012,3,1,9,5,0,2,1,2,0.66,0.5909,0.89,0,1,37,38,37
14570,9/4/2012,3,1,9,6,0,2,1,2,0.68,0.6364,0.89,0.1045,7,165,172,165
14571,9/4/2012,3,1,9,7,0,2,1,2,0.68,0.6364,0.89,0.1045,13,480,493,480
14572,9/4/2012,3,1,9,8,0,2,1,1,0.7,0.6667,0.84,0.1642,15,617,632,617
14573,9/4/2012,3,1,9,9,0,2,1,2,0.72,0.697,0.79,0.2239,30,293,323,293
14574,9/4/2012,3,1,9,10,0,2,1,2,0.72,0.697,0.74,0.2537,42,130,172,130
14575,9/4/2012,3,1,9,11,0,2,1,2,0.74,0.697,0.7,0.2836,39,159,198,159
14576,9/4/2012,3,1,9,12,0,2,1,1,0.76,0.7273,0.7,0.2836,54,233,287,233
14577,9/4/2012,3,1,9,13,0,2,1,1,0.8,0.7576,0.55,0.4478,72,203,275,203
14578,9/4/2012,3,1,9,14,0,2,1,1,0.8,0.7576,0.55,0.4179,72,202,274,202
14579,9/4/2012,3,1,9,15,0,2,1,1,0.8,0.7727,0.59,0.4627,68,224,292,224
14580,9/4/2012,3,1,9,16,0,2,1,1,0.76,0.7273,0.7,0.4179,61,397,458,397
14581,9/4/2012,3,1,9,17,0,2,1,1,0.76,0.7273,0.7,0.3582,110,746,856,746
14582,9/4/2012,3,1,9,18,0,2,1,1,0.76,0.7424,0.75,0.2239,94,745,839,745
14583,9/4/2012,3,1,9,19,0,2,1,1,0.76,0.7273,0.7,0.2239,50,502,552,502
14584,9/4/2012,3,1,9,20,0,2,1,1,0.74,0.697,0.7,0.2537,47,338,385,338
14585,9/4/2012,3,1,9,21,0,2,1,1,0.74,0.7121,0.74,0.2537,28,240,268,240
14586,9/4/2012,3,1,9,22,0,2,1,1,0.74,0.697,0.7,0.2836,25,154,179,154
14587,9/4/2012,3,1,9,23,0,2,1,1,0.72,0.697,0.74,0.2985,12,83,95,83
14588,9/5/2012,3,1,9,0,0,3,1,1,0.72,0.697,0.74,0.2537,10,27,37,27
14589,9/5/2012,3,1,9,1,0,3,1,1,0.7,0.6667,0.84,0.194,2,11,13,11
14590,9/5/2012,3,1,9,2,0,3,1,1,0.7,0.6667,0.84,0.194,0,9,9,9
14591,9/5/2012,3,1,9,3,0,3,1,1,0.7,0.6667,0.79,0.2836,0,4,4,4
14592,9/5/2012,3,1,9,4,0,3,1,1,0.7,0.6667,0.79,0.2836,2,3,5,3
14593,9/5/2012,3,1,9,5,0,3,1,2,0.7,0.6667,0.79,0.2985,1,39,40,39
14594,9/5/2012,3,1,9,6,0,3,1,1,0.7,0.6667,0.79,0.2836,7,203,210,203
14595,9/5/2012,3,1,9,7,0,3,1,2,0.7,0.6667,0.79,0.2537,11,489,500,489
14596,9/5/2012,3,1,9,8,0,3,1,1,0.72,0.697,0.74,0.194,33,692,725,692
14597,9/5/2012,3,1,9,9,0,3,1,1,0.74,0.697,0.7,0.2537,27,263,290,263
14598,9/5/2012,3,1,9,10,0,3,1,2,0.76,0.7273,0.7,0.1642,54,181,235,181
14599,9/5/2012,3,1,9,11,0,3,1,2,0.78,0.7424,0.62,0.1642,61,156,217,156
14600,9/5/2012,3,1,9,12,0,3,1,1,0.78,0.7727,0.7,0.1045,49,217,266,217
14601,9/5/2012,3,1,9,13,0,3,1,1,0.8,0.7879,0.63,0.1642,50,184,234,184
14602,9/5/2012,3,1,9,14,0,3,1,1,0.82,0.7879,0.56,0.1045,34,177,211,177
14603,9/5/2012,3,1,9,15,0,3,1,1,0.78,0.7727,0.7,0.194,41,204,245,204
14604,9/5/2012,3,1,9,16,0,3,1,1,0.76,0.7273,0.7,0.2537,86,344,430,344
14605,9/5/2012,3,1,9,17,0,3,1,1,0.76,0.7273,0.66,0.2537,83,780,863,780
14606,9/5/2012,3,1,9,18,0,3,1,1,0.76,0.7424,0.75,0.194,82,757,839,757
14607,9/5/2012,3,1,9,19,0,3,1,1,0.74,0.697,0.7,0.1642,64,598,662,598
14608,9/5/2012,3,1,9,20,0,3,1,1,0.72,0.7121,0.84,0.1642,55,357,412,357
14609,9/5/2012,3,1,9,21,0,3,1,1,0.72,0.697,0.79,0,18,278,296,278
14610,9/5/2012,3,1,9,22,0,3,1,1,0.72,0.697,0.79,0,38,181,219,181
14611,9/5/2012,3,1,9,23,0,3,1,1,0.7,0.6667,0.84,0.0896,24,126,150,126
14612,9/6/2012,3,1,9,0,0,4,1,2,0.7,0.6667,0.84,0.0896,30,35,65,35
14613,9/6/2012,3,1,9,1,0,4,1,2,0.7,0.6667,0.84,0,2,16,18,16
14614,9/6/2012,3,1,9,2,0,4,1,1,0.72,0.697,0.79,0,1,7,8,7
14615,9/6/2012,3,1,9,3,0,4,1,1,0.7,0.6667,0.84,0.1045,0,9,9,9
14616,9/6/2012,3,1,9,4,0,4,1,2,0.7,0.6667,0.84,0.0896,0,8,8,8
14617,9/6/2012,3,1,9,5,0,4,1,2,0.7,0.6667,0.84,0.194,3,35,38,35
14618,9/6/2012,3,1,9,6,0,4,1,2,0.7,0.6667,0.84,0.0896,11,189,200,189
14619,9/6/2012,3,1,9,7,0,4,1,2,0.7,0.6667,0.84,0.1045,21,461,482,461
14620,9/6/2012,3,1,9,8,0,4,1,3,0.7,0.6667,0.79,0,24,622,646,622
14621,9/6/2012,3,1,9,9,0,4,1,3,0.66,0.5909,0.94,0.1343,8,115,123,115
14622,9/6/2012,3,1,9,10,0,4,1,3,0.66,0.5909,0.94,0.1343,9,40,49,40
14623,9/6/2012,3,1,9,11,0,4,1,3,0.7,0.6667,0.84,0.1642,10,52,62,52
14624,9/6/2012,3,1,9,12,0,4,1,2,0.72,0.697,0.79,0.2239,11,126,137,126
14625,9/6/2012,3,1,9,13,0,4,1,2,0.72,0.697,0.79,0.1045,39,152,191,152
14626,9/6/2012,3,1,9,14,0,4,1,1,0.74,0.7121,0.74,0.0896,38,178,216,178
14627,9/6/2012,3,1,9,15,0,4,1,1,0.74,0.697,0.66,0.194,42,228,270,228
14628,9/6/2012,3,1,9,16,0,4,1,1,0.74,0.697,0.7,0.2239,42,374,416,374
14629,9/6/2012,3,1,9,17,0,4,1,1,0.74,0.697,0.7,0.2537,67,741,808,741
14630,9/6/2012,3,1,9,18,0,4,1,1,0.72,0.6818,0.7,0.2537,74,761,835,761
14631,9/6/2012,3,1,9,19,0,4,1,1,0.68,0.6364,0.74,0.2537,54,504,558,504
14632,9/6/2012,3,1,9,20,0,4,1,1,0.66,0.6061,0.78,0.2239,50,356,406,356
14633,9/6/2012,3,1,9,21,0,4,1,1,0.64,0.5758,0.89,0.1642,32,240,272,240
14634,9/6/2012,3,1,9,22,0,4,1,1,0.64,0.5758,0.89,0.1642,24,193,217,193
14635,9/6/2012,3,1,9,23,0,4,1,1,0.64,0.5758,0.89,0.1642,19,150,169,150
14636,9/7/2012,3,1,9,0,0,5,1,1,0.64,0.5758,0.89,0.1343,17,79,96,79
14637,9/7/2012,3,1,9,1,0,5,1,1,0.62,0.5606,0.88,0.1045,10,19,29,19
14638,9/7/2012,3,1,9,2,0,5,1,1,0.62,0.5758,0.83,0.0896,1,10,11,10
14639,9/7/2012,3,1,9,3,0,5,1,1,0.62,0.5758,0.83,0.0896,0,9,9,9
14640,9/7/2012,3,1,9,4,0,5,1,1,0.62,0.5606,0.88,0,1,7,8,7
14641,9/7/2012,3,1,9,5,0,5,1,1,0.62,0.5606,0.88,0,1,39,40,39
14642,9/7/2012,3,1,9,6,0,5,1,1,0.62,0.5606,0.88,0.1045,5,135,140,135
14643,9/7/2012,3,1,9,7,0,5,1,1,0.64,0.5758,0.89,0.1045,21,465,486,465
14644,9/7/2012,3,1,9,8,0,5,1,1,0.66,0.6061,0.83,0.1045,29,690,719,690
14645,9/7/2012,3,1,9,9,0,5,1,1,0.7,0.6667,0.79,0.1343,33,311,344,311
14646,9/7/2012,3,1,9,10,0,5,1,1,0.72,0.697,0.74,0.1343,53,171,224,171
14647,9/7/2012,3,1,9,11,0,5,1,1,0.76,0.7121,0.62,0.1343,81,215,296,215
14648,9/7/2012,3,1,9,12,0,5,1,1,0.78,0.7424,0.59,0.1642,76,247,323,247
14649,9/7/2012,3,1,9,13,0,5,1,1,0.8,0.7727,0.59,0.2537,71,283,354,283
14650,9/7/2012,3,1,9,14,0,5,1,1,0.8,0.7727,0.59,0.2537,66,187,253,187
14651,9/7/2012,3,1,9,15,0,5,1,1,0.8,0.7576,0.55,0.2537,66,265,331,265
14652,9/7/2012,3,1,9,16,0,5,1,1,0.8,0.7576,0.55,0.2836,75,395,470,395
14653,9/7/2012,3,1,9,17,0,5,1,1,0.78,0.7424,0.59,0.3284,88,684,772,684
14654,9/7/2012,3,1,9,18,0,5,1,1,0.76,0.7121,0.62,0.2985,95,697,792,697
14655,9/7/2012,3,1,9,19,0,5,1,1,0.74,0.6818,0.62,0.2836,70,498,568,498
14656,9/7/2012,3,1,9,20,0,5,1,1,0.72,0.6818,0.66,0.2239,51,340,391,340
14657,9/7/2012,3,1,9,21,0,5,1,1,0.7,0.6667,0.74,0.1642,55,246,301,246
14658,9/7/2012,3,1,9,22,0,5,1,1,0.7,0.6667,0.74,0.2239,52,247,299,247
14659,9/7/2012,3,1,9,23,0,5,1,1,0.66,0.5909,0.89,0.2537,28,220,248,220
14660,9/8/2012,3,1,9,0,0,6,0,1,0.66,0.5909,0.89,0.2537,20,130,150,130
14661,9/8/2012,3,1,9,1,0,6,0,2,0.66,0.5909,0.89,0.2836,10,107,117,107
14662,9/8/2012,3,1,9,2,0,6,0,1,0.66,0.5909,0.89,0.3284,9,68,77,68
14663,9/8/2012,3,1,9,3,0,6,0,2,0.66,0.5909,0.89,0.2239,3,40,43,40
14664,9/8/2012,3,1,9,4,0,6,0,2,0.66,0.5909,0.94,0.2239,3,8,11,8
14665,9/8/2012,3,1,9,5,0,6,0,2,0.66,0.5909,0.94,0.2537,2,13,15,13
14666,9/8/2012,3,1,9,6,0,6,0,2,0.66,0.5909,0.89,0.2836,8,26,34,26
14667,9/8/2012,3,1,9,7,0,6,0,1,0.66,0.5909,0.89,0.2836,11,71,82,71
14668,9/8/2012,3,1,9,8,0,6,0,1,0.7,0.6667,0.79,0.3284,33,197,230,197
14669,9/8/2012,3,1,9,9,0,6,0,1,0.7,0.6667,0.74,0.3881,87,261,348,261
14670,9/8/2012,3,1,9,10,0,6,0,1,0.74,0.697,0.7,0.3881,100,322,422,322
14671,9/8/2012,3,1,9,11,0,6,0,1,0.76,0.7121,0.62,0.4478,173,405,578,405
14672,9/8/2012,3,1,9,12,0,6,0,1,0.8,0.7576,0.55,0.4925,220,474,694,474
14673,9/8/2012,3,1,9,13,0,6,0,1,0.82,0.7727,0.52,0.5224,233,435,668,435
14674,9/8/2012,3,1,9,14,0,6,0,1,0.82,0.7727,0.52,0.4478,260,366,626,366
14675,9/8/2012,3,1,9,15,0,6,0,3,0.56,0.5303,0.88,0.2537,175,337,512,337
14676,9/8/2012,3,1,9,16,0,6,0,3,0.56,0.5303,0.88,0.194,19,95,114,95
14677,9/8/2012,3,1,9,17,0,6,0,3,0.58,0.5455,0.83,0.194,52,119,171,119
14678,9/8/2012,3,1,9,18,0,6,0,3,0.58,0.5455,0.83,0.1343,27,140,167,140
14679,9/8/2012,3,1,9,19,0,6,0,3,0.58,0.5455,0.88,0.1045,28,187,215,187
14680,9/8/2012,3,1,9,20,0,6,0,2,0.58,0.5455,0.88,0.0896,28,166,194,166
14681,9/8/2012,3,1,9,21,0,6,0,2,0.6,0.5606,0.83,0.1642,26,155,181,155
14682,9/8/2012,3,1,9,22,0,6,0,2,0.58,0.5455,0.78,0.2985,18,176,194,176
14683,9/8/2012,3,1,9,23,0,6,0,2,0.58,0.5455,0.73,0.1642,12,121,133,121
14684,9/9/2012,3,1,9,0,0,0,0,2,0.56,0.5303,0.73,0.194,18,106,124,106
14685,9/9/2012,3,1,9,1,0,0,0,1,0.56,0.5303,0.73,0.2239,20,104,124,104
14686,9/9/2012,3,1,9,2,0,0,0,1,0.54,0.5152,0.77,0.2836,15,81,96,81
14687,9/9/2012,3,1,9,3,0,0,0,1,0.54,0.5152,0.73,0.2239,14,32,46,32
14688,9/9/2012,3,1,9,4,0,0,0,1,0.52,0.5,0.77,0.2537,12,16,28,16
14689,9/9/2012,3,1,9,5,0,0,0,1,0.52,0.5,0.77,0.194,16,39,55,39
14690,9/9/2012,3,1,9,6,0,0,0,1,0.52,0.5,0.77,0.194,11,24,35,24
14691,9/9/2012,3,1,9,7,0,0,0,1,0.54,0.5152,0.73,0.1642,20,50,70,50
14692,9/9/2012,3,1,9,8,0,0,0,1,0.58,0.5455,0.68,0.2239,27,143,170,143
14693,9/9/2012,3,1,9,9,0,0,0,1,0.62,0.6061,0.61,0.2537,85,214,299,214
14694,9/9/2012,3,1,9,10,0,0,0,1,0.64,0.6212,0.57,0.2985,172,323,495,323
14695,9/9/2012,3,1,9,11,0,0,0,1,0.66,0.6212,0.47,0.2537,194,391,585,391
14696,9/9/2012,3,1,9,12,0,0,0,1,0.66,0.6212,0.47,0,247,510,757,510
14697,9/9/2012,3,1,9,13,0,0,0,1,0.68,0.6364,0.39,0,238,491,729,491
14698,9/9/2012,3,1,9,14,0,0,0,1,0.72,0.6515,0.3,0.2836,232,415,647,415
14699,9/9/2012,3,1,9,15,0,0,0,1,0.72,0.6515,0.32,0.2537,284,412,696,412
14700,9/9/2012,3,1,9,16,0,0,0,1,0.68,0.6364,0.36,0.2836,228,473,701,473
14701,9/9/2012,3,1,9,17,0,0,0,1,0.7,0.6364,0.37,0.2537,213,458,671,458
14702,9/9/2012,3,1,9,18,0,0,0,1,0.66,0.6212,0.36,0.2537,156,404,560,404
14703,9/9/2012,3,1,9,19,0,0,0,1,0.66,0.6212,0.36,0.2537,134,362,496,362
14704,9/9/2012,3,1,9,20,0,0,0,1,0.62,0.6212,0.41,0.2836,91,265,356,265
14705,9/9/2012,3,1,9,21,0,0,0,1,0.6,0.6212,0.46,0.2239,57,149,206,149
14706,9/9/2012,3,1,9,22,0,0,0,1,0.58,0.5455,0.49,0.2537,64,125,189,125
14707,9/9/2012,3,1,9,23,0,0,0,1,0.56,0.5303,0.52,0.2836,22,70,92,70
14708,9/10/2012,3,1,9,0,0,1,1,1,0.56,0.5303,0.52,0.2836,6,35,41,35
14709,9/10/2012,3,1,9,1,0,1,1,1,0.54,0.5152,0.6,0.194,7,11,18,11
14710,9/10/2012,3,1,9,2,0,1,1,1,0.54,0.5152,0.6,0.3582,11,6,17,6
14711,9/10/2012,3,1,9,3,0,1,1,1,0.52,0.5,0.68,0.2836,5,7,12,7
14712,9/10/2012,3,1,9,4,0,1,1,1,0.52,0.5,0.68,0.2836,1,4,5,4
14713,9/10/2012,3,1,9,5,0,1,1,1,0.5,0.4848,0.72,0.2537,4,36,40,36
14714,9/10/2012,3,1,9,6,0,1,1,1,0.5,0.4848,0.72,0.1343,8,172,180,172
14715,9/10/2012,3,1,9,7,0,1,1,1,0.52,0.5,0.68,0.2239,20,427,447,427
14716,9/10/2012,3,1,9,8,0,1,1,1,0.56,0.5303,0.6,0.2836,33,697,730,697
14717,9/10/2012,3,1,9,9,0,1,1,1,0.6,0.6212,0.53,0.2985,40,321,361,321
14718,9/10/2012,3,1,9,10,0,1,1,1,0.62,0.6212,0.5,0.2836,42,168,210,168
14719,9/10/2012,3,1,9,11,0,1,1,1,0.62,0.6212,0.43,0.2985,69,167,236,167
14720,9/10/2012,3,1,9,12,0,1,1,1,0.64,0.6212,0.44,0.3881,76,256,332,256
14721,9/10/2012,3,1,9,13,0,1,1,1,0.64,0.6212,0.38,0.2239,72,251,323,251
14722,9/10/2012,3,1,9,14,0,1,1,1,0.66,0.6212,0.36,0.2836,107,233,340,233
14723,9/10/2012,3,1,9,15,0,1,1,1,0.66,0.6212,0.31,0.3881,115,231,346,231
14724,9/10/2012,3,1,9,16,0,1,1,1,0.66,0.6212,0.34,0.3284,108,380,488,380
14725,9/10/2012,3,1,9,17,0,1,1,1,0.66,0.6212,0.34,0.3284,127,744,871,744
14726,9/10/2012,3,1,9,18,0,1,1,1,0.62,0.6212,0.35,0.2985,111,857,968,857
14727,9/10/2012,3,1,9,19,0,1,1,1,0.62,0.6212,0.38,0.2985,71,562,633,562
14728,9/10/2012,3,1,9,20,0,1,1,1,0.6,0.6212,0.4,0.194,34,356,390,356
14729,9/10/2012,3,1,9,21,0,1,1,1,0.56,0.5303,0.49,0.1642,29,256,285,256
14730,9/10/2012,3,1,9,22,0,1,1,1,0.54,0.5152,0.52,0.1343,15,144,159,144
14731,9/10/2012,3,1,9,23,0,1,1,1,0.54,0.5152,0.52,0,7,86,93,86
14732,9/11/2012,3,1,9,0,0,2,1,1,0.52,0.5,0.59,0.1045,5,27,32,27
14733,9/11/2012,3,1,9,1,0,2,1,1,0.5,0.4848,0.63,0,0,10,10,10
14734,9/11/2012,3,1,9,2,0,2,1,1,0.48,0.4697,0.77,0.1642,1,5,6,5
14735,9/11/2012,3,1,9,3,0,2,1,1,0.48,0.4697,0.67,0.1343,1,7,8,7
14736,9/11/2012,3,1,9,4,0,2,1,1,0.48,0.4697,0.72,0.1045,1,8,9,8
14737,9/11/2012,3,1,9,5,0,2,1,1,0.46,0.4545,0.72,0.0896,3,41,44,41
14738,9/11/2012,3,1,9,6,0,2,1,1,0.46,0.4545,0.77,0.1045,11,200,211,200
14739,9/11/2012,3,1,9,7,0,2,1,1,0.5,0.4848,0.72,0.1045,24,572,596,572
14740,9/11/2012,3,1,9,8,0,2,1,1,0.54,0.5152,0.68,0.0896,48,702,750,702
14741,9/11/2012,3,1,9,9,0,2,1,1,0.6,0.6212,0.49,0,35,323,358,323
14742,9/11/2012,3,1,9,10,0,2,1,1,0.62,0.6212,0.38,0,54,142,196,142
14743,9/11/2012,3,1,9,11,0,2,1,1,0.64,0.6212,0.33,0.0896,60,187,247,187
14744,9/11/2012,3,1,9,12,0,2,1,1,0.64,0.6212,0.33,0,62,254,316,254
14745,9/11/2012,3,1,9,13,0,2,1,1,0.66,0.6212,0.29,0.0896,72,256,328,256
14746,9/11/2012,3,1,9,14,0,2,1,1,0.68,0.6212,0.3,0.0896,74,181,255,181
14747,9/11/2012,3,1,9,15,0,2,1,1,0.7,0.6364,0.28,0.1045,73,253,326,253
14748,9/11/2012,3,1,9,16,0,2,1,1,0.7,0.6364,0.28,0.1343,99,437,536,437
14749,9/11/2012,3,1,9,17,0,2,1,1,0.7,0.6364,0.28,0,168,802,970,802
14750,9/11/2012,3,1,9,18,0,2,1,1,0.64,0.6212,0.36,0.1642,110,767,877,767
14751,9/11/2012,3,1,9,19,0,2,1,1,0.62,0.6212,0.41,0.194,56,540,596,540
14752,9/11/2012,3,1,9,20,0,2,1,1,0.58,0.5455,0.56,0.1343,40,421,461,421
14753,9/11/2012,3,1,9,21,0,2,1,1,0.56,0.5303,0.6,0.1045,28,282,310,282
14754,9/11/2012,3,1,9,22,0,2,1,1,0.56,0.5303,0.64,0.1045,27,189,216,189
14755,9/11/2012,3,1,9,23,0,2,1,1,0.54,0.5152,0.68,0.1045,18,91,109,91
14756,9/12/2012,3,1,9,0,0,3,1,1,0.52,0.5,0.72,0.1045,8,41,49,41
14757,9/12/2012,3,1,9,1,0,3,1,1,0.52,0.5,0.72,0.1045,2,19,21,19
14758,9/12/2012,3,1,9,2,0,3,1,1,0.52,0.5,0.72,0.0896,2,9,11,9
14759,9/12/2012,3,1,9,3,0,3,1,1,0.5,0.4848,0.77,0.0896,0,7,7,7
14760,9/12/2012,3,1,9,4,0,3,1,1,0.5,0.4848,0.72,0.0896,0,5,5,5
14761,9/12/2012,3,1,9,5,0,3,1,1,0.5,0.4848,0.72,0.0896,4,44,48,44
14762,9/12/2012,3,1,9,6,0,3,1,1,0.5,0.4848,0.72,0.0896,6,199,205,199
14763,9/12/2012,3,1,9,7,0,3,1,1,0.52,0.5,0.72,0,24,533,557,533
14764,9/12/2012,3,1,9,8,0,3,1,1,0.56,0.5303,0.64,0.1045,43,727,770,727
14765,9/12/2012,3,1,9,9,0,3,1,1,0.6,0.6061,0.64,0.1343,50,278,328,278
14766,9/12/2012,3,1,9,10,0,3,1,1,0.62,0.6061,0.61,0.1343,57,148,205,148
14767,9/12/2012,3,1,9,11,0,3,1,1,0.66,0.6212,0.5,0.194,51,181,232,181
14768,9/12/2012,3,1,9,12,0,3,1,1,0.68,0.6364,0.36,0.1343,88,264,352,264
14769,9/12/2012,3,1,9,13,0,3,1,1,0.7,0.6364,0.34,0.1343,85,238,323,238
14770,9/12/2012,3,1,9,14,0,3,1,1,0.7,0.6364,0.37,0.1642,78,200,278,200
14771,9/12/2012,3,1,9,15,0,3,1,1,0.72,0.6515,0.37,0.1343,75,243,318,243
14772,9/12/2012,3,1,9,16,0,3,1,1,0.72,0.6515,0.37,0.1642,90,419,509,419
14773,9/12/2012,3,1,9,17,0,3,1,1,0.7,0.6364,0.41,0.2985,114,811,925,811
14774,9/12/2012,3,1,9,18,0,3,1,1,0.66,0.6212,0.44,0.2537,91,886,977,886
14775,9/12/2012,3,1,9,19,0,3,1,1,0.64,0.6212,0.5,0.194,78,557,635,557
14776,9/12/2012,3,1,9,20,0,3,1,1,0.62,0.6212,0.57,0.1343,38,432,470,432
14777,9/12/2012,3,1,9,21,0,3,1,1,0.6,0.6061,0.6,0.1343,27,279,306,279
14778,9/12/2012,3,1,9,22,0,3,1,1,0.56,0.5303,0.64,0.0896,23,189,212,189
14779,9/12/2012,3,1,9,23,0,3,1,1,0.56,0.5303,0.68,0.1045,16,111,127,111
14780,9/13/2012,3,1,9,0,0,4,1,1,0.56,0.5303,0.73,0.0896,11,46,57,46
14781,9/13/2012,3,1,9,1,0,4,1,1,0.54,0.5152,0.77,0.0896,6,22,28,22
14782,9/13/2012,3,1,9,2,0,4,1,1,0.54,0.5152,0.77,0,0,9,9,9
14783,9/13/2012,3,1,9,3,0,4,1,1,0.52,0.5,0.83,0,2,9,11,9
14784,9/13/2012,3,1,9,4,0,4,1,1,0.52,0.5,0.83,0,0,6,6,6
14785,9/13/2012,3,1,9,5,0,4,1,1,0.52,0.5,0.83,0,3,54,57,54
14786,9/13/2012,3,1,9,6,0,4,1,1,0.5,0.4848,0.82,0,9,186,195,186
14787,9/13/2012,3,1,9,7,0,4,1,1,0.54,0.5152,0.77,0,22,549,571,549
14788,9/13/2012,3,1,9,8,0,4,1,1,0.56,0.5303,0.73,0,33,725,758,725
14789,9/13/2012,3,1,9,9,0,4,1,1,0.6,0.6061,0.64,0.0896,46,292,338,292
14790,9/13/2012,3,1,9,10,0,4,1,1,0.64,0.6212,0.61,0.0896,63,149,212,149
14791,9/13/2012,3,1,9,11,0,4,1,1,0.66,0.6212,0.5,0.1642,71,183,254,183
14792,9/13/2012,3,1,9,12,0,4,1,1,0.68,0.6364,0.44,0.1045,57,240,297,240
14793,9/13/2012,3,1,9,13,0,4,1,1,0.7,0.6364,0.42,0,60,223,283,223
14794,9/13/2012,3,1,9,14,0,4,1,1,0.72,0.6515,0.39,0.1343,60,214,274,214
14795,9/13/2012,3,1,9,15,0,4,1,1,0.72,0.6515,0.42,0.1045,99,253,352,253
14796,9/13/2012,3,1,9,16,0,4,1,1,0.72,0.6515,0.39,0.0896,85,406,491,406
14797,9/13/2012,3,1,9,17,0,4,1,1,0.72,0.6515,0.42,0.194,97,787,884,787
14798,9/13/2012,3,1,9,18,0,4,1,1,0.68,0.6364,0.57,0.2537,108,744,852,744
14799,9/13/2012,3,1,9,19,0,4,1,1,0.64,0.6061,0.65,0.1343,80,594,674,594
14800,9/13/2012,3,1,9,20,0,4,1,1,0.62,0.6061,0.69,0.1045,55,408,463,408
14801,9/13/2012,3,1,9,21,0,4,1,1,0.62,0.6061,0.65,0.1045,26,291,317,291
14802,9/13/2012,3,1,9,22,0,4,1,1,0.6,0.5909,0.69,0.1343,28,223,251,223
14803,9/13/2012,3,1,9,23,0,4,1,1,0.58,0.5455,0.73,0.1045,33,137,170,137
14804,9/14/2012,3,1,9,0,0,5,1,1,0.56,0.5303,0.73,0.0896,24,63,87,63
14805,9/14/2012,3,1,9,1,0,5,1,1,0.56,0.5303,0.73,0.0896,6,35,41,35
14806,9/14/2012,3,1,9,2,0,5,1,1,0.56,0.5303,0.73,0,7,23,30,23
14807,9/14/2012,3,1,9,3,0,5,1,1,0.54,0.5152,0.77,0,5,9,14,9
14808,9/14/2012,3,1,9,4,0,5,1,1,0.54,0.5152,0.77,0,1,11,12,11
14809,9/14/2012,3,1,9,5,0,5,1,1,0.54,0.5152,0.83,0,1,40,41,40
14810,9/14/2012,3,1,9,6,0,5,1,1,0.54,0.5152,0.88,0,8,144,152,144
14811,9/14/2012,3,1,9,7,0,5,1,2,0.56,0.5303,0.88,0,17,437,454,437
14812,9/14/2012,3,1,9,8,0,5,1,2,0.6,0.5758,0.78,0.1642,51,715,766,715
14813,9/14/2012,3,1,9,9,0,5,1,2,0.62,0.5909,0.78,0.1642,46,301,347,301
14814,9/14/2012,3,1,9,10,0,5,1,2,0.68,0.6364,0.65,0,75,171,246,171
14815,9/14/2012,3,1,9,11,0,5,1,2,0.68,0.6364,0.61,0.1045,84,196,280,196
14816,9/14/2012,3,1,9,12,0,5,1,2,0.7,0.6515,0.54,0.194,119,290,409,290
14817,9/14/2012,3,1,9,13,0,5,1,2,0.7,0.6515,0.54,0.194,107,301,408,301
14818,9/14/2012,3,1,9,14,0,5,1,2,0.72,0.6515,0.45,0.1642,113,258,371,258
14819,9/14/2012,3,1,9,15,0,5,1,2,0.72,0.6667,0.48,0.1343,94,273,367,273
14820,9/14/2012,3,1,9,16,0,5,1,2,0.72,0.6667,0.51,0,109,454,563,454
14821,9/14/2012,3,1,9,17,0,5,1,1,0.72,0.6667,0.51,0.194,137,757,894,757
14822,9/14/2012,3,1,9,18,0,5,1,1,0.72,0.6515,0.45,0.2239,116,692,808,692
14823,9/14/2012,3,1,9,19,0,5,1,1,0.68,0.6364,0.57,0.1642,83,496,579,496
14824,9/14/2012,3,1,9,20,0,5,1,1,0.66,0.6212,0.61,0.1045,67,337,404,337
14825,9/14/2012,3,1,9,21,0,5,1,1,0.64,0.6061,0.73,0.2239,42,270,312,270
14826,9/14/2012,3,1,9,22,0,5,1,1,0.62,0.5758,0.83,0.194,40,189,229,189
14827,9/14/2012,3,1,9,23,0,5,1,1,0.62,0.5909,0.78,0.0896,27,168,195,168
14828,9/15/2012,3,1,9,0,0,6,0,1,0.6,0.5606,0.83,0.1045,38,169,207,169
14829,9/15/2012,3,1,9,1,0,6,0,1,0.6,0.5909,0.73,0,8,101,109,101
14830,9/15/2012,3,1,9,2,0,6,0,1,0.58,0.5455,0.78,0.1045,18,75,93,75
14831,9/15/2012,3,1,9,3,0,6,0,1,0.6,0.5909,0.73,0.2537,6,31,37,31
14832,9/15/2012,3,1,9,4,0,6,0,2,0.6,0.5909,0.69,0.3582,3,3,6,3
14833,9/15/2012,3,1,9,5,0,6,0,1,0.58,0.5455,0.6,0.5224,1,15,16,15
14834,9/15/2012,3,1,9,6,0,6,0,1,0.54,0.5152,0.49,0.4179,6,27,33,27
14835,9/15/2012,3,1,9,7,0,6,0,1,0.54,0.5152,0.52,0.2836,10,63,73,63
14836,9/15/2012,3,1,9,8,0,6,0,1,0.56,0.5303,0.49,0.4179,43,169,212,169
14837,9/15/2012,3,1,9,9,0,6,0,1,0.6,0.6212,0.43,0.4179,79,263,342,263
14838,9/15/2012,3,1,9,10,0,6,0,1,0.62,0.6212,0.41,0.3881,119,323,442,323
14839,9/15/2012,3,1,9,11,0,6,0,1,0.64,0.6212,0.38,0.3881,228,399,627,399
14840,9/15/2012,3,1,9,12,0,6,0,1,0.66,0.6212,0.36,0.3582,287,419,706,419
14841,9/15/2012,3,1,9,13,0,6,0,1,0.68,0.6364,0.36,0.194,327,377,704,377
14842,9/15/2012,3,1,9,14,0,6,0,1,0.68,0.6364,0.34,0.3284,325,390,715,390
14843,9/15/2012,3,1,9,15,0,6,0,2,0.68,0.6364,0.34,0.2836,312,342,654,342
14844,9/15/2012,3,1,9,16,0,6,0,2,0.66,0.6212,0.36,0.2239,350,433,783,433
14845,9/15/2012,3,1,9,17,0,6,0,2,0.66,0.6212,0.36,0.2537,295,434,729,434
14846,9/15/2012,3,1,9,18,0,6,0,2,0.64,0.6212,0.36,0.2836,232,382,614,382
14847,9/15/2012,3,1,9,19,0,6,0,1,0.62,0.6212,0.41,0.1642,169,309,478,309
14848,9/15/2012,3,1,9,20,0,6,0,1,0.6,0.6212,0.43,0.0896,89,241,330,241
14849,9/15/2012,3,1,9,21,0,6,0,1,0.56,0.5303,0.52,0.1045,86,210,296,210
14850,9/15/2012,3,1,9,22,0,6,0,1,0.56,0.5303,0.52,0,82,197,279,197
14851,9/15/2012,3,1,9,23,0,6,0,1,0.54,0.5152,0.6,0,47,182,229,182
14852,9/16/2012,3,1,9,0,0,0,0,1,0.54,0.5152,0.64,0,28,123,151,123
14853,9/16/2012,3,1,9,1,0,0,0,1,0.54,0.5152,0.64,0,35,82,117,82
14854,9/16/2012,3,1,9,2,0,0,0,1,0.52,0.5,0.63,0,27,62,89,62
14855,9/16/2012,3,1,9,3,0,0,0,1,0.5,0.4848,0.68,0,10,38,48,38
14856,9/16/2012,3,1,9,4,0,0,0,1,0.5,0.4848,0.72,0,2,6,8,6
14857,9/16/2012,3,1,9,5,0,0,0,1,0.5,0.4848,0.72,0,3,10,13,10
14858,9/16/2012,3,1,9,6,0,0,0,1,0.5,0.4848,0.72,0,9,26,35,26
14859,9/16/2012,3,1,9,7,0,0,0,1,0.5,0.4848,0.77,0.1045,28,43,71,43
14860,9/16/2012,3,1,9,8,0,0,0,1,0.54,0.5152,0.64,0.1642,34,94,128,94
14861,9/16/2012,3,1,9,9,0,0,0,1,0.58,0.5455,0.6,0.1343,70,226,296,226
14862,9/16/2012,3,1,9,10,0,0,0,1,0.62,0.6212,0.5,0.1045,160,330,490,330
14863,9/16/2012,3,1,9,11,0,0,0,1,0.64,0.6212,0.47,0.1642,183,376,559,376
14864,9/16/2012,3,1,9,12,0,0,0,1,0.66,0.6212,0.44,0.1642,188,468,656,468
14865,9/16/2012,3,1,9,13,0,0,0,1,0.64,0.6212,0.41,0.1642,240,454,694,454
14866,9/16/2012,3,1,9,14,0,0,0,1,0.66,0.6212,0.39,0.1343,225,410,635,410
14867,9/16/2012,3,1,9,15,0,0,0,1,0.64,0.6212,0.41,0.1642,215,342,557,342
14868,9/16/2012,3,1,9,16,0,0,0,1,0.64,0.6212,0.44,0.1642,194,402,596,402
14869,9/16/2012,3,1,9,17,0,0,0,1,0.66,0.6212,0.41,0,177,393,570,393
14870,9/16/2012,3,1,9,18,0,0,0,1,0.62,0.6212,0.5,0.1642,120,361,481,361
14871,9/16/2012,3,1,9,19,0,0,0,1,0.62,0.6212,0.5,0.1343,91,312,403,312
14872,9/16/2012,3,1,9,20,0,0,0,1,0.6,0.6212,0.53,0.1045,57,267,324,267
14873,9/16/2012,3,1,9,21,0,0,0,1,0.6,0.6212,0.56,0.1045,43,148,191,148
14874,9/16/2012,3,1,9,22,0,0,0,1,0.56,0.5303,0.68,0.0896,18,109,127,109
14875,9/16/2012,3,1,9,23,0,0,0,1,0.54,0.5152,0.68,0.1045,9,85,94,85
14876,9/17/2012,3,1,9,0,0,1,1,1,0.54,0.5152,0.68,0.1642,14,31,45,31
14877,9/17/2012,3,1,9,1,0,1,1,1,0.52,0.5,0.72,0.0896,9,12,21,12
14878,9/17/2012,3,1,9,2,0,1,1,1,0.52,0.5,0.72,0,5,8,13,8
14879,9/17/2012,3,1,9,3,0,1,1,1,0.5,0.4848,0.77,0.0896,0,7,7,7
14880,9/17/2012,3,1,9,4,0,1,1,1,0.5,0.4848,0.77,0,2,9,11,9
14881,9/17/2012,3,1,9,5,0,1,1,1,0.48,0.4697,0.82,0.0896,1,44,45,44
14882,9/17/2012,3,1,9,6,0,1,1,1,0.48,0.4697,0.82,0,7,157,164,157
14883,9/17/2012,3,1,9,7,0,1,1,1,0.52,0.5,0.77,0,18,474,492,474
14884,9/17/2012,3,1,9,8,0,1,1,1,0.54,0.5152,0.77,0.0896,36,647,683,647
14885,9/17/2012,3,1,9,9,0,1,1,1,0.58,0.5455,0.68,0.1343,34,265,299,265
14886,9/17/2012,3,1,9,10,0,1,1,2,0.62,0.6061,0.65,0.194,73,129,202,129
14887,9/17/2012,3,1,9,11,0,1,1,2,0.62,0.6061,0.69,0.2239,61,191,252,191
14888,9/17/2012,3,1,9,12,0,1,1,2,0.62,0.6061,0.69,0.194,62,233,295,233
14889,9/17/2012,3,1,9,13,0,1,1,1,0.64,0.6061,0.65,0.2537,112,231,343,231
14890,9/17/2012,3,1,9,14,0,1,1,2,0.64,0.6061,0.65,0.2537,129,203,332,203
14891,9/17/2012,3,1,9,15,0,1,1,2,0.64,0.6061,0.65,0.2537,82,256,338,256
14892,9/17/2012,3,1,9,16,0,1,1,2,0.64,0.6061,0.69,0.2537,74,379,453,379
14893,9/17/2012,3,1,9,17,0,1,1,2,0.64,0.6061,0.65,0.2239,102,740,842,740
14894,9/17/2012,3,1,9,18,0,1,1,2,0.62,0.5909,0.73,0.1642,66,708,774,708
14895,9/17/2012,3,1,9,19,0,1,1,2,0.62,0.5909,0.73,0.1045,51,435,486,435
14896,9/17/2012,3,1,9,20,0,1,1,2,0.62,0.5909,0.73,0.1343,32,308,340,308
14897,9/17/2012,3,1,9,21,0,1,1,3,0.62,0.5758,0.83,0.2239,28,205,233,205
14898,9/17/2012,3,1,9,22,0,1,1,3,0.62,0.5758,0.83,0.2537,20,109,129,109
14899,9/17/2012,3,1,9,23,0,1,1,3,0.6,0.5152,0.94,0.2537,4,66,70,66
14900,9/18/2012,3,1,9,0,0,2,1,3,0.6,0.5152,0.94,0.2537,2,11,13,11
14901,9/18/2012,3,1,9,1,0,2,1,3,0.6,0.5152,0.94,0.194,0,5,5,5
14902,9/18/2012,3,1,9,2,0,2,1,3,0.6,0.5152,0.94,0.194,0,4,4,4
14903,9/18/2012,3,1,9,3,0,2,1,2,0.62,0.5455,0.94,0.2836,0,6,6,6
14904,9/18/2012,3,1,9,4,0,2,1,2,0.62,0.5455,0.94,0.3582,2,5,7,5
14905,9/18/2012,3,1,9,5,0,2,1,2,0.64,0.5758,0.89,0.3284,3,45,48,45
14906,9/18/2012,3,1,9,6,0,2,1,2,0.64,0.5758,0.89,0.3284,4,163,167,163
14907,9/18/2012,3,1,9,7,0,2,1,2,0.64,0.5758,0.89,0.4478,13,343,356,343
14908,9/18/2012,3,1,9,8,0,2,1,2,0.66,0.6061,0.83,0.5522,32,640,672,640
14909,9/18/2012,3,1,9,9,0,2,1,2,0.66,0.6061,0.83,0.5821,27,266,293,266
14910,9/18/2012,3,1,9,10,0,2,1,3,0.68,0.6364,0.79,0.6418,30,130,160,130
14911,9/18/2012,3,1,9,11,0,2,1,2,0.68,0.6364,0.79,0.6418,36,115,151,115
14912,9/18/2012,3,1,9,12,0,2,1,3,0.68,0.6364,0.83,0.4478,16,72,88,72
14913,9/18/2012,3,1,9,13,0,2,1,2,0.7,0.6667,0.74,0.5821,17,97,114,97
14914,9/18/2012,3,1,9,14,0,2,1,3,0.6,0.5152,0.94,0.4627,27,116,143,116
14915,9/18/2012,3,1,9,15,0,2,1,3,0.6,0.5455,0.88,0.2537,1,35,36,35
14916,9/18/2012,3,1,9,16,0,2,1,3,0.6,0.5455,0.88,0.2985,19,122,141,122
14917,9/18/2012,3,1,9,17,0,2,1,3,0.6,0.5455,0.88,0.194,36,302,338,302
14918,9/18/2012,3,1,9,18,0,2,1,2,0.6,0.5455,0.88,0.1642,19,262,281,262
14919,9/18/2012,3,1,9,19,0,2,1,2,0.6,0.5455,0.88,0.2985,22,302,324,302
14920,9/18/2012,3,1,9,20,0,2,1,2,0.6,0.5455,0.88,0.194,19,271,290,271
14921,9/18/2012,3,1,9,21,0,2,1,2,0.6,0.5455,0.88,0.194,21,186,207,186
14922,9/18/2012,3,1,9,22,0,2,1,3,0.58,0.5455,0.83,0.4627,14,137,151,137
14923,9/18/2012,3,1,9,23,0,2,1,2,0.56,0.5303,0.83,0.2239,11,67,78,67
14924,9/19/2012,3,1,9,0,0,3,1,2,0.56,0.5303,0.68,0.2836,3,23,26,23
14925,9/19/2012,3,1,9,1,0,3,1,2,0.54,0.5152,0.68,0.2537,0,12,12,12
14926,9/19/2012,3,1,9,2,0,3,1,2,0.54,0.5152,0.64,0.3284,0,3,3,3
14927,9/19/2012,3,1,9,3,0,3,1,2,0.52,0.5,0.63,0.2537,1,4,5,4
14928,9/19/2012,3,1,9,4,0,3,1,2,0.52,0.5,0.68,0.3582,0,10,10,10
14929,9/19/2012,3,1,9,5,0,3,1,2,0.52,0.5,0.68,0.2836,2,54,56,54
14930,9/19/2012,3,1,9,6,0,3,1,1,0.52,0.5,0.63,0.2537,6,166,172,166
14931,9/19/2012,3,1,9,7,0,3,1,1,0.52,0.5,0.63,0.2239,16,529,545,529
14932,9/19/2012,3,1,9,8,0,3,1,1,0.52,0.5,0.59,0.2239,39,758,797,758
14933,9/19/2012,3,1,9,9,0,3,1,1,0.54,0.5152,0.6,0.2537,26,336,362,336
14934,9/19/2012,3,1,9,10,0,3,1,1,0.56,0.5303,0.52,0.194,23,169,192,169
14935,9/19/2012,3,1,9,11,0,3,1,1,0.6,0.6212,0.43,0.2537,44,203,247,203
14936,9/19/2012,3,1,9,12,0,3,1,1,0.6,0.6212,0.43,0.2537,53,260,313,260
14937,9/19/2012,3,1,9,13,0,3,1,1,0.6,0.6212,0.4,0.2537,55,234,289,234
14938,9/19/2012,3,1,9,14,0,3,1,1,0.62,0.6212,0.38,0.2537,59,227,286,227
14939,9/19/2012,3,1,9,15,0,3,1,1,0.62,0.6212,0.35,0,57,254,311,254
14940,9/19/2012,3,1,9,16,0,3,1,1,0.62,0.6212,0.35,0,69,397,466,397
14941,9/19/2012,3,1,9,17,0,3,1,1,0.6,0.6212,0.38,0.2239,74,812,886,812
14942,9/19/2012,3,1,9,18,0,3,1,1,0.58,0.5455,0.4,0.2836,85,807,892,807
14943,9/19/2012,3,1,9,19,0,3,1,1,0.56,0.5303,0.43,0.2239,72,539,611,539
14944,9/19/2012,3,1,9,20,0,3,1,1,0.52,0.5,0.48,0.1642,31,378,409,378
14945,9/19/2012,3,1,9,21,0,3,1,1,0.5,0.4848,0.59,0.1642,25,324,349,324
14946,9/19/2012,3,1,9,22,0,3,1,1,0.5,0.4848,0.63,0.0896,31,198,229,198
14947,9/19/2012,3,1,9,23,0,3,1,1,0.48,0.4697,0.67,0.0896,17,106,123,106
14948,9/20/2012,3,1,9,0,0,4,1,1,0.5,0.4848,0.63,0,12,46,58,46
14949,9/20/2012,3,1,9,1,0,4,1,1,0.46,0.4545,0.72,0.1045,4,14,18,14
14950,9/20/2012,3,1,9,2,0,4,1,1,0.46,0.4545,0.72,0.0896,2,9,11,9
14951,9/20/2012,3,1,9,3,0,4,1,1,0.44,0.4394,0.77,0,0,6,6,6
14952,9/20/2012,3,1,9,4,0,4,1,1,0.44,0.4394,0.77,0.1045,0,6,6,6
14953,9/20/2012,3,1,9,5,0,4,1,1,0.44,0.4394,0.77,0.1045,4,52,56,52
14954,9/20/2012,3,1,9,6,0,4,1,1,0.44,0.4394,0.77,0,9,161,170,161
14955,9/20/2012,3,1,9,7,0,4,1,1,0.46,0.4545,0.82,0.1045,20,514,534,514
14956,9/20/2012,3,1,9,8,0,4,1,1,0.5,0.4848,0.68,0.0896,44,746,790,746
14957,9/20/2012,3,1,9,9,0,4,1,1,0.56,0.5303,0.6,0.0896,25,330,355,330
14958,9/20/2012,3,1,9,10,0,4,1,1,0.58,0.5455,0.53,0.0896,33,157,190,157
14959,9/20/2012,3,1,9,11,0,4,1,1,0.62,0.6212,0.43,0,37,206,243,206
14960,9/20/2012,3,1,9,12,0,4,1,1,0.62,0.6212,0.43,0.1343,57,233,290,233
14961,9/20/2012,3,1,9,13,0,4,1,1,0.64,0.6212,0.44,0.1343,68,268,336,268
14962,9/20/2012,3,1,9,14,0,4,1,1,0.64,0.6212,0.47,0.194,76,222,298,222
14963,9/20/2012,3,1,9,15,0,4,1,1,0.66,0.6212,0.47,0.194,60,231,291,231
14964,9/20/2012,3,1,9,16,0,4,1,1,0.64,0.6212,0.47,0.1642,72,385,457,385
14965,9/20/2012,3,1,9,17,0,4,1,1,0.64,0.6212,0.5,0.2239,91,885,976,885
14966,9/20/2012,3,1,9,18,0,4,1,1,0.6,0.6212,0.56,0.2537,119,781,900,781
14967,9/20/2012,3,1,9,19,0,4,1,1,0.58,0.5455,0.6,0.2239,69,534,603,534
14968,9/20/2012,3,1,9,20,0,4,1,1,0.56,0.5303,0.64,0.1343,57,360,417,360
14969,9/20/2012,3,1,9,21,0,4,1,1,0.56,0.5303,0.64,0.194,28,246,274,246
14970,9/20/2012,3,1,9,22,0,4,1,1,0.54,0.5152,0.73,0.1045,35,252,287,252
14971,9/20/2012,3,1,9,23,0,4,1,1,0.54,0.5152,0.68,0.1045,17,137,154,137
14972,9/21/2012,3,1,9,0,0,5,1,1,0.54,0.5152,0.68,0,13,53,66,53
14973,9/21/2012,3,1,9,1,0,5,1,1,0.52,0.5,0.72,0,11,38,49,38
14974,9/21/2012,3,1,9,2,0,5,1,1,0.52,0.5,0.72,0,6,8,14,8
14975,9/21/2012,3,1,9,3,0,5,1,1,0.5,0.4848,0.77,0.0896,1,11,12,11
14976,9/21/2012,3,1,9,4,0,5,1,1,0.5,0.4848,0.77,0,1,9,10,9
14977,9/21/2012,3,1,9,5,0,5,1,1,0.5,0.4848,0.82,0,2,47,49,47
14978,9/21/2012,3,1,9,6,0,5,1,1,0.5,0.4848,0.77,0.0896,19,146,165,146
14979,9/21/2012,3,1,9,7,0,5,1,1,0.52,0.5,0.77,0,35,468,503,468
14980,9/21/2012,3,1,9,8,0,5,1,1,0.54,0.5152,0.73,0.1343,31,726,757,726
14981,9/21/2012,3,1,9,9,0,5,1,1,0.58,0.5455,0.68,0.1343,35,348,383,348
14982,9/21/2012,3,1,9,10,0,5,1,1,0.62,0.6061,0.61,0.2239,44,181,225,181
14983,9/21/2012,3,1,9,11,0,5,1,1,0.66,0.6212,0.57,0.2239,79,242,321,242
14984,9/21/2012,3,1,9,12,0,5,1,1,0.68,0.6364,0.57,0.1642,84,305,389,305
14985,9/21/2012,3,1,9,13,0,5,1,1,0.7,0.6515,0.54,0.1642,105,316,421,316
14986,9/21/2012,3,1,9,14,0,5,1,1,0.7,0.6515,0.54,0.2985,113,299,412,299
14987,9/21/2012,3,1,9,15,0,5,1,1,0.7,0.6515,0.54,0.2239,90,333,423,333
14988,9/21/2012,3,1,9,16,0,5,1,1,0.7,0.6515,0.54,0.194,103,464,567,464
14989,9/21/2012,3,1,9,17,0,5,1,1,0.68,0.6364,0.57,0.2836,107,739,846,739
14990,9/21/2012,3,1,9,18,0,5,1,1,0.66,0.6212,0.61,0.2537,106,699,805,699
14991,9/21/2012,3,1,9,19,0,5,1,1,0.64,0.6061,0.65,0.2537,95,493,588,493
14992,9/21/2012,3,1,9,20,0,5,1,1,0.62,0.6061,0.69,0.194,54,315,369,315
14993,9/21/2012,3,1,9,21,0,5,1,1,0.6,0.5909,0.73,0.2537,46,266,312,266
14994,9/21/2012,3,1,9,22,0,5,1,1,0.6,0.5909,0.73,0.194,47,248,295,248
14995,9/21/2012,3,1,9,23,0,5,1,1,0.6,0.5909,0.73,0.3284,23,163,186,163
14996,9/22/2012,3,1,9,0,0,6,0,1,0.6,0.5909,0.73,0.2836,32,140,172,140
14997,9/22/2012,3,1,9,1,0,6,0,1,0.58,0.5455,0.83,0.2985,18,106,124,106
14998,9/22/2012,3,1,9,2,0,6,0,1,0.56,0.5303,0.88,0.2537,10,73,83,73
14999,9/22/2012,3,1,9,3,0,6,0,1,0.56,0.5303,0.83,0.2836,6,39,45,39
15000,9/22/2012,3,1,9,4,0,6,0,1,0.56,0.5303,0.83,0.2836,5,10,15,10
15001,9/22/2012,3,1,9,5,0,6,0,1,0.56,0.5303,0.83,0.3284,2,15,17,15
15002,9/22/2012,3,1,9,6,0,6,0,1,0.56,0.5303,0.83,0.2985,6,35,41,35
15003,9/22/2012,3,1,9,7,0,6,0,1,0.58,0.5455,0.78,0.2537,7,70,77,70
15004,9/22/2012,3,1,9,8,0,6,0,1,0.6,0.5909,0.73,0.2985,21,197,218,197
15005,9/22/2012,3,1,9,9,0,6,0,1,0.64,0.6061,0.69,0.2537,88,289,377,289
15006,9/22/2012,3,1,9,10,0,6,0,1,0.66,0.6212,0.65,0.3284,124,350,474,350
15007,9/22/2012,3,1,9,11,0,6,0,1,0.7,0.6515,0.58,0.2836,189,437,626,437
15008,9/22/2012,3,1,9,12,0,6,0,1,0.72,0.6667,0.54,0.2985,228,460,688,460
15009,9/22/2012,3,1,9,13,0,6,0,1,0.74,0.6667,0.51,0.3582,273,434,707,434
15010,9/22/2012,3,1,9,14,0,6,0,1,0.76,0.6818,0.48,0.2836,250,404,654,404
15011,9/22/2012,3,1,9,15,0,6,0,1,0.74,0.6667,0.48,0.3881,307,443,750,443
15012,9/22/2012,3,1,9,16,0,6,0,1,0.74,0.6667,0.51,0.3284,253,427,680,427
15013,9/22/2012,3,1,9,17,0,6,0,1,0.74,0.6667,0.51,0.3284,195,451,646,451
15014,9/22/2012,3,1,9,18,0,6,0,1,0.72,0.6667,0.54,0.2836,171,427,598,427
15015,9/22/2012,3,1,9,19,0,6,0,1,0.7,0.6515,0.58,0.194,99,308,407,308
15016,9/22/2012,3,1,9,20,0,6,0,1,0.7,0.6515,0.54,0.2537,76,249,325,249
15017,9/22/2012,3,1,9,21,0,6,0,1,0.64,0.6212,0.57,0.2537,59,202,261,202
15018,9/22/2012,3,1,9,22,0,6,0,1,0.62,0.6212,0.57,0.194,59,180,239,180
15019,9/22/2012,3,1,9,23,0,6,0,1,0.62,0.6212,0.5,0.194,34,137,171,137
15020,9/23/2012,4,1,9,0,0,0,0,1,0.62,0.6212,0.38,0.2537,34,146,180,146
15021,9/23/2012,4,1,9,1,0,0,0,1,0.54,0.5152,0.52,0.3582,23,119,142,119
15022,9/23/2012,4,1,9,2,0,0,0,1,0.52,0.5,0.48,0.2537,18,77,95,77
15023,9/23/2012,4,1,9,3,0,0,0,1,0.48,0.4697,0.55,0.2985,13,41,54,41
15024,9/23/2012,4,1,9,4,0,0,0,1,0.46,0.4545,0.55,0.2239,1,9,10,9
15025,9/23/2012,4,1,9,5,0,0,0,1,0.46,0.4545,0.59,0.2537,1,5,6,5
15026,9/23/2012,4,1,9,6,0,0,0,1,0.44,0.4394,0.62,0.2537,5,11,16,11
15027,9/23/2012,4,1,9,7,0,0,0,1,0.46,0.4545,0.59,0.2239,9,48,57,48
15028,9/23/2012,4,1,9,8,0,0,0,1,0.48,0.4697,0.55,0.3582,38,137,175,137
15029,9/23/2012,4,1,9,9,0,0,0,1,0.5,0.4848,0.51,0.3284,71,205,276,205
15030,9/23/2012,4,1,9,10,0,0,0,1,0.54,0.5152,0.45,0.2537,138,351,489,351
15031,9/23/2012,4,1,9,11,0,0,0,1,0.56,0.5303,0.46,0.2537,186,384,570,384
15032,9/23/2012,4,1,9,12,0,0,0,1,0.56,0.5303,0.43,0.1045,250,526,776,526
15033,9/23/2012,4,1,9,13,0,0,0,1,0.6,0.6212,0.38,0.1642,257,445,702,445
15034,9/23/2012,4,1,9,14,0,0,0,1,0.6,0.6212,0.38,0.194,266,400,666,400
15035,9/23/2012,4,1,9,15,0,0,0,1,0.6,0.6212,0.33,0.2239,265,375,640,375
15036,9/23/2012,4,1,9,16,0,0,0,1,0.6,0.6212,0.33,0.3284,254,437,691,437
15037,9/23/2012,4,1,9,17,0,0,0,1,0.56,0.5303,0.35,0.2985,227,496,723,496
15038,9/23/2012,4,1,9,18,0,0,0,1,0.54,0.5152,0.37,0.194,135,405,540,405
15039,9/23/2012,4,1,9,19,0,0,0,1,0.52,0.5,0.42,0.1642,82,331,413,331
15040,9/23/2012,4,1,9,20,0,0,0,1,0.52,0.5,0.42,0.1642,60,192,252,192
15041,9/23/2012,4,1,9,21,0,0,0,2,0.52,0.5,0.48,0.1045,51,145,196,145
15042,9/23/2012,4,1,9,22,0,0,0,1,0.52,0.5,0.48,0,40,98,138,98
15043,9/23/2012,4,1,9,23,0,0,0,2,0.5,0.4848,0.59,0.1045,30,70,100,70
15044,9/24/2012,4,1,9,0,0,1,1,1,0.46,0.4545,0.63,0.194,10,54,64,54
15045,9/24/2012,4,1,9,1,0,1,1,1,0.46,0.4545,0.67,0.1343,6,12,18,12
15046,9/24/2012,4,1,9,2,0,1,1,2,0.46,0.4545,0.63,0.1343,0,8,8,8
15047,9/24/2012,4,1,9,3,0,1,1,1,0.46,0.4545,0.63,0.1642,0,5,5,5
15048,9/24/2012,4,1,9,4,0,1,1,1,0.44,0.4394,0.67,0.1045,0,8,8,8
15049,9/24/2012,4,1,9,5,0,1,1,1,0.46,0.4545,0.63,0,2,35,37,35
15050,9/24/2012,4,1,9,6,0,1,1,1,0.46,0.4545,0.59,0,6,162,168,162
15051,9/24/2012,4,1,9,7,0,1,1,1,0.46,0.4545,0.67,0.1343,17,513,530,513
15052,9/24/2012,4,1,9,8,0,1,1,1,0.5,0.4848,0.55,0.194,31,719,750,719
15053,9/24/2012,4,1,9,9,0,1,1,1,0.52,0.5,0.52,0.194,42,286,328,286
15054,9/24/2012,4,1,9,10,0,1,1,1,0.54,0.5152,0.49,0.2239,52,146,198,146
15055,9/24/2012,4,1,9,11,0,1,1,1,0.56,0.5303,0.37,0.194,71,167,238,167
15056,9/24/2012,4,1,9,12,0,1,1,1,0.56,0.5303,0.35,0.2985,77,265,342,265
15057,9/24/2012,4,1,9,13,0,1,1,1,0.6,0.6212,0.31,0.2985,80,248,328,248
15058,9/24/2012,4,1,9,14,0,1,1,1,0.6,0.6061,0.28,0,77,226,303,226
15059,9/24/2012,4,1,9,15,0,1,1,1,0.6,0.6212,0.31,0,84,216,300,216
15060,9/24/2012,4,1,9,16,0,1,1,1,0.58,0.5455,0.3,0.2537,99,417,516,417
15061,9/24/2012,4,1,9,17,0,1,1,1,0.58,0.5455,0.3,0,89,809,898,809
15062,9/24/2012,4,1,9,18,0,1,1,1,0.54,0.5152,0.37,0.1642,95,758,853,758
15063,9/24/2012,4,1,9,19,0,1,1,1,0.52,0.5,0.39,0.1343,56,534,590,534
15064,9/24/2012,4,1,9,20,0,1,1,1,0.52,0.5,0.52,0.1045,52,380,432,380
15065,9/24/2012,4,1,9,21,0,1,1,1,0.5,0.4848,0.51,0.1343,26,230,256,230
15066,9/24/2012,4,1,9,22,0,1,1,1,0.5,0.4848,0.51,0.2239,18,154,172,154
15067,9/24/2012,4,1,9,23,0,1,1,1,0.46,0.4545,0.63,0.1343,11,83,94,83
15068,9/25/2012,4,1,9,0,0,2,1,1,0.46,0.4545,0.67,0.1642,8,56,64,56
15069,9/25/2012,4,1,9,1,0,2,1,1,0.44,0.4394,0.72,0.1343,2,11,13,11
15070,9/25/2012,4,1,9,2,0,2,1,1,0.42,0.4242,0.77,0.1343,5,9,14,9
15071,9/25/2012,4,1,9,3,0,2,1,1,0.42,0.4242,0.71,0.0896,2,3,5,3
15072,9/25/2012,4,1,9,4,0,2,1,1,0.42,0.4242,0.71,0.1343,2,7,9,7
15073,9/25/2012,4,1,9,5,0,2,1,1,0.42,0.4242,0.77,0.0896,1,46,47,46
15074,9/25/2012,4,1,9,6,0,2,1,1,0.44,0.4394,0.77,0.2239,5,189,194,189
15075,9/25/2012,4,1,9,7,0,2,1,1,0.44,0.4394,0.77,0.194,17,539,556,539
15076,9/25/2012,4,1,9,8,0,2,1,1,0.48,0.4697,0.67,0.194,41,764,805,764
15077,9/25/2012,4,1,9,9,0,2,1,1,0.54,0.5152,0.56,0.2537,28,381,409,381
15078,9/25/2012,4,1,9,10,0,2,1,1,0.56,0.5303,0.52,0.2985,45,125,170,125
15079,9/25/2012,4,1,9,11,0,2,1,1,0.6,0.6212,0.46,0.2985,63,155,218,155
15080,9/25/2012,4,1,9,12,0,2,1,1,0.62,0.6212,0.43,0.2836,69,233,302,233
15081,9/25/2012,4,1,9,13,0,2,1,1,0.64,0.6212,0.47,0.2537,48,257,305,257
15082,9/25/2012,4,1,9,14,0,2,1,1,0.66,0.6212,0.39,0.3284,80,213,293,213
15083,9/25/2012,4,1,9,15,0,2,1,1,0.66,0.6212,0.36,0.3284,56,247,303,247
15084,9/25/2012,4,1,9,16,0,2,1,1,0.66,0.6212,0.39,0.2985,59,436,495,436
15085,9/25/2012,4,1,9,17,0,2,1,1,0.66,0.6212,0.39,0.2836,107,860,967,860
15086,9/25/2012,4,1,9,18,0,2,1,1,0.64,0.6212,0.41,0.2239,64,758,822,758
15087,9/25/2012,4,1,9,19,0,2,1,1,0.62,0.6212,0.5,0.2537,49,490,539,490
15088,9/25/2012,4,1,9,20,0,2,1,1,0.6,0.6212,0.56,0.2985,37,388,425,388
15089,9/25/2012,4,1,9,21,0,2,1,1,0.6,0.6212,0.56,0.2985,34,263,297,263
15090,9/25/2012,4,1,9,22,0,2,1,1,0.6,0.6212,0.56,0.2836,14,174,188,174
15091,9/25/2012,4,1,9,23,0,2,1,1,0.6,0.6212,0.56,0.3284,9,89,98,89
15092,9/26/2012,4,1,9,0,0,3,1,1,0.58,0.5455,0.64,0.2985,6,34,40,34
15093,9/26/2012,4,1,9,1,0,3,1,1,0.58,0.5455,0.64,0.3284,10,19,29,19
15094,9/26/2012,4,1,9,2,0,3,1,2,0.58,0.5455,0.64,0.2836,2,15,17,15
15095,9/26/2012,4,1,9,3,0,3,1,2,0.58,0.5455,0.64,0.2836,4,6,10,6
15096,9/26/2012,4,1,9,4,0,3,1,1,0.56,0.5303,0.73,0.2537,2,12,14,12
15097,9/26/2012,4,1,9,5,0,3,1,1,0.56,0.5303,0.73,0.2239,1,35,36,35
15098,9/26/2012,4,1,9,6,0,3,1,1,0.54,0.5152,0.73,0.194,3,179,182,179
15099,9/26/2012,4,1,9,7,0,3,1,1,0.54,0.5152,0.77,0.1343,9,523,532,523
15100,9/26/2012,4,1,9,8,0,3,1,1,0.56,0.5303,0.73,0.2985,30,808,838,808
15101,9/26/2012,4,1,9,9,0,3,1,1,0.6,0.6061,0.64,0.194,27,307,334,307
15102,9/26/2012,4,1,9,10,0,3,1,1,0.6,0.5909,0.73,0.2836,29,156,185,156
15103,9/26/2012,4,1,9,11,0,3,1,1,0.64,0.6212,0.61,0.2537,46,181,227,181
15104,9/26/2012,4,1,9,12,0,3,1,1,0.68,0.6364,0.61,0.2239,56,260,316,260
15105,9/26/2012,4,1,9,13,0,3,1,1,0.7,0.6515,0.58,0.2239,67,273,340,273
15106,9/26/2012,4,1,9,14,0,3,1,1,0.74,0.6667,0.48,0.2836,60,217,277,217
15107,9/26/2012,4,1,9,15,0,3,1,1,0.74,0.6667,0.48,0.2985,69,231,300,231
15108,9/26/2012,4,1,9,16,0,3,1,1,0.74,0.6667,0.45,0.2836,71,397,468,397
15109,9/26/2012,4,1,9,17,0,3,1,1,0.74,0.6667,0.48,0.2985,77,876,953,876
15110,9/26/2012,4,1,9,18,0,3,1,1,0.74,0.6667,0.48,0.2239,69,815,884,815
15111,9/26/2012,4,1,9,19,0,3,1,1,0.7,0.6515,0.54,0.1642,38,589,627,589
15112,9/26/2012,4,1,9,20,0,3,1,1,0.66,0.6212,0.69,0.194,45,389,434,389
15113,9/26/2012,4,1,9,21,0,3,1,1,0.66,0.6212,0.65,0.194,32,328,360,328
15114,9/26/2012,4,1,9,22,0,3,1,3,0.62,0.6061,0.69,0.194,21,194,215,194
15115,9/26/2012,4,1,9,23,0,3,1,2,0.6,0.5758,0.78,0.2537,13,102,115,102
15116,9/27/2012,4,1,9,0,0,4,1,1,0.6,0.5758,0.78,0.0896,5,60,65,60
15117,9/27/2012,4,1,9,1,0,4,1,1,0.6,0.5758,0.78,0.0896,5,16,21,16
15118,9/27/2012,4,1,9,2,0,4,1,1,0.6,0.5758,0.78,0.0896,3,13,16,13
15119,9/27/2012,4,1,9,3,0,4,1,1,0.6,0.5758,0.78,0,0,7,7,7
15120,9/27/2012,4,1,9,4,0,4,1,1,0.56,0.5303,0.94,0.1343,2,6,8,6
15121,9/27/2012,4,1,9,5,0,4,1,1,0.58,0.5455,0.83,0,2,64,66,64
15122,9/27/2012,4,1,9,6,0,4,1,1,0.56,0.5303,0.88,0.0896,5,164,169,164
15123,9/27/2012,4,1,9,7,0,4,1,1,0.6,0.5758,0.78,0,12,546,558,546
15124,9/27/2012,4,1,9,8,0,4,1,1,0.62,0.6061,0.71,0.0896,20,774,794,774
15125,9/27/2012,4,1,9,9,0,4,1,1,0.66,0.6212,0.65,0,30,305,335,305
15126,9/27/2012,4,1,9,10,0,4,1,2,0.7,0.6515,0.51,0.2836,40,168,208,168
15127,9/27/2012,4,1,9,11,0,4,1,2,0.72,0.6667,0.51,0.1642,67,227,294,227
15128,9/27/2012,4,1,9,12,0,4,1,2,0.74,0.6667,0.48,0.1343,63,272,335,272
15129,9/27/2012,4,1,9,13,0,4,1,2,0.74,0.6667,0.48,0,61,265,326,265
15130,9/27/2012,4,1,9,14,0,4,1,2,0.76,0.6818,0.45,0.0896,44,214,258,214
15131,9/27/2012,4,1,9,15,0,4,1,2,0.76,0.6818,0.45,0,41,255,296,255
15132,9/27/2012,4,1,9,16,0,4,1,2,0.72,0.6667,0.58,0.3284,73,399,472,399
15133,9/27/2012,4,1,9,17,0,4,1,2,0.66,0.6212,0.69,0.2985,87,818,905,818
15134,9/27/2012,4,1,9,18,0,4,1,2,0.66,0.6212,0.69,0.2239,77,822,899,822
15135,9/27/2012,4,1,9,19,0,4,1,1,0.66,0.6212,0.65,0.1343,48,511,559,511
15136,9/27/2012,4,1,9,20,0,4,1,2,0.64,0.6061,0.69,0.2239,45,412,457,412
15137,9/27/2012,4,1,9,21,0,4,1,3,0.62,0.5758,0.83,0.2985,18,235,253,235
15138,9/27/2012,4,1,9,22,0,4,1,3,0.62,0.5758,0.83,0.2985,2,45,47,45
15139,9/27/2012,4,1,9,23,0,4,1,3,0.62,0.5758,0.83,0.1642,1,44,45,44
15140,9/28/2012,4,1,9,0,0,5,1,3,0.6,0.5455,0.88,0.1642,2,15,17,15
15141,9/28/2012,4,1,9,1,0,5,1,3,0.6,0.5455,0.88,0,0,13,13,13
15142,9/28/2012,4,1,9,2,0,5,1,3,0.6,0.5455,0.88,0.2985,1,9,10,9
15143,9/28/2012,4,1,9,3,0,5,1,2,0.6,0.5606,0.83,0.1343,0,7,7,7
15144,9/28/2012,4,1,9,4,0,5,1,3,0.56,0.5303,0.88,0.1045,2,10,12,10
15145,9/28/2012,4,1,9,5,0,5,1,1,0.56,0.5303,0.88,0,1,37,38,37
15146,9/28/2012,4,1,9,6,0,5,1,2,0.56,0.5303,0.94,0.0896,2,136,138,136
15147,9/28/2012,4,1,9,7,0,5,1,2,0.56,0.5303,0.94,0,10,384,394,384
15148,9/28/2012,4,1,9,8,0,5,1,1,0.6,0.5606,0.83,0.0896,31,674,705,674
15149,9/28/2012,4,1,9,9,0,5,1,2,0.62,0.5758,0.83,0.1045,27,399,426,399
15150,9/28/2012,4,1,9,10,0,5,1,2,0.64,0.5909,0.78,0.1343,51,194,245,194
15151,9/28/2012,4,1,9,11,0,5,1,2,0.66,0.6212,0.69,0,109,252,361,252
15152,9/28/2012,4,1,9,12,0,5,1,2,0.7,0.6515,0.54,0.2537,94,286,380,286
15153,9/28/2012,4,1,9,13,0,5,1,2,0.7,0.6515,0.51,0.2537,106,304,410,304
15154,9/28/2012,4,1,9,14,0,5,1,2,0.7,0.6515,0.54,0.2537,105,294,399,294
15155,9/28/2012,4,1,9,15,0,5,1,2,0.68,0.6364,0.54,0.2836,104,288,392,288
15156,9/28/2012,4,1,9,16,0,5,1,2,0.66,0.6212,0.5,0.2239,83,419,502,419
15157,9/28/2012,4,1,9,17,0,5,1,2,0.66,0.6212,0.54,0.2985,101,707,808,707
15158,9/28/2012,4,1,9,18,0,5,1,2,0.64,0.6212,0.5,0.2239,58,609,667,609
15159,9/28/2012,4,1,9,19,0,5,1,3,0.62,0.6212,0.5,0.2537,38,470,508,470
15160,9/28/2012,4,1,9,20,0,5,1,3,0.6,0.6212,0.53,0.1642,32,304,336,304
15161,9/28/2012,4,1,9,21,0,5,1,3,0.6,0.6212,0.53,0.194,32,205,237,205
15162,9/28/2012,4,1,9,22,0,5,1,2,0.58,0.5455,0.53,0.2239,30,190,220,190
15163,9/28/2012,4,1,9,23,0,5,1,2,0.56,0.5303,0.56,0.194,26,164,190,164
15164,9/29/2012,4,1,9,0,0,6,0,1,0.54,0.5152,0.6,0.2239,15,134,149,134
15165,9/29/2012,4,1,9,1,0,6,0,1,0.54,0.5152,0.6,0.2239,12,89,101,89
15166,9/29/2012,4,1,9,2,0,6,0,2,0.54,0.5152,0.56,0.2239,12,80,92,80
15167,9/29/2012,4,1,9,3,0,6,0,2,0.52,0.5,0.59,0.194,4,25,29,25
15168,9/29/2012,4,1,9,4,0,6,0,1,0.52,0.5,0.59,0.2537,6,8,14,8
15169,9/29/2012,4,1,9,5,0,6,0,1,0.5,0.4848,0.63,0.194,2,13,15,13
15170,9/29/2012,4,1,9,6,0,6,0,1,0.5,0.4848,0.63,0.2537,4,33,37,33
15171,9/29/2012,4,1,9,7,0,6,0,1,0.48,0.4697,0.67,0.2836,12,61,73,61
15172,9/29/2012,4,1,9,8,0,6,0,1,0.5,0.4848,0.68,0.2836,37,174,211,174
15173,9/29/2012,4,1,9,9,0,6,0,1,0.5,0.4848,0.63,0.194,69,263,332,263
15174,9/29/2012,4,1,9,10,0,6,0,1,0.54,0.5152,0.56,0.2537,134,338,472,338
15175,9/29/2012,4,1,9,11,0,6,0,1,0.56,0.5303,0.52,0.2836,217,446,663,446
15176,9/29/2012,4,1,9,12,0,6,0,1,0.62,0.6212,0.41,0.2985,191,491,682,491
15177,9/29/2012,4,1,9,13,0,6,0,1,0.62,0.6212,0.41,0.2985,233,453,686,453
15178,9/29/2012,4,1,9,14,0,6,0,1,0.6,0.6212,0.4,0.2537,302,448,750,448
15179,9/29/2012,4,1,9,15,0,6,0,1,0.6,0.6212,0.43,0.2537,271,456,727,456
15180,9/29/2012,4,1,9,16,0,6,0,1,0.62,0.6212,0.41,0.2537,275,447,722,447
15181,9/29/2012,4,1,9,17,0,6,0,1,0.6,0.6212,0.38,0.3582,256,456,712,456
15182,9/29/2012,4,1,9,18,0,6,0,1,0.56,0.5303,0.46,0.194,174,420,594,420
15183,9/29/2012,4,1,9,19,0,6,0,1,0.52,0.5,0.55,0.1642,119,351,470,351
15184,9/29/2012,4,1,9,20,0,6,0,1,0.52,0.5,0.55,0.194,88,227,315,227
15185,9/29/2012,4,1,9,21,0,6,0,1,0.52,0.5,0.55,0.1343,73,219,292,219
15186,9/29/2012,4,1,9,22,0,6,0,1,0.5,0.4848,0.63,0.1045,48,173,221,173
15187,9/29/2012,4,1,9,23,0,6,0,1,0.5,0.4848,0.59,0.0896,35,161,196,161
15188,9/30/2012,4,1,9,0,0,0,0,1,0.5,0.4848,0.59,0,35,112,147,112
15189,9/30/2012,4,1,9,1,0,0,0,1,0.5,0.4848,0.59,0,31,85,116,85
15190,9/30/2012,4,1,9,2,0,0,0,1,0.48,0.4697,0.63,0,21,71,92,71
15191,9/30/2012,4,1,9,3,0,0,0,1,0.46,0.4545,0.67,0.0896,17,41,58,41
15192,9/30/2012,4,1,9,4,0,0,0,1,0.46,0.4545,0.67,0.0896,1,6,7,6
15193,9/30/2012,4,1,9,5,0,0,0,1,0.44,0.4394,0.72,0,1,9,10,9
15194,9/30/2012,4,1,9,6,0,0,0,1,0.44,0.4394,0.72,0.0896,2,20,22,20
15195,9/30/2012,4,1,9,7,0,0,0,1,0.44,0.4394,0.77,0,14,43,57,43
15196,9/30/2012,4,1,9,8,0,0,0,1,0.48,0.4697,0.67,0.1045,18,126,144,126
15197,9/30/2012,4,1,9,9,0,0,0,1,0.52,0.5,0.63,0.1045,74,211,285,211
15198,9/30/2012,4,1,9,10,0,0,0,1,0.58,0.5455,0.46,0.1642,160,319,479,319
15199,9/30/2012,4,1,9,11,0,0,0,1,0.6,0.6212,0.43,0.2239,222,369,591,369
15200,9/30/2012,4,1,9,12,0,0,0,1,0.62,0.6212,0.41,0.2985,206,474,680,474
15201,9/30/2012,4,1,9,13,0,0,0,1,0.62,0.6212,0.41,0.2537,180,414,594,414
15202,9/30/2012,4,1,9,14,0,0,0,1,0.62,0.6212,0.41,0.2537,208,404,612,404
15203,9/30/2012,4,1,9,15,0,0,0,1,0.64,0.6212,0.36,0.2537,230,419,649,419
15204,9/30/2012,4,1,9,16,0,0,0,1,0.64,0.6212,0.36,0.2239,202,446,648,446
15205,9/30/2012,4,1,9,17,0,0,0,1,0.62,0.6212,0.35,0.2836,195,380,575,380
15206,9/30/2012,4,1,9,18,0,0,0,1,0.52,0.5,0.59,0.4478,91,310,401,310
15207,9/30/2012,4,1,9,19,0,0,0,3,0.5,0.4848,0.72,0.1343,34,223,257,223
15208,9/30/2012,4,1,9,20,0,0,0,3,0.5,0.4848,0.72,0.1343,31,163,194,163
15209,9/30/2012,4,1,9,21,0,0,0,1,0.5,0.4848,0.68,0,19,104,123,104
15210,9/30/2012,4,1,9,22,0,0,0,1,0.48,0.4697,0.72,0,15,76,91,76
15211,9/30/2012,4,1,9,23,0,0,0,1,0.48,0.4697,0.72,0.0896,8,49,57,49
15212,10/1/2012,4,1,10,0,0,1,1,1,0.46,0.4545,0.72,0.1045,6,39,45,39
15213,10/1/2012,4,1,10,1,0,1,1,1,0.44,0.4394,0.77,0.0896,5,13,18,13
15214,10/1/2012,4,1,10,2,0,1,1,1,0.46,0.4545,0.72,0,6,6,12,6
15215,10/1/2012,4,1,10,3,0,1,1,1,0.44,0.4394,0.77,0,1,6,7,6
15216,10/1/2012,4,1,10,4,0,1,1,1,0.42,0.4242,0.82,0.1045,0,10,10,10
15217,10/1/2012,4,1,10,5,0,1,1,1,0.44,0.4394,0.77,0,2,34,36,34
15218,10/1/2012,4,1,10,6,0,1,1,1,0.44,0.4394,0.77,0.1045,8,147,155,147
15219,10/1/2012,4,1,10,7,0,1,1,1,0.44,0.4394,0.77,0.1642,13,470,483,470
15220,10/1/2012,4,1,10,8,0,1,1,2,0.46,0.4545,0.77,0.1045,40,744,784,744
15221,10/1/2012,4,1,10,9,0,1,1,2,0.52,0.5,0.63,0,26,314,340,314
15222,10/1/2012,4,1,10,10,0,1,1,1,0.54,0.5152,0.56,0,44,135,179,135
15223,10/1/2012,4,1,10,11,0,1,1,1,0.58,0.5455,0.46,0,76,196,272,196
15224,10/1/2012,4,1,10,12,0,1,1,2,0.6,0.6212,0.43,0.1642,61,262,323,262
15225,10/1/2012,4,1,10,13,0,1,1,2,0.6,0.6212,0.43,0.1642,80,225,305,225
15226,10/1/2012,4,1,10,14,0,1,1,2,0.6,0.6212,0.43,0.1045,51,193,244,193
15227,10/1/2012,4,1,10,15,0,1,1,2,0.62,0.6212,0.43,0.1343,95,234,329,234
15228,10/1/2012,4,1,10,16,0,1,1,2,0.62,0.6212,0.46,0.2537,51,408,459,408
15229,10/1/2012,4,1,10,17,0,1,1,3,0.56,0.5303,0.6,0.2537,65,791,856,791
15230,10/1/2012,4,1,10,18,0,1,1,3,0.56,0.5303,0.64,0.1045,42,571,613,571
15231,10/1/2012,4,1,10,19,0,1,1,2,0.54,0.5152,0.68,0.1045,33,483,516,483
15232,10/1/2012,4,1,10,20,0,1,1,3,0.54,0.5152,0.68,0,11,251,262,251
15233,10/1/2012,4,1,10,21,0,1,1,2,0.54,0.5152,0.73,0.1343,13,205,218,205
15234,10/1/2012,4,1,10,22,0,1,1,3,0.54,0.5152,0.77,0.0896,17,190,207,190
15235,10/1/2012,4,1,10,23,0,1,1,3,0.54,0.5152,0.77,0,17,88,105,88
15236,10/2/2012,4,1,10,0,0,2,1,2,0.56,0.5303,0.73,0,1,30,31,30
15237,10/2/2012,4,1,10,1,0,2,1,2,0.54,0.5152,0.77,0.1045,0,11,11,11
15238,10/2/2012,4,1,10,2,0,2,1,2,0.54,0.5152,0.77,0.1045,0,2,2,2
15239,10/2/2012,4,1,10,3,0,2,1,2,0.54,0.5152,0.88,0.194,1,4,5,4
15240,10/2/2012,4,1,10,4,0,2,1,2,0.56,0.5303,0.83,0.0896,2,8,10,8
15241,10/2/2012,4,1,10,5,0,2,1,2,0.56,0.5303,0.83,0.1343,1,42,43,42
15242,10/2/2012,4,1,10,6,0,2,1,3,0.58,0.5455,0.83,0.1045,3,176,179,176
15243,10/2/2012,4,1,10,7,0,2,1,3,0.58,0.5455,0.83,0.1045,4,256,260,256
15244,10/2/2012,4,1,10,8,0,2,1,3,0.6,0.5455,0.88,0,6,128,134,128
15245,10/2/2012,4,1,10,9,0,2,1,3,0.58,0.5455,0.88,0.1343,3,83,86,83
15246,10/2/2012,4,1,10,10,0,2,1,3,0.58,0.5455,0.88,0.1343,3,42,45,42
15247,10/2/2012,4,1,10,11,0,2,1,3,0.58,0.5455,0.94,0.1343,7,92,99,92
15248,10/2/2012,4,1,10,12,0,2,1,2,0.6,0.5455,0.88,0.194,6,98,104,98
15249,10/2/2012,4,1,10,13,0,2,1,2,0.6,0.5455,0.88,0.1343,6,148,154,148
15250,10/2/2012,4,1,10,14,0,2,1,3,0.6,0.5455,0.88,0.1343,16,147,163,147
15251,10/2/2012,4,1,10,15,0,2,1,3,0.62,0.5758,0.83,0.1343,14,195,209,195
15252,10/2/2012,4,1,10,16,0,2,1,3,0.62,0.5606,0.88,0.1343,46,328,374,328
15253,10/2/2012,4,1,10,17,0,2,1,3,0.62,0.5606,0.88,0.1045,38,677,715,677
15254,10/2/2012,4,1,10,18,0,2,1,3,0.62,0.5455,0.94,0.0896,48,639,687,639
15255,10/2/2012,4,1,10,19,0,2,1,3,0.62,0.5455,0.94,0,27,368,395,368
15256,10/2/2012,4,1,10,20,0,2,1,3,0.62,0.5455,0.94,0.1343,20,286,306,286
15257,10/2/2012,4,1,10,21,0,2,1,3,0.62,0.5455,0.94,0.1045,24,265,289,265
15258,10/2/2012,4,1,10,22,0,2,1,2,0.62,0.5455,0.94,0.1045,28,212,240,212
15259,10/2/2012,4,1,10,23,0,2,1,2,0.62,0.5455,0.94,0,11,87,98,87
15260,10/3/2012,4,1,10,0,0,3,1,3,0.62,0.5455,0.94,0,5,47,52,47
15261,10/3/2012,4,1,10,1,0,3,1,2,0.62,0.5455,0.94,0,3,16,19,16
15262,10/3/2012,4,1,10,2,0,3,1,2,0.62,0.5455,0.94,0,2,7,9,7
15263,10/3/2012,4,1,10,3,0,3,1,2,0.6,0.5152,0.94,0,0,7,7,7
15264,10/3/2012,4,1,10,4,0,3,1,2,0.6,0.5,1,0,2,9,11,9
15265,10/3/2012,4,1,10,5,0,3,1,2,0.62,0.5455,0.94,0.1045,2,32,34,32
15266,10/3/2012,4,1,10,6,0,3,1,2,0.6,0.5152,0.94,0.1343,4,173,177,173
15267,10/3/2012,4,1,10,7,0,3,1,2,0.6,0.5152,0.94,0.194,11,504,515,504
15268,10/3/2012,4,1,10,8,0,3,1,2,0.62,0.5606,0.88,0.1045,28,781,809,781
15269,10/3/2012,4,1,10,9,0,3,1,2,0.62,0.5758,0.83,0.194,30,332,362,332
15270,10/3/2012,4,1,10,10,0,3,1,1,0.66,0.6061,0.78,0.1642,29,146,175,146
15271,10/3/2012,4,1,10,11,0,3,1,1,0.66,0.6061,0.78,0.1642,52,178,230,178
15272,10/3/2012,4,1,10,12,0,3,1,2,0.7,0.6515,0.7,0.1045,69,289,358,289
15273,10/3/2012,4,1,10,13,0,3,1,2,0.7,0.6667,0.74,0.1045,55,224,279,224
15274,10/3/2012,4,1,10,14,0,3,1,2,0.72,0.6818,0.7,0.1642,56,195,251,195
15275,10/3/2012,4,1,10,15,0,3,1,2,0.72,0.6818,0.62,0.1642,59,260,319,260
15276,10/3/2012,4,1,10,16,0,3,1,2,0.72,0.6667,0.58,0,42,436,478,436
15277,10/3/2012,4,1,10,17,0,3,1,1,0.7,0.6515,0.65,0,84,833,917,833
15278,10/3/2012,4,1,10,18,0,3,1,1,0.7,0.6515,0.65,0,54,756,810,756
15279,10/3/2012,4,1,10,19,0,3,1,1,0.7,0.6515,0.65,0,49,544,593,544
15280,10/3/2012,4,1,10,20,0,3,1,1,0.7,0.6515,0.65,0,48,449,497,449
15281,10/3/2012,4,1,10,21,0,3,1,2,0.66,0.6212,0.74,0,14,195,209,195
15282,10/3/2012,4,1,10,22,0,3,1,1,0.66,0.6212,0.74,0,9,232,241,232
15283,10/3/2012,4,1,10,23,0,3,1,2,0.66,0.6061,0.78,0,21,199,220,199
15284,10/4/2012,4,1,10,0,0,4,1,3,0.64,0.5758,0.89,0,11,65,76,65
15285,10/4/2012,4,1,10,1,0,4,1,2,0.62,0.5455,0.94,0,2,23,25,23
15286,10/4/2012,4,1,10,2,0,4,1,1,0.64,0.5758,0.89,0,3,10,13,10
15287,10/4/2012,4,1,10,3,0,4,1,2,0.62,0.5606,0.88,0,5,6,11,6
15288,10/4/2012,4,1,10,4,0,4,1,2,0.64,0.5758,0.89,0,0,10,10,10
15289,10/4/2012,4,1,10,5,0,4,1,3,0.64,0.5758,0.89,0.1045,2,37,39,37
15290,10/4/2012,4,1,10,6,0,4,1,3,0.62,0.5455,0.94,0.0896,1,132,133,132
15291,10/4/2012,4,1,10,7,0,4,1,2,0.64,0.5758,0.89,0.0896,12,379,391,379
15292,10/4/2012,4,1,10,8,0,4,1,1,0.64,0.5758,0.89,0,27,711,738,711
15293,10/4/2012,4,1,10,9,0,4,1,2,0.64,0.5758,0.89,0.194,40,319,359,319
15294,10/4/2012,4,1,10,10,0,4,1,2,0.66,0.6061,0.83,0.1343,27,150,177,150
15295,10/4/2012,4,1,10,11,0,4,1,2,0.7,0.6515,0.7,0.1045,38,176,214,176
15296,10/4/2012,4,1,10,12,0,4,1,2,0.72,0.6667,0.54,0.194,57,231,288,231
15297,10/4/2012,4,1,10,13,0,4,1,2,0.72,0.6667,0.58,0.3284,63,231,294,231
15298,10/4/2012,4,1,10,14,0,4,1,1,0.7,0.6515,0.61,0.2537,56,211,267,211
15299,10/4/2012,4,1,10,15,0,4,1,1,0.72,0.6667,0.54,0.2836,77,248,325,248
15300,10/4/2012,4,1,10,16,0,4,1,1,0.7,0.6515,0.54,0.2836,86,411,497,411
15301,10/4/2012,4,1,10,17,0,4,1,1,0.7,0.6515,0.51,0.2239,112,789,901,789
15302,10/4/2012,4,1,10,18,0,4,1,1,0.66,0.6212,0.57,0.1045,75,812,887,812
15303,10/4/2012,4,1,10,19,0,4,1,1,0.66,0.6212,0.57,0.1045,67,467,534,467
15304,10/4/2012,4,1,10,20,0,4,1,1,0.64,0.6061,0.65,0.1045,50,391,441,391
15305,10/4/2012,4,1,10,21,0,4,1,1,0.62,0.6061,0.69,0,33,288,321,288
15306,10/4/2012,4,1,10,22,0,4,1,1,0.64,0.6212,0.47,0.1343,29,203,232,203
15307,10/4/2012,4,1,10,23,0,4,1,1,0.6,0.6212,0.56,0.0896,18,137,155,137
15308,10/5/2012,4,1,10,0,0,5,1,1,0.56,0.5303,0.73,0,16,86,102,86
15309,10/5/2012,4,1,10,1,0,5,1,1,0.54,0.5152,0.68,0.1045,3,43,46,43
15310,10/5/2012,4,1,10,2,0,5,1,1,0.54,0.5152,0.73,0.0896,1,10,11,10
15311,10/5/2012,4,1,10,3,0,5,1,1,0.54,0.5152,0.73,0,5,11,16,11
15312,10/5/2012,4,1,10,4,0,5,1,1,0.54,0.5152,0.77,0,0,11,11,11
15313,10/5/2012,4,1,10,5,0,5,1,1,0.52,0.5,0.77,0,0,41,41,41
15314,10/5/2012,4,1,10,6,0,5,1,1,0.52,0.5,0.83,0,4,133,137,133
15315,10/5/2012,4,1,10,7,0,5,1,1,0.52,0.5,0.83,0.1045,11,417,428,417
15316,10/5/2012,4,1,10,8,0,5,1,1,0.58,0.5455,0.64,0,36,749,785,749
15317,10/5/2012,4,1,10,9,0,5,1,1,0.6,0.6061,0.6,0.0896,58,326,384,326
15318,10/5/2012,4,1,10,10,0,5,1,1,0.66,0.6212,0.54,0,68,192,260,192
15319,10/5/2012,4,1,10,11,0,5,1,1,0.7,0.6515,0.48,0.194,90,214,304,214
15320,10/5/2012,4,1,10,12,0,5,1,1,0.72,0.6515,0.42,0.1642,161,307,468,307
15321,10/5/2012,4,1,10,13,0,5,1,1,0.7,0.6515,0.48,0,117,307,424,307
15322,10/5/2012,4,1,10,14,0,5,1,1,0.74,0.6515,0.37,0.2239,113,287,400,287
15323,10/5/2012,4,1,10,15,0,5,1,1,0.72,0.6515,0.39,0.2537,150,320,470,320
15324,10/5/2012,4,1,10,16,0,5,1,1,0.72,0.6515,0.37,0,153,481,634,481
15325,10/5/2012,4,1,10,17,0,5,1,1,0.7,0.6364,0.42,0.1642,158,742,900,742
15326,10/5/2012,4,1,10,18,0,5,1,1,0.64,0.6212,0.57,0.1343,106,655,761,655
15327,10/5/2012,4,1,10,19,0,5,1,1,0.62,0.5909,0.73,0.1642,67,433,500,433
15328,10/5/2012,4,1,10,20,0,5,1,1,0.6,0.5758,0.78,0.1343,66,306,372,306
15329,10/5/2012,4,1,10,21,0,5,1,1,0.6,0.5909,0.69,0.2239,47,220,267,220
15330,10/5/2012,4,1,10,22,0,5,1,1,0.6,0.5909,0.73,0.2836,63,201,264,201
15331,10/5/2012,4,1,10,23,0,5,1,1,0.58,0.5455,0.78,0.2239,23,148,171,148
15332,10/6/2012,4,1,10,0,0,6,0,1,0.56,0.5303,0.83,0.1642,37,154,191,154
15333,10/6/2012,4,1,10,1,0,6,0,1,0.56,0.5303,0.83,0.2537,25,116,141,116
15334,10/6/2012,4,1,10,2,0,6,0,1,0.56,0.5303,0.78,0.194,13,62,75,62
15335,10/6/2012,4,1,10,3,0,6,0,1,0.54,0.5152,0.77,0.2239,2,54,56,54
15336,10/6/2012,4,1,10,4,0,6,0,1,0.54,0.5152,0.83,0.2537,4,7,11,7
15337,10/6/2012,4,1,10,5,0,6,0,1,0.54,0.5152,0.83,0.194,2,8,10,8
15338,10/6/2012,4,1,10,6,0,6,0,1,0.54,0.5152,0.88,0.2537,2,28,30,28
15339,10/6/2012,4,1,10,7,0,6,0,1,0.54,0.5152,0.83,0.2985,13,71,84,71
15340,10/6/2012,4,1,10,8,0,6,0,1,0.56,0.5303,0.83,0.194,22,184,206,184
15341,10/6/2012,4,1,10,9,0,6,0,1,0.6,0.5909,0.73,0.194,130,265,395,265
15342,10/6/2012,4,1,10,10,0,6,0,1,0.62,0.6061,0.69,0.2836,198,341,539,341
15343,10/6/2012,4,1,10,11,0,6,0,1,0.64,0.6061,0.65,0.2537,258,389,647,389
15344,10/6/2012,4,1,10,12,0,6,0,1,0.7,0.6515,0.54,0.1045,362,381,743,381
15345,10/6/2012,4,1,10,13,0,6,0,2,0.64,0.6212,0.57,0.5224,310,400,710,400
15346,10/6/2012,4,1,10,14,0,6,0,2,0.6,0.6212,0.56,0.4179,269,307,576,307
15347,10/6/2012,4,1,10,15,0,6,0,1,0.6,0.6212,0.46,0.4179,279,341,620,341
15348,10/6/2012,4,1,10,16,0,6,0,1,0.6,0.6212,0.43,0.5224,317,342,659,342
15349,10/6/2012,4,1,10,17,0,6,0,1,0.54,0.5152,0.49,0.3881,268,342,610,342
15350,10/6/2012,4,1,10,18,0,6,0,1,0.52,0.5,0.48,0.4179,183,312,495,312
15351,10/6/2012,4,1,10,19,0,6,0,1,0.48,0.4697,0.55,0.2239,102,239,341,239
15352,10/6/2012,4,1,10,20,0,6,0,1,0.48,0.4697,0.55,0.2537,75,172,247,172
15353,10/6/2012,4,1,10,21,0,6,0,1,0.46,0.4545,0.59,0.1343,78,137,215,137
15354,10/6/2012,4,1,10,22,0,6,0,1,0.44,0.4394,0.62,0.1343,45,140,185,140
15355,10/6/2012,4,1,10,23,0,6,0,1,0.44,0.4394,0.62,0.1343,37,142,179,142
15356,10/7/2012,4,1,10,0,0,0,0,1,0.44,0.4394,0.62,0.1642,28,99,127,99
15357,10/7/2012,4,1,10,1,0,0,0,1,0.44,0.4394,0.54,0.2239,29,80,109,80
15358,10/7/2012,4,1,10,2,0,0,0,1,0.42,0.4242,0.62,0.1343,10,64,74,64
15359,10/7/2012,4,1,10,3,0,0,0,2,0.44,0.4394,0.62,0.1343,5,17,22,17
15360,10/7/2012,4,1,10,4,0,0,0,2,0.44,0.4394,0.54,0.2537,5,6,11,6
15361,10/7/2012,4,1,10,5,0,0,0,2,0.44,0.4394,0.54,0.1343,2,8,10,8
15362,10/7/2012,4,1,10,6,0,0,0,2,0.44,0.4394,0.54,0.194,4,19,23,19
15363,10/7/2012,4,1,10,7,0,0,0,3,0.42,0.4242,0.58,0.1642,6,29,35,29
15364,10/7/2012,4,1,10,8,0,0,0,3,0.42,0.4242,0.67,0.1343,11,51,62,51
15365,10/7/2012,4,1,10,9,0,0,0,3,0.4,0.4091,0.71,0.1343,16,70,86,70
15366,10/7/2012,4,1,10,10,0,0,0,2,0.42,0.4242,0.67,0.194,41,144,185,144
15367,10/7/2012,4,1,10,11,0,0,0,2,0.42,0.4242,0.71,0.1045,76,260,336,260
15368,10/7/2012,4,1,10,12,0,0,0,2,0.42,0.4242,0.71,0,100,292,392,292
15369,10/7/2012,4,1,10,13,0,0,0,2,0.44,0.4394,0.72,0.0896,80,240,320,240
15370,10/7/2012,4,1,10,14,0,0,0,2,0.44,0.4394,0.67,0,71,243,314,243
15371,10/7/2012,4,1,10,15,0,0,0,3,0.42,0.4242,0.77,0.1343,74,232,306,232
15372,10/7/2012,4,1,10,16,0,0,0,3,0.4,0.4091,0.82,0.1642,87,246,333,246
15373,10/7/2012,4,1,10,17,0,0,0,3,0.4,0.4091,0.82,0.2239,35,122,157,122
15374,10/7/2012,4,1,10,18,0,0,0,3,0.4,0.4091,0.82,0.194,24,82,106,82
15375,10/7/2012,4,1,10,19,0,0,0,2,0.4,0.4091,0.82,0.1045,17,97,114,97
15376,10/7/2012,4,1,10,20,0,0,0,1,0.4,0.4091,0.82,0.1343,19,97,116,97
15377,10/7/2012,4,1,10,21,0,0,0,1,0.38,0.3939,0.87,0.1045,22,91,113,91
15378,10/7/2012,4,1,10,22,0,0,0,1,0.38,0.3939,0.87,0.1343,7,72,79,72
15379,10/7/2012,4,1,10,23,0,0,0,1,0.36,0.3485,0.93,0.1343,12,68,80,68
15380,10/8/2012,4,1,10,0,1,1,0,1,0.38,0.3939,0.76,0.2836,7,44,51,44
15381,10/8/2012,4,1,10,1,1,1,0,1,0.34,0.3333,0.87,0.1642,2,35,37,35
15382,10/8/2012,4,1,10,2,1,1,0,1,0.34,0.3333,0.81,0.194,3,12,15,12
15383,10/8/2012,4,1,10,3,1,1,0,1,0.34,0.3485,0.81,0.1045,2,8,10,8
15384,10/8/2012,4,1,10,4,1,1,0,1,0.32,0.3333,0.87,0.1343,1,6,7,6
15385,10/8/2012,4,1,10,5,1,1,0,1,0.34,0.3182,0.76,0.2239,2,17,19,17
15386,10/8/2012,4,1,10,6,1,1,0,1,0.34,0.3485,0.76,0.1045,5,54,59,54
15387,10/8/2012,4,1,10,7,1,1,0,2,0.34,0.3333,0.76,0.1642,3,151,154,151
15388,10/8/2012,4,1,10,8,1,1,0,2,0.36,0.3485,0.71,0.2239,23,374,397,374
15389,10/8/2012,4,1,10,9,1,1,0,2,0.38,0.3939,0.66,0.1642,59,273,332,273
15390,10/8/2012,4,1,10,10,1,1,0,2,0.38,0.3939,0.68,0.1343,69,229,298,229
15391,10/8/2012,4,1,10,11,1,1,0,2,0.4,0.4091,0.62,0.0896,72,236,308,236
15392,10/8/2012,4,1,10,12,1,1,0,2,0.42,0.4242,0.63,0.1642,74,267,341,267
15393,10/8/2012,4,1,10,13,1,1,0,2,0.42,0.4242,0.62,0.194,82,323,405,323
15394,10/8/2012,4,1,10,14,1,1,0,2,0.42,0.4242,0.58,0.1045,121,299,420,299
15395,10/8/2012,4,1,10,15,1,1,0,3,0.42,0.4242,0.58,0.194,76,294,370,294
15396,10/8/2012,4,1,10,16,1,1,0,3,0.42,0.4242,0.58,0.194,61,316,377,316
15397,10/8/2012,4,1,10,17,1,1,0,2,0.42,0.4242,0.66,0.2537,81,416,497,416
15398,10/8/2012,4,1,10,18,1,1,0,2,0.42,0.4242,0.66,0.2836,41,415,456,415
15399,10/8/2012,4,1,10,19,1,1,0,2,0.4,0.4091,0.71,0.2537,38,333,371,333
15400,10/8/2012,4,1,10,20,1,1,0,3,0.4,0.4091,0.71,0.2239,20,207,227,207
15401,10/8/2012,4,1,10,21,1,1,0,2,0.4,0.4091,0.76,0.2239,17,134,151,134
15402,10/8/2012,4,1,10,22,1,1,0,3,0.4,0.4091,0.76,0.2537,6,101,107,101
15403,10/8/2012,4,1,10,23,1,1,0,2,0.4,0.4091,0.71,0.2239,9,60,69,60
15404,10/9/2012,4,1,10,0,0,2,1,2,0.38,0.3939,0.82,0.2239,9,22,31,22
15405,10/9/2012,4,1,10,1,0,2,1,3,0.36,0.3485,0.87,0.2239,0,13,13,13
15406,10/9/2012,4,1,10,2,0,2,1,3,0.36,0.3333,0.87,0.2537,2,5,7,5
15407,10/9/2012,4,1,10,3,0,2,1,3,0.36,0.3333,0.87,0.2836,0,3,3,3
15408,10/9/2012,4,1,10,4,0,2,1,3,0.36,0.3485,0.87,0.1642,1,6,7,6
15409,10/9/2012,4,1,10,5,0,2,1,2,0.38,0.3939,0.82,0.194,0,19,19,19
15410,10/9/2012,4,1,10,6,0,2,1,2,0.38,0.3939,0.82,0.2537,2,141,143,141
15411,10/9/2012,4,1,10,7,0,2,1,1,0.38,0.3939,0.83,0.2537,5,357,362,357
15412,10/9/2012,4,1,10,8,0,2,1,2,0.42,0.4242,0.8,0.194,15,698,713,698
15413,10/9/2012,4,1,10,9,0,2,1,2,0.42,0.4242,0.77,0.2239,37,345,382,345
15414,10/9/2012,4,1,10,10,0,2,1,2,0.44,0.4394,0.75,0.2239,33,131,164,131
15415,10/9/2012,4,1,10,11,0,2,1,2,0.48,0.4697,0.69,0.194,37,156,193,156
15416,10/9/2012,4,1,10,12,0,2,1,2,0.48,0.4697,0.69,0.194,43,217,260,217
15417,10/9/2012,4,1,10,13,0,2,1,2,0.5,0.4848,0.67,0.1343,54,184,238,184
15418,10/9/2012,4,1,10,14,0,2,1,2,0.54,0.5152,0.64,0.194,43,201,244,201
15419,10/9/2012,4,1,10,15,0,2,1,2,0.52,0.5,0.63,0.1642,59,195,254,195
15420,10/9/2012,4,1,10,16,0,2,1,2,0.5,0.4848,0.72,0.1642,70,354,424,354
15421,10/9/2012,4,1,10,17,0,2,1,2,0.52,0.5,0.68,0.1642,73,733,806,733
15422,10/9/2012,4,1,10,18,0,2,1,2,0.5,0.4848,0.72,0.2239,26,758,784,758
15423,10/9/2012,4,1,10,19,0,2,1,2,0.5,0.4848,0.72,0.1642,31,483,514,483
15424,10/9/2012,4,1,10,20,0,2,1,2,0.5,0.4848,0.72,0.1642,30,330,360,330
15425,10/9/2012,4,1,10,21,0,2,1,2,0.48,0.4697,0.77,0.1343,16,209,225,209
15426,10/9/2012,4,1,10,22,0,2,1,2,0.48,0.4697,0.77,0.0896,7,155,162,155
15427,10/9/2012,4,1,10,23,0,2,1,2,0.48,0.4697,0.77,0.0896,8,76,84,76
15428,10/10/2012,4,1,10,0,0,3,1,2,0.46,0.4545,0.88,0.0896,0,33,33,33
15429,10/10/2012,4,1,10,1,0,3,1,2,0.46,0.4545,0.88,0,2,6,8,6
15430,10/10/2012,4,1,10,2,0,3,1,2,0.46,0.4545,0.88,0,2,6,8,6
15431,10/10/2012,4,1,10,3,0,3,1,2,0.46,0.4545,0.88,0,0,6,6,6
15432,10/10/2012,4,1,10,4,0,3,1,2,0.46,0.4545,0.88,0.1045,0,6,6,6
15433,10/10/2012,4,1,10,5,0,3,1,2,0.46,0.4545,0.88,0.0896,2,38,40,38
15434,10/10/2012,4,1,10,6,0,3,1,2,0.46,0.4545,0.88,0.0896,3,172,175,172
15435,10/10/2012,4,1,10,7,0,3,1,1,0.46,0.4545,0.82,0.1045,9,498,507,498
15436,10/10/2012,4,1,10,8,0,3,1,1,0.5,0.4848,0.77,0.1642,33,806,839,806
15437,10/10/2012,4,1,10,9,0,3,1,1,0.54,0.5152,0.6,0.2836,35,331,366,331
15438,10/10/2012,4,1,10,10,0,3,1,1,0.56,0.5303,0.52,0.2985,27,190,217,190
15439,10/10/2012,4,1,10,11,0,3,1,1,0.54,0.5152,0.52,0.194,53,238,291,238
15440,10/10/2012,4,1,10,12,0,3,1,1,0.54,0.5152,0.56,0.2239,78,312,390,312
15441,10/10/2012,4,1,10,13,0,3,1,1,0.56,0.5303,0.49,0,60,237,297,237
15442,10/10/2012,4,1,10,14,0,3,1,1,0.6,0.6212,0.4,0.1642,63,208,271,208
15443,10/10/2012,4,1,10,15,0,3,1,1,0.6,0.6212,0.4,0.1642,58,261,319,261
15444,10/10/2012,4,1,10,16,0,3,1,1,0.6,0.6212,0.4,0.2239,92,474,566,474
15445,10/10/2012,4,1,10,17,0,3,1,1,0.58,0.5455,0.43,0.2239,91,857,948,857
15446,10/10/2012,4,1,10,18,0,3,1,2,0.56,0.5303,0.49,0.1642,57,787,844,787
15447,10/10/2012,4,1,10,19,0,3,1,2,0.56,0.5303,0.46,0.5821,32,534,566,534
15448,10/10/2012,4,1,10,20,0,3,1,1,0.52,0.5,0.48,0.4925,21,371,392,371
15449,10/10/2012,4,1,10,21,0,3,1,1,0.5,0.4848,0.51,0.3582,18,251,269,251
15450,10/10/2012,4,1,10,22,0,3,1,1,0.46,0.4545,0.55,0.2985,27,170,197,170
15451,10/10/2012,4,1,10,23,0,3,1,1,0.44,0.4394,0.58,0.194,17,119,136,119
15452,10/11/2012,4,1,10,0,0,4,1,1,0.44,0.4394,0.51,0.1343,1,41,42,41
15453,10/11/2012,4,1,10,1,0,4,1,1,0.44,0.4394,0.47,0.194,1,10,11,10
15454,10/11/2012,4,1,10,2,0,4,1,1,0.42,0.4242,0.5,0.1343,4,7,11,7
15455,10/11/2012,4,1,10,3,0,4,1,1,0.42,0.4242,0.47,0.2985,0,3,3,3
15456,10/11/2012,4,1,10,4,0,4,1,1,0.4,0.4091,0.5,0.2537,0,10,10,10
15457,10/11/2012,4,1,10,5,0,4,1,1,0.36,0.3485,0.5,0.1642,0,42,42,42
15458,10/11/2012,4,1,10,6,0,4,1,1,0.36,0.3485,0.5,0.1642,1,158,159,158
15459,10/11/2012,4,1,10,7,0,4,1,1,0.36,0.3333,0.5,0.2537,11,467,478,467
15460,10/11/2012,4,1,10,8,0,4,1,1,0.38,0.3939,0.46,0.3881,25,773,798,773
15461,10/11/2012,4,1,10,9,0,4,1,1,0.4,0.4091,0.43,0.3881,27,328,355,328
15462,10/11/2012,4,1,10,10,0,4,1,1,0.44,0.4394,0.41,0.3582,39,165,204,165
15463,10/11/2012,4,1,10,11,0,4,1,1,0.46,0.4545,0.36,0,76,175,251,175
15464,10/11/2012,4,1,10,12,0,4,1,1,0.46,0.4545,0.36,0,47,279,326,279
15465,10/11/2012,4,1,10,13,0,4,1,1,0.5,0.4848,0.31,0.1045,48,243,291,243
15466,10/11/2012,4,1,10,14,0,4,1,1,0.52,0.5,0.32,0.0896,78,270,348,270
15467,10/11/2012,4,1,10,15,0,4,1,1,0.52,0.5,0.34,0.1642,102,358,460,358
15468,10/11/2012,4,1,10,16,0,4,1,1,0.5,0.4848,0.36,0.1343,68,413,481,413
15469,10/11/2012,4,1,10,17,0,4,1,1,0.5,0.4848,0.39,0.2836,90,737,827,737
15470,10/11/2012,4,1,10,18,0,4,1,1,0.46,0.4545,0.44,0.1642,64,628,692,628
15471,10/11/2012,4,1,10,19,0,4,1,1,0.44,0.4394,0.51,0.1343,81,662,743,662
15472,10/11/2012,4,1,10,20,0,4,1,1,0.42,0.4242,0.62,0.1642,27,388,415,388
15473,10/11/2012,4,1,10,21,0,4,1,1,0.42,0.4242,0.62,0.1343,24,236,260,236
15474,10/11/2012,4,1,10,22,0,4,1,1,0.4,0.4091,0.66,0.1642,10,167,177,167
15475,10/11/2012,4,1,10,23,0,4,1,1,0.42,0.4242,0.58,0.0896,10,176,186,176
15476,10/12/2012,4,1,10,0,0,5,1,1,0.4,0.4091,0.66,0.1045,8,60,68,60
15477,10/12/2012,4,1,10,1,0,5,1,1,0.4,0.4091,0.66,0.0896,8,29,37,29
15478,10/12/2012,4,1,10,2,0,5,1,1,0.4,0.4091,0.66,0.0896,0,16,16,16
15479,10/12/2012,4,1,10,3,0,5,1,1,0.36,0.3636,0.76,0.0896,0,6,6,6
15480,10/12/2012,4,1,10,4,0,5,1,1,0.36,0.3636,0.76,0.1045,0,8,8,8
15481,10/12/2012,4,1,10,5,0,5,1,1,0.36,0.3636,0.81,0.0896,2,33,35,33
15482,10/12/2012,4,1,10,6,0,5,1,1,0.34,0.3485,0.81,0.0896,3,140,143,140
15483,10/12/2012,4,1,10,7,0,5,1,1,0.36,0.3636,0.81,0.0896,8,384,392,384
15484,10/12/2012,4,1,10,8,0,5,1,1,0.42,0.4242,0.71,0.0896,34,711,745,711
15485,10/12/2012,4,1,10,9,0,5,1,1,0.5,0.4848,0.39,0.2985,26,374,400,374
15486,10/12/2012,4,1,10,10,0,5,1,1,0.52,0.5,0.36,0.2985,75,200,275,200
15487,10/12/2012,4,1,10,11,0,5,1,1,0.54,0.5152,0.37,0.3582,61,252,313,252
15488,10/12/2012,4,1,10,12,0,5,1,1,0.54,0.5152,0.39,0.4627,75,312,387,312
15489,10/12/2012,4,1,10,13,0,5,1,1,0.56,0.5303,0.37,0.3881,81,300,381,300
15490,10/12/2012,4,1,10,14,0,5,1,1,0.56,0.5303,0.37,0.4627,109,262,371,262
15491,10/12/2012,4,1,10,15,0,5,1,1,0.52,0.5,0.42,0.4478,138,317,455,317
15492,10/12/2012,4,1,10,16,0,5,1,1,0.46,0.4545,0.41,0.3582,108,412,520,412
15493,10/12/2012,4,1,10,17,0,5,1,1,0.46,0.4545,0.38,0.3881,131,706,837,706
15494,10/12/2012,4,1,10,18,0,5,1,1,0.44,0.4394,0.38,0.2985,76,566,642,566
15495,10/12/2012,4,1,10,19,0,5,1,1,0.42,0.4242,0.41,0.2239,40,453,493,453
15496,10/12/2012,4,1,10,20,0,5,1,1,0.42,0.4242,0.47,0.1343,28,280,308,280
15497,10/12/2012,4,1,10,21,0,5,1,1,0.4,0.4091,0.54,0.194,21,169,190,169
15498,10/12/2012,4,1,10,22,0,5,1,1,0.4,0.4091,0.47,0.2985,17,143,160,143
15499,10/12/2012,4,1,10,23,0,5,1,1,0.36,0.3485,0.57,0.194,11,89,100,89
15500,10/13/2012,4,1,10,0,0,6,0,1,0.36,0.3636,0.57,0.0896,31,218,249,218
15501,10/13/2012,4,1,10,1,0,6,0,1,0.34,0.3333,0.53,0.1343,23,123,146,123
15502,10/13/2012,4,1,10,2,0,6,0,1,0.34,0.3333,0.53,0.194,7,60,67,60
15503,10/13/2012,4,1,10,3,0,6,0,1,0.32,0.303,0.66,0.2239,2,13,15,13
15504,10/13/2012,4,1,10,4,0,6,0,1,0.3,0.303,0.65,0.1642,2,9,11,9
15505,10/13/2012,4,1,10,5,0,6,0,1,0.3,0.2879,0.61,0.194,0,11,11,11
15506,10/13/2012,4,1,10,6,0,6,0,1,0.3,0.2879,0.61,0.194,5,23,28,23
15507,10/13/2012,4,1,10,7,0,6,0,1,0.3,0.303,0.61,0.1642,10,60,70,60
15508,10/13/2012,4,1,10,8,0,6,0,1,0.34,0.3485,0.53,0.1045,23,151,174,151
15509,10/13/2012,4,1,10,9,0,6,0,1,0.36,0.3636,0.5,0.0896,46,220,266,220
15510,10/13/2012,4,1,10,10,0,6,0,1,0.4,0.4091,0.43,0,82,265,347,265
15511,10/13/2012,4,1,10,11,0,6,0,1,0.42,0.4242,0.35,0.1343,192,335,527,335
15512,10/13/2012,4,1,10,12,0,6,0,1,0.44,0.4394,0.35,0,202,371,573,371
15513,10/13/2012,4,1,10,13,0,6,0,1,0.46,0.4545,0.36,0.194,235,435,670,435
15514,10/13/2012,4,1,10,14,0,6,0,1,0.48,0.4697,0.33,0.194,243,354,597,354
15515,10/13/2012,4,1,10,15,0,6,0,1,0.5,0.4848,0.36,0.194,251,364,615,364
15516,10/13/2012,4,1,10,16,0,6,0,1,0.5,0.4848,0.31,0.194,294,343,637,343
15517,10/13/2012,4,1,10,17,0,6,0,1,0.46,0.4545,0.38,0.1642,193,335,528,335
15518,10/13/2012,4,1,10,18,0,6,0,1,0.46,0.4545,0.44,0.1343,174,299,473,299
15519,10/13/2012,4,1,10,19,0,6,0,1,0.44,0.4394,0.44,0.1642,73,259,332,259
15520,10/13/2012,4,1,10,20,0,6,0,1,0.4,0.4091,0.54,0.0896,57,198,255,198
15521,10/13/2012,4,1,10,21,0,6,0,1,0.4,0.4091,0.58,0.194,47,157,204,157
15522,10/13/2012,4,1,10,22,0,6,0,1,0.4,0.4091,0.62,0,33,156,189,156
15523,10/13/2012,4,1,10,23,0,6,0,1,0.42,0.4242,0.58,0.2985,27,98,125,98
15524,10/14/2012,4,1,10,0,0,0,0,1,0.4,0.4091,0.71,0.2537,8,103,111,103
15525,10/14/2012,4,1,10,1,0,0,0,1,0.42,0.4242,0.77,0.2836,16,96,112,96
15526,10/14/2012,4,1,10,2,0,0,0,1,0.4,0.4091,0.76,0.0896,8,58,66,58
15527,10/14/2012,4,1,10,3,0,0,0,1,0.42,0.4242,0.77,0.2985,3,25,28,25
15528,10/14/2012,4,1,10,4,0,0,0,1,0.42,0.4242,0.77,0.2836,2,10,12,10
15529,10/14/2012,4,1,10,5,0,0,0,1,0.4,0.4091,0.82,0.194,5,6,11,6
15530,10/14/2012,4,1,10,6,0,0,0,1,0.4,0.4091,0.82,0.1642,4,20,24,20
15531,10/14/2012,4,1,10,7,0,0,0,1,0.42,0.4242,0.82,0.2239,7,44,51,44
15532,10/14/2012,4,1,10,8,0,0,0,1,0.44,0.4394,0.77,0.194,28,104,132,104
15533,10/14/2012,4,1,10,9,0,0,0,2,0.48,0.4697,0.67,0.2836,62,161,223,161
15534,10/14/2012,4,1,10,10,0,0,0,1,0.54,0.5152,0.56,0.194,150,278,428,278
15535,10/14/2012,4,1,10,11,0,0,0,1,0.56,0.5303,0.52,0.2985,156,338,494,338
15536,10/14/2012,4,1,10,12,0,0,0,1,0.62,0.6212,0.46,0.3284,200,362,562,362
15537,10/14/2012,4,1,10,13,0,0,0,1,0.64,0.6212,0.41,0.4478,218,401,619,401
15538,10/14/2012,4,1,10,14,0,0,0,1,0.66,0.6212,0.39,0.4179,249,368,617,368
15539,10/14/2012,4,1,10,15,0,0,0,1,0.66,0.6212,0.39,0.4179,213,355,568,355
15540,10/14/2012,4,1,10,16,0,0,0,1,0.64,0.6212,0.41,0.2985,203,378,581,378
15541,10/14/2012,4,1,10,17,0,0,0,1,0.64,0.6212,0.44,0.194,193,346,539,346
15542,10/14/2012,4,1,10,18,0,0,0,1,0.58,0.5455,0.6,0.2537,134,319,453,319
15543,10/14/2012,4,1,10,19,0,0,0,1,0.56,0.5303,0.64,0.2239,68,268,336,268
15544,10/14/2012,4,1,10,20,0,0,0,1,0.54,0.5152,0.73,0.2239,48,198,246,198
15545,10/14/2012,4,1,10,21,0,0,0,1,0.56,0.5303,0.73,0.4478,40,156,196,156
15546,10/14/2012,4,1,10,22,0,0,0,1,0.56,0.5303,0.73,0.3881,38,87,125,87
15547,10/14/2012,4,1,10,23,0,0,0,2,0.56,0.5303,0.68,0.2836,27,78,105,78
15548,10/15/2012,4,1,10,0,0,1,1,2,0.56,0.5303,0.73,0.2537,17,31,48,31
15549,10/15/2012,4,1,10,1,0,1,1,2,0.58,0.5455,0.64,0.3881,5,24,29,24
15550,10/15/2012,4,1,10,2,0,1,1,2,0.58,0.5455,0.64,0.3582,1,5,6,5
15551,10/15/2012,4,1,10,3,0,1,1,2,0.56,0.5303,0.73,0.2537,2,2,4,2
15552,10/15/2012,4,1,10,4,0,1,1,2,0.56,0.5303,0.68,0.2239,1,9,10,9
15553,10/15/2012,4,1,10,5,0,1,1,2,0.56,0.5303,0.73,0.2836,2,38,40,38
15554,10/15/2012,4,1,10,6,0,1,1,2,0.56,0.5303,0.73,0.2985,6,141,147,141
15555,10/15/2012,4,1,10,7,0,1,1,2,0.58,0.5455,0.68,0.3284,15,461,476,461
15556,10/15/2012,4,1,10,8,0,1,1,2,0.6,0.6061,0.64,0.3881,24,713,737,713
15557,10/15/2012,4,1,10,9,0,1,1,3,0.6,0.5909,0.69,0.3881,31,328,359,328
15558,10/15/2012,4,1,10,10,0,1,1,2,0.6,0.5909,0.73,0.3881,43,125,168,125
15559,10/15/2012,4,1,10,11,0,1,1,2,0.6,0.5909,0.73,0.3881,88,175,263,175
15560,10/15/2012,4,1,10,12,0,1,1,3,0.6,0.5758,0.78,0.3284,73,211,284,211
15561,10/15/2012,4,1,10,13,0,1,1,2,0.56,0.5303,0.88,0.2239,37,109,146,109
15562,10/15/2012,4,1,10,14,0,1,1,2,0.6,0.5758,0.78,0.2836,57,128,185,128
15563,10/15/2012,4,1,10,15,0,1,1,1,0.6,0.5758,0.78,0.3284,70,190,260,190
15564,10/15/2012,4,1,10,16,0,1,1,1,0.56,0.5303,0.64,0.2985,76,371,447,371
15565,10/15/2012,4,1,10,17,0,1,1,1,0.56,0.5303,0.64,0.2537,96,670,766,670
15566,10/15/2012,4,1,10,18,0,1,1,3,0.54,0.5152,0.77,0.1343,52,540,592,540
15567,10/15/2012,4,1,10,19,0,1,1,3,0.52,0.5,0.83,0.0896,12,227,239,227
15568,10/15/2012,4,1,10,20,0,1,1,2,0.52,0.5,0.72,0.3881,19,237,256,237
15569,10/15/2012,4,1,10,21,0,1,1,1,0.52,0.5,0.59,0.3284,16,190,206,190
15570,10/15/2012,4,1,10,22,0,1,1,1,0.5,0.4848,0.59,0.2836,8,118,126,118
15571,10/15/2012,4,1,10,23,0,1,1,1,0.46,0.4545,0.63,0.2239,9,72,81,72
15572,10/16/2012,4,1,10,0,0,2,1,1,0.46,0.4545,0.63,0.3881,3,45,48,45
15573,10/16/2012,4,1,10,1,0,2,1,1,0.44,0.4394,0.67,0.194,4,9,13,9
15574,10/16/2012,4,1,10,2,0,2,1,1,0.44,0.4394,0.67,0.1343,2,1,3,1
15575,10/16/2012,4,1,10,3,0,2,1,1,0.42,0.4242,0.67,0.1045,0,2,2,2
15576,10/16/2012,4,1,10,4,0,2,1,1,0.42,0.4242,0.67,0.1642,0,7,7,7
15577,10/16/2012,4,1,10,5,0,2,1,1,0.42,0.4242,0.67,0.2537,5,47,52,47
15578,10/16/2012,4,1,10,6,0,2,1,1,0.42,0.4242,0.67,0.1642,4,168,172,168
15579,10/16/2012,4,1,10,7,0,2,1,1,0.42,0.4242,0.67,0.0896,20,505,525,505
15580,10/16/2012,4,1,10,8,0,2,1,1,0.44,0.4394,0.62,0,35,800,835,800
15581,10/16/2012,4,1,10,9,0,2,1,1,0.48,0.4697,0.55,0.2537,32,323,355,323
15582,10/16/2012,4,1,10,10,0,2,1,1,0.5,0.4848,0.48,0.2836,65,157,222,157
15583,10/16/2012,4,1,10,11,0,2,1,1,0.5,0.4848,0.45,0.4179,56,172,228,172
15584,10/16/2012,4,1,10,12,0,2,1,2,0.52,0.5,0.45,0.3284,69,256,325,256
15585,10/16/2012,4,1,10,13,0,2,1,1,0.52,0.5,0.45,0.2836,68,260,328,260
15586,10/16/2012,4,1,10,14,0,2,1,1,0.54,0.5152,0.39,0.2537,94,214,308,214
15587,10/16/2012,4,1,10,15,0,2,1,1,0.54,0.5152,0.41,0.3284,76,270,346,270
15588,10/16/2012,4,1,10,16,0,2,1,1,0.54,0.5152,0.39,0.2836,79,367,446,367
15589,10/16/2012,4,1,10,17,0,2,1,1,0.52,0.5,0.39,0.194,104,839,943,839
15590,10/16/2012,4,1,10,18,0,2,1,1,0.5,0.4848,0.42,0.1642,71,767,838,767
15591,10/16/2012,4,1,10,19,0,2,1,1,0.48,0.4697,0.48,0,40,491,531,491
15592,10/16/2012,4,1,10,20,0,2,1,1,0.46,0.4545,0.55,0,35,397,432,397
15593,10/16/2012,4,1,10,21,0,2,1,1,0.46,0.4545,0.63,0,19,176,195,176
15594,10/16/2012,4,1,10,22,0,2,1,1,0.4,0.4091,0.71,0.0896,18,163,181,163
15595,10/16/2012,4,1,10,23,0,2,1,1,0.4,0.4091,0.71,0,23,176,199,176
15596,10/17/2012,4,1,10,0,0,3,1,1,0.38,0.3939,0.76,0,1,48,49,48
15597,10/17/2012,4,1,10,1,0,3,1,1,0.38,0.3939,0.76,0,3,14,17,14
15598,10/17/2012,4,1,10,2,0,3,1,1,0.38,0.3939,0.76,0,4,12,16,12
15599,10/17/2012,4,1,10,3,0,3,1,1,0.36,0.3788,0.87,0,0,7,7,7
15600,10/17/2012,4,1,10,4,0,3,1,1,0.36,0.3636,0.81,0.0896,0,4,4,4
15601,10/17/2012,4,1,10,5,0,3,1,2,0.36,0.3788,0.81,0,2,39,41,39
15602,10/17/2012,4,1,10,6,0,3,1,1,0.38,0.3939,0.82,0,7,171,178,171
15603,10/17/2012,4,1,10,7,0,3,1,1,0.36,0.3636,0.81,0.1045,15,449,464,449
15604,10/17/2012,4,1,10,8,0,3,1,2,0.4,0.4091,0.76,0,38,779,817,779
15605,10/17/2012,4,1,10,9,0,3,1,2,0.42,0.4242,0.77,0,38,344,382,344
15606,10/17/2012,4,1,10,10,0,3,1,2,0.46,0.4545,0.67,0,60,168,228,168
15607,10/17/2012,4,1,10,11,0,3,1,2,0.5,0.4848,0.51,0.0896,78,156,234,156
15608,10/17/2012,4,1,10,12,0,3,1,2,0.52,0.5,0.48,0.1642,71,261,332,261
15609,10/17/2012,4,1,10,13,0,3,1,2,0.54,0.5152,0.49,0.1343,73,237,310,237
15610,10/17/2012,4,1,10,14,0,3,1,2,0.56,0.5303,0.43,0.1642,82,188,270,188
15611,10/17/2012,4,1,10,15,0,3,1,2,0.58,0.5455,0.43,0.2239,62,239,301,239
15612,10/17/2012,4,1,10,16,0,3,1,1,0.56,0.5303,0.52,0.194,70,396,466,396
15613,10/17/2012,4,1,10,17,0,3,1,1,0.54,0.5152,0.56,0.1045,122,766,888,766
15614,10/17/2012,4,1,10,18,0,3,1,1,0.52,0.5,0.59,0.1642,90,794,884,794
15615,10/17/2012,4,1,10,19,0,3,1,1,0.5,0.4848,0.72,0.194,49,467,516,467
15616,10/17/2012,4,1,10,20,0,3,1,1,0.5,0.4848,0.72,0.1343,54,360,414,360
15617,10/17/2012,4,1,10,21,0,3,1,1,0.46,0.4545,0.82,0.194,28,301,329,301
15618,10/17/2012,4,1,10,22,0,3,1,1,0.46,0.4545,0.88,0.2537,17,198,215,198
15619,10/17/2012,4,1,10,23,0,3,1,1,0.46,0.4545,0.88,0.2239,15,84,99,84
15620,10/18/2012,4,1,10,0,0,4,1,1,0.46,0.4545,0.88,0.194,4,53,57,53
15621,10/18/2012,4,1,10,1,0,4,1,1,0.46,0.4545,0.82,0.2239,0,14,14,14
15622,10/18/2012,4,1,10,2,0,4,1,1,0.46,0.4545,0.82,0.194,1,13,14,13
15623,10/18/2012,4,1,10,3,0,4,1,1,0.44,0.4394,0.88,0.2239,0,5,5,5
15624,10/18/2012,4,1,10,4,0,4,1,1,0.44,0.4394,0.88,0.2239,0,5,5,5
15625,10/18/2012,4,1,10,5,0,4,1,1,0.44,0.4394,0.82,0.2239,1,41,42,41
15626,10/18/2012,4,1,10,6,0,4,1,1,0.44,0.4394,0.88,0.2985,3,150,153,150
15627,10/18/2012,4,1,10,7,0,4,1,1,0.44,0.4394,0.88,0.2537,20,488,508,488
15628,10/18/2012,4,1,10,8,0,4,1,1,0.46,0.4545,0.82,0.2537,31,803,834,803
15629,10/18/2012,4,1,10,9,0,4,1,2,0.5,0.4848,0.77,0.1642,41,346,387,346
15630,10/18/2012,4,1,10,10,0,4,1,2,0.52,0.5,0.68,0.2239,60,158,218,158
15631,10/18/2012,4,1,10,11,0,4,1,2,0.56,0.5303,0.56,0.2239,79,189,268,189
15632,10/18/2012,4,1,10,12,0,4,1,2,0.6,0.6212,0.53,0.2537,93,284,377,284
15633,10/18/2012,4,1,10,13,0,4,1,1,0.62,0.6212,0.53,0.3582,96,236,332,236
15634,10/18/2012,4,1,10,14,0,4,1,2,0.62,0.6212,0.5,0.2985,94,191,285,191
15635,10/18/2012,4,1,10,15,0,4,1,2,0.6,0.6061,0.6,0.194,69,284,353,284
15636,10/18/2012,4,1,10,16,0,4,1,1,0.6,0.6212,0.56,0.2836,94,356,450,356
15637,10/18/2012,4,1,10,17,0,4,1,2,0.58,0.5455,0.64,0.3284,102,788,890,788
15638,10/18/2012,4,1,10,18,0,4,1,2,0.56,0.5303,0.64,0.3284,68,720,788,720
15639,10/18/2012,4,1,10,19,0,4,1,2,0.56,0.5303,0.68,0.2985,42,471,513,471
15640,10/18/2012,4,1,10,20,0,4,1,2,0.56,0.5303,0.68,0.2537,39,348,387,348
15641,10/18/2012,4,1,10,21,0,4,1,2,0.54,0.5152,0.77,0.194,38,245,283,245
15642,10/18/2012,4,1,10,22,0,4,1,2,0.54,0.5152,0.83,0.194,27,202,229,202
15643,10/18/2012,4,1,10,23,0,4,1,2,0.54,0.5152,0.83,0,6,111,117,111
15644,10/19/2012,4,1,10,0,0,5,1,2,0.56,0.5303,0.83,0.1045,5,51,56,51
15645,10/19/2012,4,1,10,1,0,5,1,3,0.54,0.5152,0.88,0,4,12,16,12
15646,10/19/2012,4,1,10,2,0,5,1,2,0.54,0.5152,0.88,0,1,9,10,9
15647,10/19/2012,4,1,10,3,0,5,1,2,0.56,0.5303,0.83,0,0,5,5,5
15648,10/19/2012,4,1,10,4,0,5,1,2,0.56,0.5303,0.83,0,1,5,6,5
15649,10/19/2012,4,1,10,5,0,5,1,2,0.54,0.5152,0.88,0,1,35,36,35
15650,10/19/2012,4,1,10,6,0,5,1,3,0.54,0.5152,0.94,0.1642,5,126,131,126
15651,10/19/2012,4,1,10,7,0,5,1,3,0.54,0.5152,0.94,0,5,149,154,149
15652,10/19/2012,4,1,10,8,0,5,1,2,0.54,0.5152,0.94,0.1045,20,447,467,447
15653,10/19/2012,4,1,10,9,0,5,1,2,0.54,0.5152,0.94,0.1045,26,363,389,363
15654,10/19/2012,4,1,10,10,0,5,1,2,0.58,0.5455,0.88,0.194,26,198,224,198
15655,10/19/2012,4,1,10,11,0,5,1,1,0.6,0.5606,0.83,0.194,41,211,252,211
15656,10/19/2012,4,1,10,12,0,5,1,1,0.64,0.6061,0.69,0.2239,74,258,332,258
15657,10/19/2012,4,1,10,13,0,5,1,1,0.62,0.5909,0.73,0.2239,87,288,375,288
15658,10/19/2012,4,1,10,14,0,5,1,1,0.66,0.6212,0.61,0.2537,88,277,365,277
15659,10/19/2012,4,1,10,15,0,5,1,1,0.64,0.6061,0.65,0.2985,93,302,395,302
15660,10/19/2012,4,1,10,16,0,5,1,3,0.62,0.6061,0.69,0.3582,131,434,565,434
15661,10/19/2012,4,1,10,17,0,5,1,3,0.62,0.6061,0.69,0.3582,48,377,425,377
15662,10/19/2012,4,1,10,18,0,5,1,1,0.56,0.5303,0.83,0.1045,21,212,233,212
15663,10/19/2012,4,1,10,19,0,5,1,1,0.54,0.5152,0.88,0.1642,19,213,232,213
15664,10/19/2012,4,1,10,20,0,5,1,1,0.52,0.5,0.77,0.194,13,216,229,216
15665,10/19/2012,4,1,10,21,0,5,1,1,0.5,0.4848,0.77,0,17,189,206,189
15666,10/19/2012,4,1,10,22,0,5,1,1,0.5,0.4848,0.77,0.0896,14,176,190,176
15667,10/19/2012,4,1,10,23,0,5,1,1,0.46,0.4545,0.88,0.1045,13,118,131,118
15668,10/20/2012,4,1,10,0,0,6,0,1,0.46,0.4545,0.82,0.1343,13,110,123,110
15669,10/20/2012,4,1,10,1,0,6,0,1,0.46,0.4545,0.72,0.1343,2,93,95,93
15670,10/20/2012,4,1,10,2,0,6,0,1,0.44,0.4394,0.77,0.1045,9,69,78,69
15671,10/20/2012,4,1,10,3,0,6,0,1,0.42,0.4242,0.77,0.1343,2,27,29,27
15672,10/20/2012,4,1,10,4,0,6,0,1,0.44,0.4394,0.72,0,9,9,18,9
15673,10/20/2012,4,1,10,5,0,6,0,1,0.4,0.4091,0.82,0,6,7,13,7
15674,10/20/2012,4,1,10,6,0,6,0,1,0.42,0.4242,0.71,0,5,26,31,26
15675,10/20/2012,4,1,10,7,0,6,0,1,0.4,0.4091,0.82,0,6,59,65,59
15676,10/20/2012,4,1,10,8,0,6,0,1,0.46,0.4545,0.67,0.1343,29,164,193,164
15677,10/20/2012,4,1,10,9,0,6,0,1,0.5,0.4848,0.59,0.1343,106,257,363,257
15678,10/20/2012,4,1,10,10,0,6,0,1,0.52,0.5,0.52,0.1343,111,312,423,312
15679,10/20/2012,4,1,10,11,0,6,0,1,0.54,0.5152,0.52,0.2239,204,408,612,408
15680,10/20/2012,4,1,10,12,0,6,0,1,0.56,0.5303,0.46,0.1045,267,436,703,436
15681,10/20/2012,4,1,10,13,0,6,0,1,0.56,0.5303,0.43,0.1642,273,441,714,441
15682,10/20/2012,4,1,10,14,0,6,0,1,0.56,0.5303,0.4,0,335,376,711,376
15683,10/20/2012,4,1,10,15,0,6,0,1,0.56,0.5303,0.43,0,308,403,711,403
15684,10/20/2012,4,1,10,16,0,6,0,1,0.54,0.5152,0.42,0.2836,325,366,691,366
15685,10/20/2012,4,1,10,17,0,6,0,1,0.54,0.5152,0.37,0.2239,347,384,731,384
15686,10/20/2012,4,1,10,18,0,6,0,1,0.52,0.5,0.39,0.2239,165,356,521,356
15687,10/20/2012,4,1,10,19,0,6,0,1,0.5,0.4848,0.45,0.1343,77,268,345,268
15688,10/20/2012,4,1,10,20,0,6,0,1,0.5,0.4848,0.39,0.2239,61,198,259,198
15689,10/20/2012,4,1,10,21,0,6,0,1,0.46,0.4545,0.47,0.2239,72,224,296,224
15690,10/20/2012,4,1,10,22,0,6,0,1,0.44,0.4394,0.51,0.1045,47,155,202,155
15691,10/20/2012,4,1,10,23,0,6,0,1,0.42,0.4242,0.58,0,27,136,163,136
15692,10/21/2012,4,1,10,0,0,0,0,1,0.44,0.4394,0.54,0.1642,35,119,154,119
15693,10/21/2012,4,1,10,1,0,0,0,1,0.42,0.4242,0.58,0.2239,20,97,117,97
15694,10/21/2012,4,1,10,2,0,0,0,1,0.4,0.4091,0.62,0.1642,44,88,132,88
15695,10/21/2012,4,1,10,3,0,0,0,1,0.38,0.3939,0.66,0.0896,12,29,41,29
15696,10/21/2012,4,1,10,4,0,0,0,1,0.36,0.3485,0.71,0.1642,8,13,21,13
15697,10/21/2012,4,1,10,5,0,0,0,1,0.38,0.3939,0.66,0.0896,6,4,10,4
15698,10/21/2012,4,1,10,6,0,0,0,1,0.4,0.4091,0.62,0,8,18,26,18
15699,10/21/2012,4,1,10,7,0,0,0,1,0.4,0.4091,0.62,0,13,43,56,43
15700,10/21/2012,4,1,10,8,0,0,0,1,0.42,0.4242,0.67,0,39,104,143,104
15701,10/21/2012,4,1,10,9,0,0,0,1,0.46,0.4545,0.55,0.1642,77,192,269,192
15702,10/21/2012,4,1,10,10,0,0,0,1,0.5,0.4848,0.48,0.2985,167,276,443,276
15703,10/21/2012,4,1,10,11,0,0,0,1,0.52,0.5,0.44,0.3284,191,356,547,356
15704,10/21/2012,4,1,10,12,0,0,0,1,0.54,0.5152,0.39,0.3284,236,439,675,439
15705,10/21/2012,4,1,10,13,0,0,0,1,0.56,0.5303,0.37,0.2537,243,383,626,383
15706,10/21/2012,4,1,10,14,0,0,0,1,0.56,0.5303,0.35,0.194,235,405,640,405
15707,10/21/2012,4,1,10,15,0,0,0,1,0.56,0.5303,0.35,0.3284,240,383,623,383
15708,10/21/2012,4,1,10,16,0,0,0,1,0.54,0.5152,0.37,0.2239,182,409,591,409
15709,10/21/2012,4,1,10,17,0,0,0,1,0.52,0.5,0.39,0.2537,153,338,491,338
15710,10/21/2012,4,1,10,18,0,0,0,1,0.52,0.5,0.39,0.194,71,342,413,342
15711,10/21/2012,4,1,10,19,0,0,0,1,0.5,0.4848,0.42,0.1642,50,216,266,216
15712,10/21/2012,4,1,10,20,0,0,0,1,0.48,0.4697,0.44,0.194,35,160,195,160
15713,10/21/2012,4,1,10,21,0,0,0,1,0.42,0.4242,0.54,0.1642,42,124,166,124
15714,10/21/2012,4,1,10,22,0,0,0,1,0.42,0.4242,0.54,0,18,95,113,95
15715,10/21/2012,4,1,10,23,0,0,0,1,0.44,0.4394,0.54,0,7,59,66,59
15716,10/22/2012,4,1,10,0,0,1,1,1,0.4,0.4091,0.62,0,3,28,31,28
15717,10/22/2012,4,1,10,1,0,1,1,1,0.4,0.4091,0.71,0,0,11,11,11
15718,10/22/2012,4,1,10,2,0,1,1,1,0.38,0.3939,0.71,0,1,4,5,4
15719,10/22/2012,4,1,10,3,0,1,1,1,0.4,0.4091,0.62,0,1,5,6,5
15720,10/22/2012,4,1,10,4,0,1,1,1,0.38,0.3939,0.66,0,1,6,7,6
15721,10/22/2012,4,1,10,5,0,1,1,1,0.38,0.3939,0.76,0.0896,2,44,46,44
15722,10/22/2012,4,1,10,6,0,1,1,1,0.36,0.3636,0.76,0.0896,4,140,144,140
15723,10/22/2012,4,1,10,7,0,1,1,1,0.38,0.3939,0.66,0.0896,15,437,452,437
15724,10/22/2012,4,1,10,8,0,1,1,1,0.44,0.4394,0.67,0,32,696,728,696
15725,10/22/2012,4,1,10,9,0,1,1,1,0.46,0.4545,0.63,0.0896,25,335,360,335
15726,10/22/2012,4,1,10,10,0,1,1,1,0.5,0.4848,0.55,0,51,161,212,161
15727,10/22/2012,4,1,10,11,0,1,1,1,0.56,0.5303,0.37,0.1642,63,148,211,148
15728,10/22/2012,4,1,10,12,0,1,1,1,0.58,0.5455,0.35,0,52,231,283,231
15729,10/22/2012,4,1,10,13,0,1,1,1,0.62,0.6212,0.29,0.1642,88,227,315,227
15730,10/22/2012,4,1,10,14,0,1,1,1,0.62,0.6061,0.27,0.194,73,209,282,209
15731,10/22/2012,4,1,10,15,0,1,1,1,0.64,0.6212,0.29,0.1642,74,222,296,222
15732,10/22/2012,4,1,10,16,0,1,1,1,0.62,0.6212,0.33,0.1642,80,444,524,444
15733,10/22/2012,4,1,10,17,0,1,1,1,0.62,0.6212,0.33,0.1045,84,838,922,838
15734,10/22/2012,4,1,10,18,0,1,1,1,0.54,0.5152,0.64,0.1045,60,726,786,726
15735,10/22/2012,4,1,10,19,0,1,1,1,0.52,0.5,0.52,0.1045,36,478,514,478
15736,10/22/2012,4,1,10,20,0,1,1,1,0.5,0.4848,0.59,0.1045,21,382,403,382
15737,10/22/2012,4,1,10,21,0,1,1,1,0.48,0.4697,0.67,0.0896,19,155,174,155
15738,10/22/2012,4,1,10,22,0,1,1,1,0.46,0.4545,0.82,0.1343,25,158,183,158
15739,10/22/2012,4,1,10,23,0,1,1,1,0.46,0.4545,0.82,0.1045,20,143,163,143
15740,10/23/2012,4,1,10,0,0,2,1,1,0.46,0.4545,0.88,0.1642,5,32,37,32
15741,10/23/2012,4,1,10,1,0,2,1,1,0.46,0.4545,0.77,0.1642,1,16,17,16
15742,10/23/2012,4,1,10,2,0,2,1,1,0.44,0.4394,0.88,0.1343,1,6,7,6
15743,10/23/2012,4,1,10,3,0,2,1,1,0.44,0.4394,0.77,0.1343,0,1,1,1
15744,10/23/2012,4,1,10,4,0,2,1,1,0.42,0.4242,0.77,0.1045,1,6,7,6
15745,10/23/2012,4,1,10,5,0,2,1,1,0.44,0.4394,0.77,0.0896,1,49,50,49
15746,10/23/2012,4,1,10,6,0,2,1,1,0.4,0.4091,0.82,0.0896,6,152,158,152
15747,10/23/2012,4,1,10,7,0,2,1,2,0.44,0.4394,0.77,0.1045,12,519,531,519
15748,10/23/2012,4,1,10,8,0,2,1,2,0.46,0.4545,0.72,0.0896,28,733,761,733
15749,10/23/2012,4,1,10,9,0,2,1,2,0.5,0.4848,0.72,0.1045,29,305,334,305
15750,10/23/2012,4,1,10,10,0,2,1,1,0.54,0.5152,0.6,0,50,171,221,171
15751,10/23/2012,4,1,10,11,0,2,1,1,0.6,0.6212,0.53,0,52,201,253,201
15752,10/23/2012,4,1,10,12,0,2,1,2,0.62,0.6212,0.46,0.0896,80,298,378,298
15753,10/23/2012,4,1,10,13,0,2,1,2,0.64,0.6212,0.44,0,59,244,303,244
15754,10/23/2012,4,1,10,14,0,2,1,1,0.68,0.6364,0.41,0.1642,67,229,296,229
15755,10/23/2012,4,1,10,15,0,2,1,1,0.68,0.6364,0.41,0.2239,76,270,346,270
15756,10/23/2012,4,1,10,16,0,2,1,1,0.68,0.6364,0.44,0.0896,108,433,541,433
15757,10/23/2012,4,1,10,17,0,2,1,1,0.68,0.6364,0.41,0,67,871,938,871
15758,10/23/2012,4,1,10,18,0,2,1,1,0.62,0.6212,0.53,0.0896,64,762,826,762
15759,10/23/2012,4,1,10,19,0,2,1,1,0.62,0.6212,0.57,0.0896,25,457,482,457
15760,10/23/2012,4,1,10,20,0,2,1,1,0.58,0.5455,0.64,0.1343,45,334,379,334
15761,10/23/2012,4,1,10,21,0,2,1,1,0.56,0.5303,0.68,0,35,260,295,260
15762,10/23/2012,4,1,10,22,0,2,1,1,0.56,0.5303,0.68,0.1045,20,174,194,174
15763,10/23/2012,4,1,10,23,0,2,1,1,0.54,0.5152,0.73,0.1045,9,102,111,102
15764,10/24/2012,4,1,10,0,0,3,1,1,0.54,0.5152,0.73,0.0896,7,39,46,39
15765,10/24/2012,4,1,10,1,0,3,1,1,0.54,0.5152,0.68,0,4,23,27,23
15766,10/24/2012,4,1,10,2,0,3,1,1,0.54,0.5152,0.68,0,0,6,6,6
15767,10/24/2012,4,1,10,3,0,3,1,1,0.5,0.4848,0.77,0.0896,0,4,4,4
15768,10/24/2012,4,1,10,4,0,3,1,1,0.5,0.4848,0.77,0.0896,1,5,6,5
15769,10/24/2012,4,1,10,5,0,3,1,1,0.5,0.4848,0.82,0,1,52,53,52
15770,10/24/2012,4,1,10,6,0,3,1,1,0.48,0.4697,0.82,0.1045,11,162,173,162
15771,10/24/2012,4,1,10,7,0,3,1,1,0.5,0.4848,0.88,0.0896,20,506,526,506
15772,10/24/2012,4,1,10,8,0,3,1,2,0.52,0.5,0.83,0.1045,24,777,801,777
15773,10/24/2012,4,1,10,9,0,3,1,2,0.52,0.5,0.77,0.0896,24,349,373,349
15774,10/24/2012,4,1,10,10,0,3,1,2,0.54,0.5152,0.73,0,29,142,171,142
15775,10/24/2012,4,1,10,11,0,3,1,1,0.58,0.5455,0.64,0,47,189,236,189
15776,10/24/2012,4,1,10,12,0,3,1,1,0.62,0.6061,0.61,0.0896,48,268,316,268
15777,10/24/2012,4,1,10,13,0,3,1,1,0.66,0.6212,0.54,0,65,241,306,241
15778,10/24/2012,4,1,10,14,0,3,1,1,0.74,0.6515,0.3,0.2537,64,237,301,237
15779,10/24/2012,4,1,10,15,0,3,1,1,0.7,0.6364,0.39,0.1045,63,245,308,245
15780,10/24/2012,4,1,10,16,0,3,1,1,0.74,0.6515,0.33,0.1343,67,465,532,465
15781,10/24/2012,4,1,10,17,0,3,1,1,0.66,0.6212,0.47,0,87,876,963,876
15782,10/24/2012,4,1,10,18,0,3,1,1,0.66,0.6212,0.44,0,63,795,858,795
15783,10/24/2012,4,1,10,19,0,3,1,2,0.64,0.6212,0.53,0.0896,50,522,572,522
15784,10/24/2012,4,1,10,20,0,3,1,2,0.62,0.6061,0.61,0.0896,45,396,441,396
15785,10/24/2012,4,1,10,21,0,3,1,2,0.62,0.6061,0.61,0.1045,33,280,313,280
15786,10/24/2012,4,1,10,22,0,3,1,2,0.6,0.6061,0.64,0.1343,30,208,238,208
15787,10/24/2012,4,1,10,23,0,3,1,2,0.58,0.5455,0.68,0.0896,12,111,123,111
15788,10/25/2012,4,1,10,0,0,4,1,2,0.6,0.6061,0.64,0.1045,19,57,76,57
15789,10/25/2012,4,1,10,1,0,4,1,1,0.58,0.5455,0.68,0,6,22,28,22
15790,10/25/2012,4,1,10,2,0,4,1,1,0.54,0.5152,0.77,0,3,15,18,15
15791,10/25/2012,4,1,10,3,0,4,1,2,0.52,0.5,0.88,0.1343,0,8,8,8
15792,10/25/2012,4,1,10,4,0,4,1,2,0.52,0.5,0.88,0.1045,1,4,5,4
15793,10/25/2012,4,1,10,5,0,4,1,2,0.52,0.5,0.88,0.1642,2,53,55,53
15794,10/25/2012,4,1,10,6,0,4,1,2,0.52,0.5,0.88,0.194,3,168,171,168
15795,10/25/2012,4,1,10,7,0,4,1,2,0.52,0.5,0.88,0.194,18,477,495,477
15796,10/25/2012,4,1,10,8,0,4,1,2,0.52,0.5,0.83,0.1642,33,746,779,746
15797,10/25/2012,4,1,10,9,0,4,1,2,0.52,0.5,0.83,0.194,23,320,343,320
15798,10/25/2012,4,1,10,10,0,4,1,2,0.54,0.5152,0.83,0.1343,53,172,225,172
15799,10/25/2012,4,1,10,11,0,4,1,2,0.54,0.5152,0.83,0.1045,57,181,238,181
15800,10/25/2012,4,1,10,12,0,4,1,2,0.56,0.5303,0.78,0.1045,61,258,319,258
15801,10/25/2012,4,1,10,13,0,4,1,2,0.56,0.5303,0.78,0,49,264,313,264
15802,10/25/2012,4,1,10,14,0,4,1,1,0.6,0.5909,0.73,0.1343,71,214,285,214
15803,10/25/2012,4,1,10,15,0,4,1,1,0.62,0.6061,0.65,0.1343,63,242,305,242
15804,10/25/2012,4,1,10,16,0,4,1,1,0.6,0.5909,0.69,0.1642,92,407,499,407
15805,10/25/2012,4,1,10,17,0,4,1,1,0.6,0.5909,0.69,0.1642,112,774,886,774
15806,10/25/2012,4,1,10,18,0,4,1,1,0.56,0.5303,0.83,0.1045,77,732,809,732
15807,10/25/2012,4,1,10,19,0,4,1,1,0.54,0.5152,0.83,0.194,45,497,542,497
15808,10/25/2012,4,1,10,20,0,4,1,2,0.52,0.5,0.88,0.1343,28,319,347,319
15809,10/25/2012,4,1,10,21,0,4,1,2,0.52,0.5,0.88,0.1343,24,247,271,247
15810,10/25/2012,4,1,10,22,0,4,1,2,0.54,0.5152,0.83,0.0896,22,185,207,185
15811,10/25/2012,4,1,10,23,0,4,1,2,0.54,0.5152,0.83,0.1343,13,122,135,122
15812,10/26/2012,4,1,10,0,0,5,1,2,0.54,0.5152,0.77,0,6,65,71,65
15813,10/26/2012,4,1,10,1,0,5,1,2,0.52,0.5,0.88,0.0896,4,32,36,32
15814,10/26/2012,4,1,10,2,0,5,1,2,0.52,0.5,0.88,0.1045,4,15,19,15
15815,10/26/2012,4,1,10,3,0,5,1,2,0.52,0.5,0.88,0.1642,5,8,13,8
15816,10/26/2012,4,1,10,4,0,5,1,2,0.52,0.5,0.88,0.1642,1,4,5,4
15817,10/26/2012,4,1,10,5,0,5,1,2,0.52,0.5,0.88,0.1045,3,47,50,47
15818,10/26/2012,4,1,10,6,0,5,1,2,0.52,0.5,0.88,0.0896,2,142,144,142
15819,10/26/2012,4,1,10,7,0,5,1,2,0.52,0.5,0.88,0.1045,13,408,421,408
15820,10/26/2012,4,1,10,8,0,5,1,2,0.54,0.5152,0.88,0.1343,20,714,734,714
15821,10/26/2012,4,1,10,9,0,5,1,2,0.54,0.5152,0.88,0.1343,56,347,403,347
15822,10/26/2012,4,1,10,10,0,5,1,2,0.54,0.5152,0.88,0.1045,41,156,197,156
15823,10/26/2012,4,1,10,11,0,5,1,2,0.56,0.5303,0.78,0.1642,68,222,290,222
15824,10/26/2012,4,1,10,12,0,5,1,2,0.58,0.5455,0.73,0.194,90,302,392,302
15825,10/26/2012,4,1,10,13,0,5,1,2,0.58,0.5455,0.68,0.1343,77,260,337,260
15826,10/26/2012,4,1,10,14,0,5,1,2,0.6,0.6061,0.64,0.1343,99,252,351,252
15827,10/26/2012,4,1,10,15,0,5,1,2,0.62,0.6061,0.61,0.1045,142,306,448,306
15828,10/26/2012,4,1,10,16,0,5,1,2,0.58,0.5455,0.73,0.1642,137,445,582,445
15829,10/26/2012,4,1,10,17,0,5,1,2,0.56,0.5303,0.76,0.194,125,692,817,692
15830,10/26/2012,4,1,10,18,0,5,1,2,0.56,0.5303,0.78,0.1343,81,584,665,584
15831,10/26/2012,4,1,10,19,0,5,1,2,0.54,0.5152,0.83,0.1642,72,399,471,399
15832,10/26/2012,4,1,10,20,0,5,1,2,0.54,0.5152,0.83,0.1642,40,271,311,271
15833,10/26/2012,4,1,10,21,0,5,1,2,0.54,0.5152,0.77,0.1343,40,252,292,252
15834,10/26/2012,4,1,10,22,0,5,1,2,0.52,0.5,0.83,0.1343,37,180,217,180
15835,10/26/2012,4,1,10,23,0,5,1,1,0.52,0.5,0.83,0.1642,19,159,178,159
15836,10/27/2012,4,1,10,0,0,6,0,1,0.5,0.4848,0.88,0.1343,10,132,142,132
15837,10/27/2012,4,1,10,1,0,6,0,2,0.5,0.4848,0.88,0.1343,23,123,146,123
15838,10/27/2012,4,1,10,2,0,6,0,2,0.5,0.4848,0.88,0.194,19,71,90,71
15839,10/27/2012,4,1,10,3,0,6,0,1,0.5,0.4848,0.88,0.1642,5,21,26,21
15840,10/27/2012,4,1,10,4,0,6,0,2,0.5,0.4848,0.88,0.1642,1,12,13,12
15841,10/27/2012,4,1,10,5,0,6,0,2,0.5,0.4848,0.82,0.194,2,7,9,7
15842,10/27/2012,4,1,10,6,0,6,0,2,0.5,0.4848,0.82,0.194,2,29,31,29
15843,10/27/2012,4,1,10,7,0,6,0,1,0.48,0.4697,0.83,0.194,7,79,86,79
15844,10/27/2012,4,1,10,8,0,6,0,1,0.5,0.4848,0.77,0.2537,26,187,213,187
15845,10/27/2012,4,1,10,9,0,6,0,1,0.5,0.4848,0.77,0.2537,88,240,328,240
15846,10/27/2012,4,1,10,10,0,6,0,1,0.54,0.5152,0.73,0.2836,165,314,479,314
15847,10/27/2012,4,1,10,11,0,6,0,1,0.56,0.5303,0.64,0.2836,197,388,585,388
15848,10/27/2012,4,1,10,12,0,6,0,1,0.6,0.6212,0.53,0.2537,264,404,668,404
15849,10/27/2012,4,1,10,13,0,6,0,1,0.6,0.6212,0.43,0.2537,310,450,760,450
15850,10/27/2012,4,1,10,14,0,6,0,1,0.6,0.6212,0.46,0.2537,325,425,750,425
15851,10/27/2012,4,1,10,15,0,6,0,2,0.56,0.5303,0.6,0.2836,310,401,711,401
15852,10/27/2012,4,1,10,16,0,6,0,2,0.56,0.5303,0.64,0.2836,257,355,612,355
15853,10/27/2012,4,1,10,17,0,6,0,2,0.56,0.5303,0.64,0.2836,248,370,618,370
15854,10/27/2012,4,1,10,18,0,6,0,2,0.56,0.5303,0.64,0.2836,138,318,456,318
15855,10/27/2012,4,1,10,19,0,6,0,2,0.52,0.5,0.72,0.2239,67,233,300,233
15856,10/27/2012,4,1,10,20,0,6,0,2,0.52,0.5,0.72,0.2239,58,238,296,238
15857,10/27/2012,4,1,10,21,0,6,0,2,0.52,0.5,0.72,0.2239,49,160,209,160
15858,10/27/2012,4,1,10,22,0,6,0,2,0.52,0.5,0.72,0.2537,41,116,157,116
15859,10/27/2012,4,1,10,23,0,6,0,2,0.52,0.5,0.68,0.3881,31,136,167,136
15860,10/28/2012,4,1,10,0,0,0,0,3,0.52,0.5,0.68,0.2985,20,97,117,97
15861,10/28/2012,4,1,10,1,0,0,0,2,0.5,0.4848,0.72,0.2836,22,111,133,111
15862,10/28/2012,4,1,10,2,0,0,0,2,0.5,0.4848,0.68,0.2985,17,99,116,99
15863,10/28/2012,4,1,10,3,0,0,0,2,0.5,0.4848,0.63,0.3284,18,61,79,61
15864,10/28/2012,4,1,10,4,0,0,0,2,0.5,0.4848,0.63,0.3582,1,19,20,19
15865,10/28/2012,4,1,10,5,0,0,0,2,0.5,0.4848,0.63,0.2985,6,22,28,22
15866,10/28/2012,4,1,10,6,0,0,0,2,0.5,0.4848,0.59,0.3284,7,32,39,32
15867,10/28/2012,4,1,10,7,0,0,0,2,0.5,0.4848,0.59,0.2985,17,48,65,48
15868,10/28/2012,4,1,10,8,0,0,0,2,0.5,0.4848,0.59,0.5522,55,118,173,118
15869,10/28/2012,4,1,10,9,0,0,0,2,0.5,0.4848,0.55,0.4179,124,206,330,206
15870,10/28/2012,4,1,10,10,0,0,0,2,0.48,0.4697,0.51,0.4179,120,314,434,314
15871,10/28/2012,4,1,10,11,0,0,0,2,0.5,0.4848,0.51,0.3881,110,352,462,352
15872,10/28/2012,4,1,10,12,0,0,0,2,0.48,0.4697,0.59,0.4925,118,373,491,373
15873,10/28/2012,4,1,10,13,0,0,0,2,0.48,0.4697,0.59,0.4179,75,316,391,316
15874,10/28/2012,4,1,10,14,0,0,0,2,0.5,0.4848,0.59,0.4478,98,304,402,304
15875,10/28/2012,4,1,10,15,0,0,0,2,0.5,0.4848,0.63,0.4925,76,225,301,225
15876,10/28/2012,4,1,10,16,0,0,0,3,0.48,0.4697,0.67,0.4627,42,251,293,251
15877,10/28/2012,4,1,10,17,0,0,0,3,0.46,0.4545,0.77,0.5224,37,188,225,188
15878,10/28/2012,4,1,10,18,0,0,0,3,0.42,0.4242,0.94,0.4925,18,136,154,136
15879,10/28/2012,4,1,10,19,0,0,0,3,0.42,0.4242,0.94,0.3582,7,47,54,47
15880,10/28/2012,4,1,10,20,0,0,0,3,0.42,0.4242,0.94,0.4627,4,51,55,51
15881,10/28/2012,4,1,10,21,0,0,0,3,0.44,0.4394,0.88,0.4179,2,44,46,44
15882,10/28/2012,4,1,10,22,0,0,0,3,0.44,0.4394,0.88,0.3582,2,35,37,35
15883,10/28/2012,4,1,10,23,0,0,0,3,0.42,0.4242,0.94,0.3582,2,12,14,12
15884,10/29/2012,4,1,10,0,0,1,1,3,0.44,0.4394,0.88,0.3582,2,20,22,20
15885,10/30/2012,4,1,10,13,0,2,1,3,0.3,0.2727,0.81,0.3582,11,105,116,105
15886,10/30/2012,4,1,10,14,0,2,1,3,0.3,0.2727,0.81,0.3582,8,118,126,118
15887,10/30/2012,4,1,10,15,0,2,1,3,0.3,0.2879,0.87,0.2537,10,114,124,114
15888,10/30/2012,4,1,10,16,0,2,1,3,0.3,0.2879,0.87,0.2537,15,83,98,83
15889,10/30/2012,4,1,10,17,0,2,1,3,0.3,0.2879,0.87,0.2239,19,105,124,105
15890,10/30/2012,4,1,10,18,0,2,1,3,0.3,0.303,0.87,0.1343,4,139,143,139
15891,10/30/2012,4,1,10,19,0,2,1,2,0.5,0.4848,0.68,0.194,6,109,115,109
15892,10/30/2012,4,1,10,20,0,2,1,2,0.3,0.2879,0.81,0.194,5,76,81,76
15893,10/30/2012,4,1,10,21,0,2,1,2,0.3,0.3182,0.87,0.1045,4,60,64,60
15894,10/30/2012,4,1,10,22,0,2,1,1,0.3,0.303,0.81,0.1343,2,64,66,64
15895,10/30/2012,4,1,10,23,0,2,1,1,0.3,0.303,0.81,0.1343,3,36,39,36
15896,10/31/2012,4,1,10,0,0,3,1,2,0.3,0.3182,0.81,0.1045,0,16,16,16
15897,10/31/2012,4,1,10,1,0,3,1,2,0.3,0.3182,0.81,0.0896,0,8,8,8
15898,10/31/2012,4,1,10,2,0,3,1,2,0.3,0.303,0.81,0.1343,0,7,7,7
15899,10/31/2012,4,1,10,3,0,3,1,2,0.3,0.3182,0.81,0.1045,0,3,3,3
15900,10/31/2012,4,1,10,4,0,3,1,2,0.3,0.2879,0.87,0.194,0,5,5,5
15901,10/31/2012,4,1,10,5,0,3,1,2,0.3,0.303,0.81,0.1343,0,24,24,24
15902,10/31/2012,4,1,10,6,0,3,1,1,0.3,0.303,0.81,0.1642,0,116,116,116
15903,10/31/2012,4,1,10,7,0,3,1,2,0.3,0.303,0.87,0.1343,3,334,337,334
15904,10/31/2012,4,1,10,8,0,3,1,1,0.32,0.3333,0.81,0.1343,6,615,621,615
15905,10/31/2012,4,1,10,9,0,3,1,1,0.34,0.3333,0.76,0.1343,17,280,297,280
15906,10/31/2012,4,1,10,10,0,3,1,1,0.36,0.3333,0.71,0.2836,21,147,168,147
15907,10/31/2012,4,1,10,11,0,3,1,2,0.36,0.3485,0.66,0.2239,37,152,189,152
15908,10/31/2012,4,1,10,12,0,3,1,1,0.4,0.4091,0.58,0.194,44,197,241,197
15909,10/31/2012,4,1,10,13,0,3,1,1,0.42,0.4242,0.5,0.2239,22,191,213,191
15910,10/31/2012,4,1,10,14,0,3,1,2,0.42,0.4242,0.5,0.2239,45,179,224,179
15911,10/31/2012,4,1,10,15,0,3,1,1,0.42,0.4242,0.54,0.1642,33,197,230,197
15912,10/31/2012,4,1,10,16,0,3,1,2,0.42,0.4242,0.54,0.2239,51,373,424,373
15913,10/31/2012,4,1,10,17,0,3,1,2,0.4,0.4091,0.58,0.1642,39,684,723,684
15914,10/31/2012,4,1,10,18,0,3,1,2,0.4,0.4091,0.58,0.1642,28,556,584,556
15915,10/31/2012,4,1,10,19,0,3,1,2,0.4,0.4091,0.5,0.194,27,383,410,383
15916,10/31/2012,4,1,10,20,0,3,1,2,0.4,0.4091,0.5,0.194,9,259,268,259
15917,10/31/2012,4,1,10,21,0,3,1,2,0.4,0.4091,0.5,0.194,12,180,192,180
15918,10/31/2012,4,1,10,22,0,3,1,1,0.36,0.3485,0.57,0.1343,18,147,165,147
15919,10/31/2012,4,1,10,23,0,3,1,1,0.36,0.3636,0.57,0.0896,7,94,101,94
15920,11/1/2012,4,1,11,0,0,4,1,1,0.36,0.3636,0.57,0.0896,8,52,60,52
15921,11/1/2012,4,1,11,1,0,4,1,1,0.3,0.3182,0.75,0.1045,8,22,30,22
15922,11/1/2012,4,1,11,2,0,4,1,1,0.32,0.3333,0.66,0.1343,10,10,20,10
15923,11/1/2012,4,1,11,3,0,4,1,1,0.34,0.3333,0.61,0.1343,5,10,15,10
15924,11/1/2012,4,1,11,4,0,4,1,2,0.34,0.3485,0.66,0.1045,2,8,10,8
15925,11/1/2012,4,1,11,5,0,4,1,1,0.34,0.3333,0.66,0.1343,1,39,40,39
15926,11/1/2012,4,1,11,6,0,4,1,1,0.34,0.3333,0.61,0.1642,2,146,148,146
15927,11/1/2012,4,1,11,7,0,4,1,2,0.36,0.3485,0.57,0.1642,6,414,420,414
15928,11/1/2012,4,1,11,8,0,4,1,2,0.36,0.3788,0.56,0.1045,12,668,680,668
15929,11/1/2012,4,1,11,9,0,4,1,3,0.36,0.3636,0.57,0.1045,21,310,331,310
15930,11/1/2012,4,1,11,10,0,4,1,3,0.36,0.3485,0.62,0.194,13,133,146,133
15931,11/1/2012,4,1,11,11,0,4,1,3,0.36,0.3485,0.62,0.194,14,156,170,156
15932,11/1/2012,4,1,11,12,0,4,1,3,0.38,0.3939,0.62,0.1642,23,198,221,198
15933,11/1/2012,4,1,11,13,0,4,1,2,0.4,0.4091,0.58,0.1642,49,199,248,199
15934,11/1/2012,4,1,11,14,0,4,1,2,0.4,0.4091,0.5,0.2239,31,154,185,154
15935,11/1/2012,4,1,11,15,0,4,1,2,0.4,0.4091,0.54,0.1642,35,179,214,179
15936,11/1/2012,4,1,11,16,0,4,1,2,0.4,0.4091,0.54,0.1642,31,313,344,313
15937,11/1/2012,4,1,11,17,0,4,1,3,0.4,0.4091,0.5,0.2239,37,652,689,652
15938,11/1/2012,4,1,11,18,0,4,1,2,0.4,0.4091,0.5,0.1642,50,628,678,628
15939,11/1/2012,4,1,11,19,0,4,1,2,0.4,0.4091,0.5,0.1642,28,424,452,424
15940,11/1/2012,4,1,11,20,0,4,1,2,0.38,0.3939,0.54,0.2537,16,280,296,280
15941,11/1/2012,4,1,11,21,0,4,1,2,0.38,0.3939,0.54,0.1343,29,238,267,238
15942,11/1/2012,4,1,11,22,0,4,1,1,0.36,0.3485,0.57,0.1642,27,175,202,175
15943,11/1/2012,4,1,11,23,0,4,1,1,0.34,0.3333,0.57,0.1642,8,112,120,112
15944,11/2/2012,4,1,11,0,0,5,1,1,0.34,0.3333,0.57,0.1642,10,40,50,40
15945,11/2/2012,4,1,11,1,0,5,1,1,0.32,0.3182,0.66,0.1642,5,19,24,19
15946,11/2/2012,4,1,11,2,0,5,1,1,0.32,0.3182,0.66,0.1642,3,7,10,7
15947,11/2/2012,4,1,11,3,0,5,1,1,0.3,0.303,0.7,0.1642,0,3,3,3
15948,11/2/2012,4,1,11,4,0,5,1,1,0.3,0.3182,0.7,0.1045,1,6,7,6
15949,11/2/2012,4,1,11,5,0,5,1,2,0.32,0.3182,0.66,0.1642,1,25,26,25
15950,11/2/2012,4,1,11,6,0,5,1,1,0.3,0.303,0.7,0.1642,2,120,122,120
15951,11/2/2012,4,1,11,7,0,5,1,2,0.3,0.303,0.7,0.1343,8,349,357,349
15952,11/2/2012,4,1,11,8,0,5,1,1,0.32,0.3333,0.57,0.1045,31,656,687,656
15953,11/2/2012,4,1,11,9,0,5,1,1,0.34,0.3485,0.53,0.1045,27,355,382,355
15954,11/2/2012,4,1,11,10,0,5,1,1,0.38,0.3939,0.46,0.2985,21,183,204,183
15955,11/2/2012,4,1,11,11,0,5,1,1,0.42,0.4242,0.41,0.4179,42,179,221,179
15956,11/2/2012,4,1,11,12,0,5,1,1,0.42,0.4242,0.41,0.3582,52,240,292,240
15957,11/2/2012,4,1,11,13,0,5,1,1,0.4,0.4091,0.43,0.3582,64,230,294,230
15958,11/2/2012,4,1,11,14,0,5,1,2,0.4,0.4091,0.4,0.4925,63,199,262,199
15959,11/2/2012,4,1,11,15,0,5,1,2,0.4,0.4091,0.4,0.4179,51,255,306,255
15960,11/2/2012,4,1,11,16,0,5,1,1,0.38,0.3939,0.4,0.3284,48,373,421,373
15961,11/2/2012,4,1,11,17,0,5,1,1,0.38,0.3939,0.4,0.3284,57,581,638,581
15962,11/2/2012,4,1,11,18,0,5,1,2,0.38,0.3939,0.43,0.3284,32,490,522,490
15963,11/2/2012,4,1,11,19,0,5,1,2,0.38,0.3939,0.43,0.2985,38,336,374,336
15964,11/2/2012,4,1,11,20,0,5,1,2,0.36,0.3333,0.46,0.4179,14,207,221,207
15965,11/2/2012,4,1,11,21,0,5,1,2,0.36,0.3333,0.46,0.3582,23,133,156,133
15966,11/2/2012,4,1,11,22,0,5,1,1,0.36,0.3333,0.46,0.2537,14,135,149,135
15967,11/2/2012,4,1,11,23,0,5,1,1,0.34,0.303,0.53,0.2985,11,108,119,108
15968,11/3/2012,4,1,11,0,0,6,0,1,0.34,0.3333,0.53,0.1642,9,99,108,99
15969,11/3/2012,4,1,11,1,0,6,0,2,0.34,0.303,0.49,0.3284,6,83,89,83
15970,11/3/2012,4,1,11,2,0,6,0,2,0.34,0.3182,0.49,0.2537,10,36,46,36
15971,11/3/2012,4,1,11,3,0,6,0,2,0.34,0.3182,0.49,0.2537,6,22,28,22
15972,11/3/2012,4,1,11,4,0,6,0,2,0.32,0.303,0.49,0.2985,8,8,16,8
15973,11/3/2012,4,1,11,5,0,6,0,2,0.32,0.303,0.49,0.2537,1,8,9,8
15974,11/3/2012,4,1,11,6,0,6,0,2,0.32,0.3182,0.49,0.194,4,17,21,17
15975,11/3/2012,4,1,11,7,0,6,0,2,0.32,0.303,0.49,0.2537,1,58,59,58
15976,11/3/2012,4,1,11,8,0,6,0,2,0.34,0.303,0.46,0.2985,10,132,142,132
15977,11/3/2012,4,1,11,9,0,6,0,2,0.34,0.303,0.49,0.2985,31,188,219,188
15978,11/3/2012,4,1,11,10,0,6,0,1,0.36,0.3333,0.46,0.3881,68,260,328,260
15979,11/3/2012,4,1,11,11,0,6,0,2,0.36,0.3333,0.46,0.3881,56,284,340,284
15980,11/3/2012,4,1,11,12,0,6,0,2,0.36,0.3182,0.46,0.4627,74,320,394,320
15981,11/3/2012,4,1,11,13,0,6,0,2,0.36,0.3333,0.46,0.3582,110,339,449,339
15982,11/3/2012,4,1,11,14,0,6,0,2,0.36,0.3333,0.5,0.3284,136,319,455,319
15983,11/3/2012,4,1,11,15,0,6,0,2,0.36,0.3182,0.46,0.4478,117,331,448,331
15984,11/3/2012,4,1,11,16,0,6,0,2,0.36,0.3333,0.46,0.3284,108,292,400,292
15985,11/3/2012,4,1,11,17,0,6,0,2,0.36,0.3333,0.46,0.2985,112,298,410,298
15986,11/3/2012,4,1,11,18,0,6,0,2,0.36,0.3333,0.46,0.2836,58,239,297,239
15987,11/3/2012,4,1,11,19,0,6,0,1,0.36,0.3485,0.5,0.1642,22,217,239,217
15988,11/3/2012,4,1,11,20,0,6,0,1,0.34,0.3333,0.53,0.1343,23,158,181,158
15989,11/3/2012,4,1,11,21,0,6,0,1,0.34,0.3485,0.53,0.1045,31,135,166,135
15990,11/3/2012,4,1,11,22,0,6,0,1,0.32,0.3333,0.57,0.1045,13,133,146,133
15991,11/3/2012,4,1,11,23,0,6,0,1,0.32,0.3333,0.57,0.1045,15,133,148,133
15992,11/4/2012,4,1,11,0,0,0,0,1,0.3,0.3182,0.61,0.1045,5,97,102,97
15993,11/4/2012,4,1,11,1,0,0,0,1,0.26,0.2879,0.81,0.0896,26,139,165,139
15994,11/4/2012,4,1,11,2,0,0,0,1,0.3,0.3333,0.65,0,6,31,37,31
15995,11/4/2012,4,1,11,3,0,0,0,1,0.28,0.2879,0.61,0.1045,1,10,11,10
15996,11/4/2012,4,1,11,4,0,0,0,1,0.26,0.2727,0.65,0.1343,2,7,9,7
15997,11/4/2012,4,1,11,5,0,0,0,1,0.26,0.2727,0.65,0.1045,0,5,5,5
15998,11/4/2012,4,1,11,6,0,0,0,1,0.28,0.2879,0.61,0.1343,2,14,16,14
15999,11/4/2012,4,1,11,7,0,0,0,1,0.26,0.2727,0.65,0.1045,11,39,50,39
16000,11/4/2012,4,1,11,8,0,0,0,1,0.3,0.303,0.56,0.1343,34,115,149,115
16001,11/4/2012,4,1,11,9,0,0,0,1,0.32,0.3333,0.53,0,56,161,217,161
16002,11/4/2012,4,1,11,10,0,0,0,1,0.34,0.3333,0.49,0.194,73,287,360,287
16003,11/4/2012,4,1,11,11,0,0,0,1,0.38,0.3939,0.46,0.2239,134,311,445,311
16004,11/4/2012,4,1,11,12,0,0,0,1,0.38,0.3939,0.46,0.2239,150,354,504,354
16005,11/4/2012,4,1,11,13,0,0,0,1,0.4,0.4091,0.43,0.2239,122,371,493,371
16006,11/4/2012,4,1,11,14,0,0,0,1,0.4,0.4091,0.4,0.194,149,360,509,360
16007,11/4/2012,4,1,11,15,0,0,0,1,0.4,0.4091,0.4,0.2239,149,300,449,300
16008,11/4/2012,4,1,11,16,0,0,0,1,0.4,0.4091,0.4,0.3284,119,316,435,316
16009,11/4/2012,4,1,11,17,0,0,0,1,0.36,0.3485,0.43,0.194,57,270,327,270
16010,11/4/2012,4,1,11,18,0,0,0,1,0.36,0.3485,0.43,0.2239,31,206,237,206
16011,11/4/2012,4,1,11,19,0,0,0,1,0.36,0.3333,0.43,0.2537,24,203,227,203
16012,11/4/2012,4,1,11,20,0,0,0,1,0.32,0.2879,0.53,0.3582,7,134,141,134
16013,11/4/2012,4,1,11,21,0,0,0,1,0.3,0.2727,0.52,0.2985,16,71,87,71
16014,11/4/2012,4,1,11,22,0,0,0,1,0.3,0.2879,0.52,0.2836,15,64,79,64
16015,11/4/2012,4,1,11,23,0,0,0,2,0.3,0.303,0.56,0.1642,12,41,53,41
16016,11/5/2012,4,1,11,0,0,1,1,2,0.3,0.2879,0.56,0.194,3,20,23,20
16017,11/5/2012,4,1,11,1,0,1,1,2,0.3,0.303,0.56,0.1642,0,8,8,8
16018,11/5/2012,4,1,11,2,0,1,1,2,0.3,0.303,0.56,0.1642,2,4,6,4
16019,11/5/2012,4,1,11,3,0,1,1,2,0.3,0.2879,0.56,0.2239,1,3,4,3
16020,11/5/2012,4,1,11,4,0,1,1,2,0.3,0.2879,0.52,0.2537,5,11,16,11
16021,11/5/2012,4,1,11,5,0,1,1,2,0.3,0.2727,0.52,0.3284,1,38,39,38
16022,11/5/2012,4,1,11,6,0,1,1,2,0.3,0.2879,0.49,0.2836,4,135,139,135
16023,11/5/2012,4,1,11,7,0,1,1,2,0.3,0.2879,0.49,0.2537,8,453,461,453
16024,11/5/2012,4,1,11,8,0,1,1,2,0.3,0.2879,0.49,0.2239,19,629,648,629
16025,11/5/2012,4,1,11,9,0,1,1,2,0.3,0.2879,0.52,0.2836,18,239,257,239
16026,11/5/2012,4,1,11,10,0,1,1,1,0.32,0.303,0.49,0.2836,30,112,142,112
16027,11/5/2012,4,1,11,11,0,1,1,1,0.34,0.3182,0.46,0.2239,31,119,150,119
16028,11/5/2012,4,1,11,12,0,1,1,1,0.36,0.3333,0.43,0.3284,38,206,244,206
16029,11/5/2012,4,1,11,13,0,1,1,1,0.36,0.3333,0.4,0.2537,39,183,222,183
16030,11/5/2012,4,1,11,14,0,1,1,1,0.38,0.3939,0.4,0.1642,31,165,196,165
16031,11/5/2012,4,1,11,15,0,1,1,1,0.38,0.3939,0.4,0.2836,24,207,231,207
16032,11/5/2012,4,1,11,16,0,1,1,1,0.36,0.3333,0.43,0.2836,35,325,360,325
16033,11/5/2012,4,1,11,17,0,1,1,1,0.34,0.3182,0.46,0.2239,34,604,638,604
16034,11/5/2012,4,1,11,18,0,1,1,1,0.34,0.3182,0.46,0.2239,19,523,542,523
16035,11/5/2012,4,1,11,19,0,1,1,1,0.32,0.3182,0.49,0.1642,11,361,372,361
16036,11/5/2012,4,1,11,20,0,1,1,1,0.32,0.303,0.49,0.2537,13,228,241,228
16037,11/5/2012,4,1,11,21,0,1,1,1,0.3,0.2879,0.52,0.2836,8,144,152,144
16038,11/5/2012,4,1,11,22,0,1,1,1,0.28,0.2727,0.56,0.194,4,111,115,111
16039,11/5/2012,4,1,11,23,0,1,1,1,0.26,0.2727,0.6,0.1343,0,53,53,53
16040,11/6/2012,4,1,11,0,0,2,1,1,0.24,0.2576,0.6,0.1045,1,18,19,18
16041,11/6/2012,4,1,11,1,0,2,1,1,0.24,0.2424,0.6,0.1642,0,8,8,8
16042,11/6/2012,4,1,11,2,0,2,1,1,0.24,0.2576,0.65,0.0896,0,2,2,2
16043,11/6/2012,4,1,11,3,0,2,1,1,0.22,0.2424,0.64,0.1045,0,4,4,4
16044,11/6/2012,4,1,11,4,0,2,1,1,0.22,0.2576,0.69,0.0896,0,7,7,7
16045,11/6/2012,4,1,11,5,0,2,1,2,0.22,0.2273,0.64,0.194,1,40,41,40
16046,11/6/2012,4,1,11,6,0,2,1,1,0.22,0.2273,0.69,0.1343,6,143,149,143
16047,11/6/2012,4,1,11,7,0,2,1,1,0.2,0.2121,0.69,0.1642,9,378,387,378
16048,11/6/2012,4,1,11,8,0,2,1,1,0.22,0.2273,0.69,0.1642,20,568,588,568
16049,11/6/2012,4,1,11,9,0,2,1,1,0.26,0.2576,0.6,0.1642,25,338,363,338
16050,11/6/2012,4,1,11,10,0,2,1,1,0.3,0.2879,0.49,0.194,41,189,230,189
16051,11/6/2012,4,1,11,11,0,2,1,1,0.32,0.3333,0.45,0.1343,39,177,216,177
16052,11/6/2012,4,1,11,12,0,2,1,1,0.32,0.3333,0.45,0.1343,31,217,248,217
16053,11/6/2012,4,1,11,13,0,2,1,1,0.34,0.3333,0.46,0.1343,46,232,278,232
16054,11/6/2012,4,1,11,14,0,2,1,1,0.36,0.3636,0.4,0.1045,44,196,240,196
16055,11/6/2012,4,1,11,15,0,2,1,1,0.34,0.3182,0.46,0.2537,45,227,272,227
16056,11/6/2012,4,1,11,16,0,2,1,1,0.34,0.3333,0.46,0.1642,33,369,402,369
16057,11/6/2012,4,1,11,17,0,2,1,1,0.32,0.303,0.53,0.2239,30,597,627,597
16058,11/6/2012,4,1,11,18,0,2,1,1,0.32,0.303,0.57,0.2985,20,477,497,477
16059,11/6/2012,4,1,11,19,0,2,1,1,0.3,0.2879,0.56,0.2239,15,356,371,356
16060,11/6/2012,4,1,11,20,0,2,1,1,0.3,0.2879,0.61,0.2239,10,218,228,218
16061,11/6/2012,4,1,11,21,0,2,1,2,0.3,0.2879,0.56,0.2537,14,137,151,137
16062,11/6/2012,4,1,11,22,0,2,1,2,0.3,0.2879,0.56,0.2239,17,136,153,136
16063,11/6/2012,4,1,11,23,0,2,1,1,0.3,0.2879,0.56,0.2239,19,186,205,186
16064,11/7/2012,4,1,11,0,0,3,1,2,0.3,0.2879,0.56,0.2836,49,234,283,234
16065,11/7/2012,4,1,11,1,0,3,1,2,0.28,0.2727,0.61,0.2537,6,86,92,86
16066,11/7/2012,4,1,11,2,0,3,1,2,0.28,0.2576,0.56,0.2985,6,68,74,68
16067,11/7/2012,4,1,11,3,0,3,1,2,0.28,0.2576,0.52,0.3284,2,9,11,9
16068,11/7/2012,4,1,11,4,0,3,1,2,0.28,0.2576,0.52,0.2985,0,9,9,9
16069,11/7/2012,4,1,11,5,0,3,1,2,0.28,0.2576,0.52,0.3284,0,27,27,27
16070,11/7/2012,4,1,11,6,0,3,1,2,0.26,0.2424,0.56,0.2836,3,115,118,115
16071,11/7/2012,4,1,11,7,0,3,1,2,0.26,0.2273,0.56,0.2985,5,314,319,314
16072,11/7/2012,4,1,11,8,0,3,1,2,0.26,0.2424,0.6,0.2836,18,583,601,583
16073,11/7/2012,4,1,11,9,0,3,1,2,0.26,0.2424,0.6,0.2836,17,351,368,351
16074,11/7/2012,4,1,11,10,0,3,1,2,0.28,0.2576,0.56,0.2985,27,151,178,151
16075,11/7/2012,4,1,11,11,0,3,1,2,0.32,0.2879,0.51,0.3582,15,132,147,132
16076,11/7/2012,4,1,11,12,0,3,1,2,0.32,0.303,0.53,0.2836,24,188,212,188
16077,11/7/2012,4,1,11,13,0,3,1,2,0.32,0.303,0.53,0.2537,23,158,181,158
16078,11/7/2012,4,1,11,14,0,3,1,2,0.32,0.2879,0.53,0.3582,19,142,161,142
16079,11/7/2012,4,1,11,15,0,3,1,2,0.32,0.303,0.53,0.2985,20,178,198,178
16080,11/7/2012,4,1,11,16,0,3,1,2,0.32,0.2879,0.53,0.3582,23,250,273,250
16081,11/7/2012,4,1,11,17,0,3,1,2,0.32,0.2879,0.53,0.3881,16,501,517,501
16082,11/7/2012,4,1,11,18,0,3,1,2,0.32,0.2879,0.53,0.3582,17,448,465,448
16083,11/7/2012,4,1,11,19,0,3,1,2,0.3,0.2727,0.56,0.2985,17,302,319,302
16084,11/7/2012,4,1,11,20,0,3,1,2,0.32,0.303,0.49,0.3284,7,249,256,249
16085,11/7/2012,4,1,11,21,0,3,1,2,0.32,0.303,0.49,0.2985,5,121,126,121
16086,11/7/2012,4,1,11,22,0,3,1,3,0.3,0.2879,0.56,0.2537,4,56,60,56
16087,11/7/2012,4,1,11,23,0,3,1,3,0.28,0.2727,0.65,0.2239,3,37,40,37
16088,11/8/2012,4,1,11,0,0,4,1,3,0.28,0.2727,0.61,0.2239,1,14,15,14
16089,11/8/2012,4,1,11,1,0,4,1,3,0.3,0.2727,0.52,0.3582,1,11,12,11
16090,11/8/2012,4,1,11,2,0,4,1,2,0.3,0.2879,0.49,0.2239,1,5,6,5
16091,11/8/2012,4,1,11,4,0,4,1,2,0.3,0.2879,0.45,0.2836,1,9,10,9
16092,11/8/2012,4,1,11,5,0,4,1,2,0.3,0.2879,0.42,0.2239,0,35,35,35
16093,11/8/2012,4,1,11,6,0,4,1,1,0.3,0.2879,0.39,0.2239,2,122,124,122
16094,11/8/2012,4,1,11,7,0,4,1,1,0.28,0.2576,0.36,0.3881,12,411,423,411
16095,11/8/2012,4,1,11,8,0,4,1,1,0.3,0.2879,0.33,0.2836,16,652,668,652
16096,11/8/2012,4,1,11,9,0,4,1,1,0.32,0.2879,0.31,0.3582,22,253,275,253
16097,11/8/2012,4,1,11,10,0,4,1,1,0.32,0.303,0.31,0.3284,13,148,161,148
16098,11/8/2012,4,1,11,11,0,4,1,1,0.36,0.3333,0.29,0.3881,16,155,171,155
16099,11/8/2012,4,1,11,12,0,4,1,1,0.4,0.4091,0.24,0.4925,33,202,235,202
16100,11/8/2012,4,1,11,13,0,4,1,1,0.44,0.4394,0.18,0.4179,33,195,228,195
16101,11/8/2012,4,1,11,14,0,4,1,1,0.44,0.4394,0.18,0.4179,33,149,182,149
16102,11/8/2012,4,1,11,15,0,4,1,1,0.44,0.4394,0.18,0.4179,32,201,233,201
16103,11/8/2012,4,1,11,16,0,4,1,1,0.42,0.4242,0.16,0.3881,18,321,339,321
16104,11/8/2012,4,1,11,17,0,4,1,1,0.4,0.4091,0.2,0.2985,36,556,592,556
16105,11/8/2012,4,1,11,18,0,4,1,1,0.4,0.4091,0.24,0.4179,16,491,507,491
16106,11/8/2012,4,1,11,19,0,4,1,1,0.38,0.3939,0.27,0.3582,14,359,373,359
16107,11/8/2012,4,1,11,20,0,4,1,1,0.38,0.3939,0.29,0.4627,10,235,245,235
16108,11/8/2012,4,1,11,21,0,4,1,1,0.36,0.3333,0.37,0.3881,11,222,233,222
16109,11/8/2012,4,1,11,22,0,4,1,1,0.34,0.303,0.42,0.2985,14,147,161,147
16110,11/8/2012,4,1,11,23,0,4,1,1,0.34,0.303,0.46,0.3582,5,82,87,82
16111,11/9/2012,4,1,11,0,0,5,1,1,0.34,0.303,0.49,0.3284,9,46,55,46
16112,11/9/2012,4,1,11,1,0,5,1,1,0.32,0.303,0.53,0.2836,3,17,20,17
16113,11/9/2012,4,1,11,2,0,5,1,1,0.32,0.303,0.53,0.2537,1,11,12,11
16114,11/9/2012,4,1,11,3,0,5,1,1,0.32,0.2879,0.53,0.4179,3,6,9,6
16115,11/9/2012,4,1,11,4,0,5,1,1,0.32,0.2879,0.53,0.3582,0,14,14,14
16116,11/9/2012,4,1,11,5,0,5,1,1,0.3,0.2879,0.56,0.194,2,25,27,25
16117,11/9/2012,4,1,11,6,0,5,1,1,0.26,0.2727,0.65,0.1045,5,126,131,126
16118,11/9/2012,4,1,11,7,0,5,1,1,0.26,0.2727,0.65,0.1343,9,332,341,332
16119,11/9/2012,4,1,11,8,0,5,1,1,0.32,0.3182,0.57,0.1642,25,668,693,668
16120,11/9/2012,4,1,11,9,0,5,1,1,0.34,0.303,0.53,0.4179,23,304,327,304
16121,11/9/2012,4,1,11,10,0,5,1,1,0.36,0.3333,0.5,0.3284,34,163,197,163
16122,11/9/2012,4,1,11,11,0,5,1,1,0.4,0.4091,0.47,0.2985,66,185,251,185
16123,11/9/2012,4,1,11,12,0,5,1,1,0.44,0.4394,0.41,0.3284,48,214,262,214
16124,11/9/2012,4,1,11,13,0,5,1,1,0.46,0.4545,0.38,0.2985,62,237,299,237
16125,11/9/2012,4,1,11,14,0,5,1,1,0.46,0.4545,0.38,0.194,67,207,274,207
16126,11/9/2012,4,1,11,15,0,5,1,1,0.46,0.4545,0.36,0.2239,78,278,356,278
16127,11/9/2012,4,1,11,16,0,5,1,1,0.46,0.4545,0.38,0.1642,57,377,434,377
16128,11/9/2012,4,1,11,17,0,5,1,1,0.42,0.4242,0.44,0.1343,61,593,654,593
16129,11/9/2012,4,1,11,18,0,5,1,1,0.42,0.4242,0.44,0.1045,46,450,496,450
16130,11/9/2012,4,1,11,19,0,5,1,1,0.34,0.3485,0.71,0.0896,30,331,361,331
16131,11/9/2012,4,1,11,20,0,5,1,1,0.36,0.3485,0.66,0.1343,20,235,255,235
16132,11/9/2012,4,1,11,21,0,5,1,1,0.34,0.3636,0.76,0,23,176,199,176
16133,11/9/2012,4,1,11,22,0,5,1,1,0.34,0.3485,0.71,0.1045,17,146,163,146
16134,11/9/2012,4,1,11,23,0,5,1,1,0.32,0.3333,0.81,0.0896,20,142,162,142
16135,11/10/2012,4,1,11,0,0,6,0,1,0.32,0.3333,0.76,0.0896,16,106,122,106
16136,11/10/2012,4,1,11,1,0,6,0,1,0.3,0.3182,0.81,0.0896,8,68,76,68
16137,11/10/2012,4,1,11,2,0,6,0,1,0.32,0.3485,0.81,0,2,42,44,42
16138,11/10/2012,4,1,11,3,0,6,0,1,0.3,0.3333,0.81,0,9,11,20,11
16139,11/10/2012,4,1,11,4,0,6,0,1,0.26,0.2727,0.87,0.1045,2,4,6,4
16140,11/10/2012,4,1,11,5,0,6,0,1,0.28,0.3182,0.87,0,1,9,10,9
16141,11/10/2012,4,1,11,6,0,6,0,1,0.24,0.2576,0.93,0.0896,5,11,16,11
16142,11/10/2012,4,1,11,7,0,6,0,1,0.26,0.2727,0.87,0.1045,14,57,71,57
16143,11/10/2012,4,1,11,8,0,6,0,1,0.32,0.3485,0.76,0,16,130,146,130
16144,11/10/2012,4,1,11,9,0,6,0,1,0.36,0.3485,0.66,0.194,43,216,259,216
16145,11/10/2012,4,1,11,10,0,6,0,1,0.4,0.4091,0.58,0,86,264,350,264
16146,11/10/2012,4,1,11,11,0,6,0,1,0.4,0.4091,0.58,0.1045,143,323,466,323
16147,11/10/2012,4,1,11,12,0,6,0,1,0.48,0.4697,0.48,0,258,348,606,348
16148,11/10/2012,4,1,11,13,0,6,0,1,0.52,0.5,0.39,0,268,383,651,383
16149,11/10/2012,4,1,11,14,0,6,0,1,0.54,0.5152,0.37,0,280,347,627,347
16150,11/10/2012,4,1,11,15,0,6,0,1,0.52,0.5,0.45,0,216,351,567,351
16151,11/10/2012,4,1,11,16,0,6,0,1,0.54,0.5152,0.37,0,227,378,605,378
16152,11/10/2012,4,1,11,17,0,6,0,1,0.5,0.4848,0.45,0.194,183,318,501,318
16153,11/10/2012,4,1,11,18,0,6,0,1,0.44,0.4394,0.54,0.1343,103,256,359,256
16154,11/10/2012,4,1,11,19,0,6,0,1,0.46,0.4545,0.51,0.0896,55,228,283,228
16155,11/10/2012,4,1,11,20,0,6,0,1,0.44,0.4394,0.54,0,39,153,192,153
16156,11/10/2012,4,1,11,21,0,6,0,1,0.4,0.4091,0.66,0,51,169,220,169
16157,11/10/2012,4,1,11,22,0,6,0,1,0.38,0.3939,0.71,0.0896,39,154,193,154
16158,11/10/2012,4,1,11,23,0,6,0,1,0.36,0.3636,0.71,0.1045,26,120,146,120
16159,11/11/2012,4,1,11,0,0,0,0,1,0.34,0.3485,0.81,0.0896,14,110,124,110
16160,11/11/2012,4,1,11,1,0,0,0,1,0.34,0.3485,0.76,0.0896,26,82,108,82
16161,11/11/2012,4,1,11,2,0,0,0,1,0.32,0.3333,0.87,0.1045,12,58,70,58
16162,11/11/2012,4,1,11,3,0,0,0,1,0.34,0.3636,0.81,0,9,39,48,39
16163,11/11/2012,4,1,11,4,0,0,0,1,0.32,0.3333,0.81,0.1045,5,6,11,6
16164,11/11/2012,4,1,11,5,0,0,0,1,0.3,0.303,0.87,0.1343,0,12,12,12
16165,11/11/2012,4,1,11,6,0,0,0,1,0.3,0.3182,0.87,0.0896,3,16,19,16
16166,11/11/2012,4,1,11,7,0,0,0,1,0.3,0.3182,0.89,0.0896,12,56,68,56
16167,11/11/2012,4,1,11,8,0,0,0,1,0.32,0.3333,0.87,0.1045,32,87,119,87
16168,11/11/2012,4,1,11,9,0,0,0,1,0.36,0.3788,0.77,0,94,179,273,179
16169,11/11/2012,4,1,11,10,0,0,0,1,0.4,0.4091,0.69,0.1045,133,272,405,272
16170,11/11/2012,4,1,11,11,0,0,0,1,0.46,0.4545,0.59,0.1343,180,324,504,324
16171,11/11/2012,4,1,11,12,0,0,0,1,0.5,0.4848,0.48,0.0896,195,390,585,390
16172,11/11/2012,4,1,11,13,0,0,0,1,0.54,0.5152,0.45,0.1045,262,424,686,424
16173,11/11/2012,4,1,11,14,0,0,0,1,0.6,0.6212,0.33,0.1642,292,362,654,362
16174,11/11/2012,4,1,11,15,0,0,0,1,0.56,0.5303,0.37,0.2239,304,420,724,420
16175,11/11/2012,4,1,11,16,0,0,0,1,0.54,0.5152,0.42,0.2239,260,393,653,393
16176,11/11/2012,4,1,11,17,0,0,0,1,0.54,0.5152,0.45,0.1642,151,342,493,342
16177,11/11/2012,4,1,11,18,0,0,0,1,0.52,0.5,0.45,0.1343,102,303,405,303
16178,11/11/2012,4,1,11,19,0,0,0,1,0.48,0.4697,0.55,0.1343,69,208,277,208
16179,11/11/2012,4,1,11,20,0,0,0,1,0.44,0.4394,0.62,0.1642,54,146,200,146
16180,11/11/2012,4,1,11,21,0,0,0,1,0.44,0.4394,0.67,0.2239,44,127,171,127
16181,11/11/2012,4,1,11,22,0,0,0,1,0.42,0.4242,0.71,0.194,21,113,134,113
16182,11/11/2012,4,1,11,23,0,0,0,1,0.42,0.4242,0.71,0.194,16,93,109,93
16183,11/12/2012,4,1,11,0,1,1,0,1,0.42,0.4242,0.71,0.1045,6,43,49,43
16184,11/12/2012,4,1,11,1,1,1,0,1,0.4,0.4091,0.76,0.1642,4,26,30,26
16185,11/12/2012,4,1,11,2,1,1,0,1,0.4,0.4091,0.76,0.1343,6,14,20,14
16186,11/12/2012,4,1,11,3,1,1,0,1,0.4,0.4091,0.76,0.1343,1,3,4,3
16187,11/12/2012,4,1,11,4,1,1,0,1,0.4,0.4091,0.76,0.0896,1,3,4,3
16188,11/12/2012,4,1,11,5,1,1,0,1,0.38,0.3939,0.87,0,1,23,24,23
16189,11/12/2012,4,1,11,6,1,1,0,1,0.38,0.3939,0.87,0.1045,7,64,71,64
16190,11/12/2012,4,1,11,7,1,1,0,1,0.4,0.4091,0.87,0,16,248,264,248
16191,11/12/2012,4,1,11,8,1,1,0,1,0.42,0.4242,0.82,0.1642,50,490,540,490
16192,11/12/2012,4,1,11,9,1,1,0,1,0.44,0.4394,0.88,0.1045,60,337,397,337
16193,11/12/2012,4,1,11,10,1,1,0,1,0.48,0.4697,0.77,0.1642,82,184,266,184
16194,11/12/2012,4,1,11,11,1,1,0,1,0.52,0.5,0.72,0.1642,112,255,367,255
16195,11/12/2012,4,1,11,12,1,1,0,1,0.56,0.5303,0.64,0.2239,105,314,419,314
16196,11/12/2012,4,1,11,13,1,1,0,1,0.6,0.6061,0.6,0.2239,108,312,420,312
16197,11/12/2012,4,1,11,14,1,1,0,1,0.58,0.5455,0.6,0.2836,134,310,444,310
16198,11/12/2012,4,1,11,15,1,1,0,1,0.56,0.5303,0.64,0.2537,102,280,382,280
16199,11/12/2012,4,1,11,16,1,1,0,1,0.56,0.5303,0.64,0.1642,87,347,434,347
16200,11/12/2012,4,1,11,17,1,1,0,1,0.56,0.5303,0.64,0.2836,66,530,596,530
16201,11/12/2012,4,1,11,18,1,1,0,1,0.52,0.5,0.72,0.1343,65,486,551,486
16202,11/12/2012,4,1,11,19,1,1,0,1,0.54,0.5152,0.73,0.2836,30,323,353,323
16203,11/12/2012,4,1,11,20,1,1,0,2,0.52,0.5,0.77,0.2836,31,273,304,273
16204,11/12/2012,4,1,11,21,1,1,0,3,0.54,0.5152,0.73,0.2239,10,145,155,145
16205,11/12/2012,4,1,11,22,1,1,0,1,0.52,0.5,0.77,0.2537,12,100,112,100
16206,11/12/2012,4,1,11,23,1,1,0,2,0.54,0.5152,0.77,0.2239,1,62,63,62
16207,11/13/2012,4,1,11,0,0,2,1,2,0.52,0.5,0.83,0.2836,5,18,23,18
16208,11/13/2012,4,1,11,1,0,2,1,3,0.44,0.4394,0.88,0.6418,0,5,5,5
16209,11/13/2012,4,1,11,2,0,2,1,3,0.36,0.3182,0.87,0.4478,7,4,11,4
16210,11/13/2012,4,1,11,3,0,2,1,3,0.36,0.3333,0.87,0.3582,2,3,5,3
16211,11/13/2012,4,1,11,4,0,2,1,2,0.36,0.3333,0.81,0.3881,0,9,9,9
16212,11/13/2012,4,1,11,5,0,2,1,2,0.34,0.3182,0.87,0.2836,0,18,18,18
16213,11/13/2012,4,1,11,6,0,2,1,3,0.32,0.2879,0.81,0.4627,2,48,50,48
16214,11/13/2012,4,1,11,7,0,2,1,3,0.32,0.303,0.87,0.2537,1,106,107,106
16215,11/13/2012,4,1,11,8,0,2,1,3,0.32,0.303,0.87,0.2537,4,207,211,207
16216,11/13/2012,4,1,11,9,0,2,1,3,0.32,0.303,0.81,0.3284,1,109,110,109
16217,11/13/2012,4,1,11,10,0,2,1,3,0.3,0.2727,0.75,0.3881,10,84,94,84
16218,11/13/2012,4,1,11,11,0,2,1,1,0.32,0.303,0.7,0.2537,22,133,155,133
16219,11/13/2012,4,1,11,12,0,2,1,1,0.34,0.3182,0.61,0.2836,16,180,196,180
16220,11/13/2012,4,1,11,13,0,2,1,1,0.34,0.3182,0.53,0.2537,30,188,218,188
16221,11/13/2012,4,1,11,14,0,2,1,1,0.38,0.3939,0.46,0.3881,34,169,203,169
16222,11/13/2012,4,1,11,15,0,2,1,1,0.4,0.4091,0.4,0.2985,33,184,217,184
16223,11/13/2012,4,1,11,16,0,2,1,1,0.38,0.3939,0.4,0.2985,28,282,310,282
16224,11/13/2012,4,1,11,17,0,2,1,1,0.34,0.303,0.49,0.3582,33,575,608,575
16225,11/13/2012,4,1,11,18,0,2,1,1,0.34,0.3182,0.49,0.2836,45,514,559,514
16226,11/13/2012,4,1,11,19,0,2,1,1,0.32,0.2879,0.49,0.3582,12,344,356,344
16227,11/13/2012,4,1,11,20,0,2,1,1,0.3,0.2727,0.49,0.3582,12,211,223,211
16228,11/13/2012,4,1,11,21,0,2,1,1,0.3,0.2727,0.49,0.3582,9,178,187,178
16229,11/13/2012,4,1,11,22,0,2,1,1,0.26,0.2273,0.56,0.3284,15,120,135,120
16230,11/13/2012,4,1,11,23,0,2,1,1,0.26,0.2273,0.56,0.2985,6,78,84,78
16231,11/14/2012,4,1,11,0,0,3,1,1,0.26,0.2424,0.56,0.2836,4,20,24,20
16232,11/14/2012,4,1,11,1,0,3,1,1,0.24,0.2121,0.6,0.2985,2,10,12,10
16233,11/14/2012,4,1,11,2,0,3,1,1,0.24,0.2121,0.6,0.2985,0,1,1,1
16234,11/14/2012,4,1,11,3,0,3,1,1,0.24,0.2273,0.65,0.2239,0,5,5,5
16235,11/14/2012,4,1,11,4,0,3,1,1,0.22,0.2273,0.69,0.194,0,6,6,6
16236,11/14/2012,4,1,11,5,0,3,1,1,0.22,0.2273,0.69,0.194,0,39,39,39
16237,11/14/2012,4,1,11,6,0,3,1,1,0.24,0.2273,0.65,0.194,4,142,146,142
16238,11/14/2012,4,1,11,7,0,3,1,1,0.24,0.2121,0.65,0.2836,10,405,415,405
16239,11/14/2012,4,1,11,8,0,3,1,1,0.28,0.2576,0.56,0.2985,27,664,691,664
16240,11/14/2012,4,1,11,9,0,3,1,1,0.3,0.2727,0.52,0.3881,22,310,332,310
16241,11/14/2012,4,1,11,10,0,3,1,1,0.32,0.2879,0.45,0.3582,18,153,171,153
16242,11/14/2012,4,1,11,11,0,3,1,1,0.32,0.303,0.49,0.2537,25,126,151,126
16243,11/14/2012,4,1,11,12,0,3,1,1,0.34,0.3333,0.46,0,40,200,240,200
16244,11/14/2012,4,1,11,13,0,3,1,1,0.36,0.3333,0.43,0.2537,32,182,214,182
16245,11/14/2012,4,1,11,14,0,3,1,1,0.36,0.3485,0.43,0.1343,20,161,181,161
16246,11/14/2012,4,1,11,15,0,3,1,1,0.36,0.3333,0.43,0.2836,32,228,260,228
16247,11/14/2012,4,1,11,16,0,3,1,1,0.34,0.3485,0.46,0.1045,31,290,321,290
16248,11/14/2012,4,1,11,17,0,3,1,1,0.32,0.3182,0.49,0.194,19,564,583,564
16249,11/14/2012,4,1,11,18,0,3,1,1,0.32,0.3182,0.53,0.1642,24,543,567,543
16250,11/14/2012,4,1,11,19,0,3,1,1,0.3,0.303,0.52,0.1642,28,368,396,368
16251,11/14/2012,4,1,11,20,0,3,1,1,0.3,0.3182,0.52,0.0896,15,252,267,252
16252,11/14/2012,4,1,11,21,0,3,1,1,0.3,0.3333,0.56,0,5,208,213,208
16253,11/14/2012,4,1,11,22,0,3,1,1,0.28,0.3182,0.61,0,6,167,173,167
16254,11/14/2012,4,1,11,23,0,3,1,1,0.24,0.2424,0.7,0.1343,9,78,87,78
16255,11/15/2012,4,1,11,0,0,4,1,2,0.26,0.303,0.65,0,1,33,34,33
16256,11/15/2012,4,1,11,1,0,4,1,2,0.26,0.2727,0.65,0.1045,2,14,16,14
16257,11/15/2012,4,1,11,2,0,4,1,2,0.26,0.2576,0.7,0.1642,0,7,7,7
16258,11/15/2012,4,1,11,3,0,4,1,2,0.26,0.2879,0.7,0.0896,0,2,2,2
16259,11/15/2012,4,1,11,4,0,4,1,2,0.28,0.2879,0.65,0.1343,0,5,5,5
16260,11/15/2012,4,1,11,5,0,4,1,2,0.3,0.2879,0.61,0.2239,3,34,37,34
16261,11/15/2012,4,1,11,6,0,4,1,2,0.3,0.2879,0.65,0.2537,1,146,147,146
16262,11/15/2012,4,1,11,7,0,4,1,2,0.3,0.2879,0.65,0.194,7,403,410,403
16263,11/15/2012,4,1,11,8,0,4,1,2,0.3,0.2879,0.61,0.2239,21,625,646,625
16264,11/15/2012,4,1,11,9,0,4,1,2,0.32,0.3182,0.61,0.194,17,306,323,306
16265,11/15/2012,4,1,11,10,0,4,1,2,0.32,0.3333,0.66,0.1343,11,142,153,142
16266,11/15/2012,4,1,11,11,0,4,1,2,0.34,0.3333,0.61,0.1343,28,138,166,138
16267,11/15/2012,4,1,11,12,0,4,1,2,0.36,0.3636,0.62,0.1045,29,184,213,184
16268,11/15/2012,4,1,11,13,0,4,1,2,0.38,0.3939,0.54,0.1045,20,197,217,197
16269,11/15/2012,4,1,11,14,0,4,1,2,0.38,0.3939,0.54,0.1642,27,174,201,174
16270,11/15/2012,4,1,11,15,0,4,1,2,0.38,0.3939,0.58,0.1642,26,191,217,191
16271,11/15/2012,4,1,11,16,0,4,1,2,0.36,0.3485,0.57,0.194,24,318,342,318
16272,11/15/2012,4,1,11,17,0,4,1,2,0.36,0.3485,0.57,0.2239,22,541,563,541
16273,11/15/2012,4,1,11,18,0,4,1,2,0.36,0.3485,0.57,0.194,10,563,573,563
16274,11/15/2012,4,1,11,19,0,4,1,2,0.34,0.3333,0.61,0.1343,11,375,386,375
16275,11/15/2012,4,1,11,20,0,4,1,1,0.34,0.3485,0.61,0.1045,23,262,285,262
16276,11/15/2012,4,1,11,21,0,4,1,2,0.32,0.3333,0.66,0.1045,20,204,224,204
16277,11/15/2012,4,1,11,22,0,4,1,2,0.32,0.3182,0.66,0.1642,10,143,153,143
16278,11/15/2012,4,1,11,23,0,4,1,2,0.32,0.3182,0.61,0.1642,7,118,125,118
16279,11/16/2012,4,1,11,0,0,5,1,2,0.32,0.3333,0.66,0.1045,7,58,65,58
16280,11/16/2012,4,1,11,1,0,5,1,2,0.3,0.3182,0.65,0.0896,5,16,21,16
16281,11/16/2012,4,1,11,2,0,5,1,2,0.3,0.303,0.7,0.1642,0,9,9,9
16282,11/16/2012,4,1,11,3,0,5,1,2,0.3,0.303,0.65,0.1343,0,6,6,6
16283,11/16/2012,4,1,11,4,0,5,1,2,0.3,0.3182,0.65,0.1045,0,5,5,5
16284,11/16/2012,4,1,11,5,0,5,1,2,0.3,0.3182,0.65,0.0896,2,34,36,34
16285,11/16/2012,4,1,11,6,0,5,1,2,0.3,0.3182,0.61,0.0896,4,126,130,126
16286,11/16/2012,4,1,11,7,0,5,1,2,0.3,0.303,0.61,0.1642,5,362,367,362
16287,11/16/2012,4,1,11,8,0,5,1,2,0.32,0.3333,0.57,0.1343,17,694,711,694
16288,11/16/2012,4,1,11,9,0,5,1,1,0.34,0.3485,0.53,0.1045,21,330,351,330
16289,11/16/2012,4,1,11,10,0,5,1,1,0.34,0.3333,0.53,0.194,33,165,198,165
16290,11/16/2012,4,1,11,11,0,5,1,1,0.38,0.3939,0.43,0.2239,33,185,218,185
16291,11/16/2012,4,1,11,12,0,5,1,1,0.4,0.4091,0.43,0.2836,28,262,290,262
16292,11/16/2012,4,1,11,13,0,5,1,1,0.42,0.4242,0.38,0.194,52,226,278,226
16293,11/16/2012,4,1,11,14,0,5,1,1,0.42,0.4242,0.35,0.1045,47,204,251,204
16294,11/16/2012,4,1,11,15,0,5,1,1,0.42,0.4242,0.38,0.1343,30,237,267,237
16295,11/16/2012,4,1,11,16,0,5,1,1,0.42,0.4242,0.35,0.2836,33,350,383,350
16296,11/16/2012,4,1,11,17,0,5,1,1,0.36,0.3485,0.46,0.194,41,539,580,539
16297,11/16/2012,4,1,11,18,0,5,1,1,0.34,0.3333,0.53,0.1642,22,483,505,483
16298,11/16/2012,4,1,11,19,0,5,1,1,0.36,0.3485,0.46,0.2239,26,306,332,306
16299,11/16/2012,4,1,11,20,0,5,1,1,0.36,0.3333,0.46,0.2537,20,207,227,207
16300,11/16/2012,4,1,11,21,0,5,1,1,0.34,0.3333,0.49,0.194,21,157,178,157
16301,11/16/2012,4,1,11,22,0,5,1,1,0.32,0.303,0.53,0.2537,23,139,162,139
16302,11/16/2012,4,1,11,23,0,5,1,1,0.32,0.303,0.53,0.2239,14,114,128,114
16303,11/17/2012,4,1,11,0,0,6,0,1,0.3,0.303,0.52,0.1642,11,95,106,95
16304,11/17/2012,4,1,11,1,0,6,0,1,0.26,0.2576,0.6,0.194,13,74,87,74
16305,11/17/2012,4,1,11,2,0,6,0,1,0.26,0.2576,0.65,0.194,8,41,49,41
16306,11/17/2012,4,1,11,3,0,6,0,1,0.26,0.2576,0.65,0.194,2,19,21,19
16307,11/17/2012,4,1,11,4,0,6,0,1,0.24,0.2273,0.7,0.194,1,6,7,6
16308,11/17/2012,4,1,11,5,0,6,0,1,0.24,0.2424,0.7,0.1642,1,10,11,10
16309,11/17/2012,4,1,11,6,0,6,0,1,0.24,0.2273,0.7,0.2239,0,21,21,21
16310,11/17/2012,4,1,11,7,0,6,0,1,0.24,0.2273,0.7,0.194,8,70,78,70
16311,11/17/2012,4,1,11,8,0,6,0,1,0.26,0.2576,0.65,0.2239,30,138,168,138
16312,11/17/2012,4,1,11,9,0,6,0,1,0.34,0.3182,0.49,0.2239,48,200,248,200
16313,11/17/2012,4,1,11,10,0,6,0,1,0.36,0.3333,0.46,0.2537,62,258,320,258
16314,11/17/2012,4,1,11,11,0,6,0,1,0.38,0.3939,0.43,0.194,80,343,423,343
16315,11/17/2012,4,1,11,12,0,6,0,1,0.4,0.4091,0.4,0.1642,117,359,476,359
16316,11/17/2012,4,1,11,13,0,6,0,1,0.42,0.4242,0.38,0.2537,179,346,525,346
16317,11/17/2012,4,1,11,14,0,6,0,1,0.42,0.4242,0.38,0.194,175,380,555,380
16318,11/17/2012,4,1,11,15,0,6,0,1,0.42,0.4242,0.35,0.2985,175,374,549,374
16319,11/17/2012,4,1,11,16,0,6,0,1,0.4,0.4091,0.4,0.2239,144,325,469,325
16320,11/17/2012,4,1,11,17,0,6,0,1,0.38,0.3939,0.4,0.1642,101,302,403,302
16321,11/17/2012,4,1,11,18,0,6,0,1,0.36,0.3636,0.5,0.1045,34,237,271,237
16322,11/17/2012,4,1,11,19,0,6,0,1,0.34,0.3485,0.53,0.0896,45,208,253,208
16323,11/17/2012,4,1,11,20,0,6,0,2,0.34,0.3485,0.66,0.0896,30,142,172,142
16324,11/17/2012,4,1,11,21,0,6,0,2,0.32,0.3333,0.57,0.1045,15,124,139,124
16325,11/17/2012,4,1,11,22,0,6,0,2,0.32,0.3333,0.57,0.1045,15,130,145,130
16326,11/17/2012,4,1,11,23,0,6,0,2,0.3,0.3182,0.7,0.1045,19,114,133,114
16327,11/18/2012,4,1,11,0,0,0,0,2,0.3,0.303,0.7,0.1642,11,118,129,118
16328,11/18/2012,4,1,11,1,0,0,0,1,0.3,0.2879,0.7,0.194,14,81,95,81
16329,11/18/2012,4,1,11,2,0,0,0,1,0.28,0.2879,0.81,0.1045,8,65,73,65
16330,11/18/2012,4,1,11,3,0,0,0,2,0.3,0.303,0.81,0.1642,9,37,46,37
16331,11/18/2012,4,1,11,4,0,0,0,2,0.3,0.2879,0.81,0.194,4,8,12,8
16332,11/18/2012,4,1,11,5,0,0,0,1,0.28,0.2879,0.81,0.1343,5,7,12,7
16333,11/18/2012,4,1,11,6,0,0,0,1,0.28,0.2727,0.81,0.1642,2,13,15,13
16334,11/18/2012,4,1,11,7,0,0,0,1,0.28,0.2727,0.81,0.194,3,39,42,39
16335,11/18/2012,4,1,11,8,0,0,0,1,0.3,0.2879,0.75,0.2537,19,100,119,100
16336,11/18/2012,4,1,11,9,0,0,0,1,0.32,0.303,0.7,0.2537,49,155,204,155
16337,11/18/2012,4,1,11,10,0,0,0,1,0.34,0.303,0.66,0.2985,79,250,329,250
16338,11/18/2012,4,1,11,11,0,0,0,1,0.38,0.3939,0.62,0.2836,92,267,359,267
16339,11/18/2012,4,1,11,12,0,0,0,1,0.4,0.4091,0.62,0.2836,101,341,442,341
16340,11/18/2012,4,1,11,13,0,0,0,1,0.4,0.4091,0.62,0.3284,113,334,447,334
16341,11/18/2012,4,1,11,14,0,0,0,1,0.4,0.4091,0.62,0.2985,125,303,428,303
16342,11/18/2012,4,1,11,15,0,0,0,1,0.42,0.4242,0.54,0.2836,89,318,407,318
16343,11/18/2012,4,1,11,16,0,0,0,2,0.4,0.4091,0.62,0.3284,59,313,372,313
16344,11/18/2012,4,1,11,17,0,0,0,2,0.38,0.3939,0.66,0.2537,48,232,280,232
16345,11/18/2012,4,1,11,18,0,0,0,1,0.36,0.3485,0.66,0.2239,36,240,276,240
16346,11/18/2012,4,1,11,19,0,0,0,1,0.36,0.3485,0.66,0.1642,16,194,210,194
16347,11/18/2012,4,1,11,20,0,0,0,1,0.36,0.3485,0.66,0.1642,9,120,129,120
16348,11/18/2012,4,1,11,21,0,0,0,1,0.36,0.3333,0.66,0.2537,17,93,110,93
16349,11/18/2012,4,1,11,22,0,0,0,2,0.36,0.3333,0.66,0.2537,8,66,74,66
16350,11/18/2012,4,1,11,23,0,0,0,1,0.36,0.3485,0.66,0.2239,6,53,59,53
16351,11/19/2012,4,1,11,0,0,1,1,1,0.36,0.3485,0.66,0.2239,5,22,27,22
16352,11/19/2012,4,1,11,1,0,1,1,2,0.36,0.3485,0.66,0.2239,0,19,19,19
16353,11/19/2012,4,1,11,2,0,1,1,2,0.36,0.3333,0.66,0.2537,0,5,5,5
16354,11/19/2012,4,1,11,3,0,1,1,2,0.36,0.3485,0.66,0.2239,0,2,2,2
16355,11/19/2012,4,1,11,4,0,1,1,2,0.36,0.3485,0.66,0.2239,1,11,12,11
16356,11/19/2012,4,1,11,5,0,1,1,2,0.36,0.3485,0.66,0.2239,1,38,39,38
16357,11/19/2012,4,1,11,6,0,1,1,2,0.36,0.3333,0.66,0.2537,3,128,131,128
16358,11/19/2012,4,1,11,7,0,1,1,2,0.36,0.3333,0.66,0.2985,5,381,386,381
16359,11/19/2012,4,1,11,8,0,1,1,2,0.36,0.3333,0.66,0.2985,13,650,663,650
16360,11/19/2012,4,1,11,9,0,1,1,2,0.36,0.3333,0.66,0.2537,18,260,278,260
16361,11/19/2012,4,1,11,10,0,1,1,2,0.36,0.3333,0.66,0.2537,33,106,139,106
16362,11/19/2012,4,1,11,11,0,1,1,2,0.38,0.3939,0.66,0.2537,33,164,197,164
16363,11/19/2012,4,1,11,12,0,1,1,2,0.4,0.4091,0.62,0.2836,35,207,242,207
16364,11/19/2012,4,1,11,13,0,1,1,1,0.44,0.4394,0.54,0.2537,46,205,251,205
16365,11/19/2012,4,1,11,14,0,1,1,1,0.44,0.4394,0.54,0.2537,47,170,217,170
16366,11/19/2012,4,1,11,15,0,1,1,1,0.44,0.4394,0.54,0.194,44,213,257,213
16367,11/19/2012,4,1,11,16,0,1,1,1,0.42,0.4242,0.58,0.2537,55,325,380,325
16368,11/19/2012,4,1,11,17,0,1,1,2,0.42,0.4242,0.58,0.194,33,586,619,586
16369,11/19/2012,4,1,11,18,0,1,1,2,0.4,0.4091,0.58,0.2537,21,559,580,559
16370,11/19/2012,4,1,11,19,0,1,1,2,0.4,0.4091,0.58,0.2836,25,381,406,381
16371,11/19/2012,4,1,11,20,0,1,1,2,0.38,0.3939,0.62,0.2537,7,252,259,252
16372,11/19/2012,4,1,11,21,0,1,1,2,0.38,0.3939,0.54,0.2239,15,188,203,188
16373,11/19/2012,4,1,11,22,0,1,1,1,0.34,0.3485,0.66,0.1045,7,106,113,106
16374,11/19/2012,4,1,11,23,0,1,1,1,0.34,0.3485,0.66,0.1045,2,72,74,72
16375,11/20/2012,4,1,11,0,0,2,1,1,0.32,0.3333,0.7,0.1343,3,26,29,26
16376,11/20/2012,4,1,11,1,0,2,1,1,0.34,0.3485,0.66,0.1045,3,10,13,10
16377,11/20/2012,4,1,11,2,0,2,1,2,0.32,0.3333,0.76,0.0896,0,5,5,5
16378,11/20/2012,4,1,11,3,0,2,1,2,0.34,0.3485,0.71,0.1045,0,2,2,2
16379,11/20/2012,4,1,11,4,0,2,1,2,0.34,0.3333,0.66,0.194,0,6,6,6
16380,11/20/2012,4,1,11,5,0,2,1,2,0.34,0.3333,0.66,0.1343,2,32,34,32
16381,11/20/2012,4,1,11,6,0,2,1,2,0.34,0.3333,0.71,0.1642,2,146,148,146
16382,11/20/2012,4,1,11,7,0,2,1,1,0.32,0.3333,0.76,0.0896,7,411,418,411
16383,11/20/2012,4,1,11,8,0,2,1,1,0.34,0.3333,0.71,0.1343,16,649,665,649
16384,11/20/2012,4,1,11,9,0,2,1,2,0.36,0.3788,0.71,0,28,298,326,298
16385,11/20/2012,4,1,11,10,0,2,1,2,0.4,0.4091,0.66,0.0896,32,144,176,144
16386,11/20/2012,4,1,11,11,0,2,1,2,0.42,0.4242,0.67,0.0896,45,160,205,160
16387,11/20/2012,4,1,11,12,0,2,1,2,0.42,0.4242,0.67,0,70,243,313,243
16388,11/20/2012,4,1,11,13,0,2,1,2,0.44,0.4394,0.58,0,49,218,267,218
16389,11/20/2012,4,1,11,14,0,2,1,2,0.44,0.4394,0.58,0.1045,47,177,224,177
16390,11/20/2012,4,1,11,15,0,2,1,2,0.46,0.4545,0.55,0.1045,61,226,287,226
16391,11/20/2012,4,1,11,16,0,2,1,2,0.42,0.4242,0.62,0.0896,60,335,395,335
16392,11/20/2012,4,1,11,17,0,2,1,2,0.4,0.4091,0.71,0.1642,37,553,590,553
16393,11/20/2012,4,1,11,18,0,2,1,2,0.4,0.4091,0.66,0.0896,16,534,550,534
16394,11/20/2012,4,1,11,19,0,2,1,2,0.4,0.4091,0.71,0,23,361,384,361
16395,11/20/2012,4,1,11,20,0,2,1,2,0.38,0.3939,0.76,0,11,224,235,224
16396,11/20/2012,4,1,11,21,0,2,1,1,0.36,0.3788,0.71,0,14,143,157,143
16397,11/20/2012,4,1,11,22,0,2,1,1,0.36,0.3788,0.71,0,7,115,122,115
16398,11/20/2012,4,1,11,23,0,2,1,1,0.32,0.3333,0.81,0.1045,1,82,83,82
16399,11/21/2012,4,1,11,0,0,3,1,1,0.34,0.3636,0.81,0,1,25,26,25
16400,11/21/2012,4,1,11,1,0,3,1,1,0.32,0.3333,0.81,0.1045,1,13,14,13
16401,11/21/2012,4,1,11,2,0,3,1,1,0.28,0.2879,0.87,0.1045,2,6,8,6
16402,11/21/2012,4,1,11,3,0,3,1,1,0.28,0.2879,0.87,0.1045,0,2,2,2
16403,11/21/2012,4,1,11,4,0,3,1,1,0.28,0.2879,0.87,0.1045,0,10,10,10
16404,11/21/2012,4,1,11,5,0,3,1,1,0.28,0.2879,0.87,0.1045,1,28,29,28
16405,11/21/2012,4,1,11,6,0,3,1,1,0.28,0.303,0.87,0.0896,2,99,101,99
16406,11/21/2012,4,1,11,7,0,3,1,1,0.26,0.2879,0.87,0.0896,11,262,273,262
16407,11/21/2012,4,1,11,8,0,3,1,2,0.28,0.303,0.81,0.0896,12,539,551,539
16408,11/21/2012,4,1,11,9,0,3,1,1,0.32,0.3333,0.76,0.0896,45,320,365,320
16409,11/21/2012,4,1,11,10,0,3,1,1,0.36,0.3788,0.62,0,22,150,172,150
16410,11/21/2012,4,1,11,11,0,3,1,1,0.4,0.4091,0.5,0.194,43,198,241,198
16411,11/21/2012,4,1,11,12,0,3,1,1,0.44,0.4394,0.41,0.194,74,270,344,270
16412,11/21/2012,4,1,11,13,0,3,1,1,0.44,0.4394,0.35,0.2239,70,295,365,295
16413,11/21/2012,4,1,11,14,0,3,1,1,0.46,0.4545,0.33,0.194,84,329,413,329
16414,11/21/2012,4,1,11,15,0,3,1,1,0.46,0.4545,0.36,0.0896,68,381,449,381
16415,11/21/2012,4,1,11,16,0,3,1,1,0.44,0.4394,0.33,0.1343,59,410,469,410
16416,11/21/2012,4,1,11,17,0,3,1,1,0.4,0.4091,0.4,0.1642,41,333,374,333
16417,11/21/2012,4,1,11,18,0,3,1,1,0.42,0.4242,0.38,0.1045,24,287,311,287
16418,11/21/2012,4,1,11,19,0,3,1,1,0.38,0.3939,0.43,0.194,23,220,243,220
16419,11/21/2012,4,1,11,20,0,3,1,1,0.34,0.3485,0.61,0.1045,11,125,136,125
16420,11/21/2012,4,1,11,21,0,3,1,1,0.36,0.3788,0.5,0,8,97,105,97
16421,11/21/2012,4,1,11,22,0,3,1,1,0.34,0.3636,0.49,0,6,82,88,82
16422,11/21/2012,4,1,11,23,0,3,1,1,0.32,0.3485,0.61,0,7,50,57,50
16423,11/22/2012,4,1,11,0,1,4,0,1,0.32,0.3333,0.66,0.0896,3,43,46,43
16424,11/22/2012,4,1,11,1,1,4,0,1,0.28,0.303,0.65,0.0896,5,37,42,37
16425,11/22/2012,4,1,11,2,1,4,0,1,0.24,0.2576,0.75,0.0896,3,15,18,15
16426,11/22/2012,4,1,11,3,1,4,0,1,0.24,0.2576,0.75,0.1045,0,6,6,6
16427,11/22/2012,4,1,11,4,1,4,0,1,0.22,0.2273,0.8,0.1343,1,2,3,2
16428,11/22/2012,4,1,11,5,1,4,0,1,0.24,0.2576,0.75,0.1045,2,6,8,6
16429,11/22/2012,4,1,11,6,1,4,0,1,0.26,0.2727,0.7,0.1045,2,15,17,15
16430,11/22/2012,4,1,11,7,1,4,0,1,0.22,0.2273,0.75,0.1343,7,49,56,49
16431,11/22/2012,4,1,11,8,1,4,0,1,0.24,0.2424,0.75,0.1343,20,77,97,77
16432,11/22/2012,4,1,11,9,1,4,0,1,0.3,0.3333,0.65,0,25,94,119,94
16433,11/22/2012,4,1,11,10,1,4,0,1,0.36,0.3636,0.57,0.1045,65,154,219,154
16434,11/22/2012,4,1,11,11,1,4,0,1,0.42,0.4242,0.41,0.0896,89,143,232,143
16435,11/22/2012,4,1,11,12,1,4,0,1,0.44,0.4394,0.35,0,117,145,262,145
16436,11/22/2012,4,1,11,13,1,4,0,1,0.46,0.4545,0.31,0,125,144,269,144
16437,11/22/2012,4,1,11,14,1,4,0,1,0.48,0.4697,0.29,0,125,95,220,95
16438,11/22/2012,4,1,11,15,1,4,0,1,0.48,0.4697,0.29,0,132,96,228,96
16439,11/22/2012,4,1,11,16,1,4,0,1,0.46,0.4545,0.33,0,101,81,182,81
16440,11/22/2012,4,1,11,17,1,4,0,1,0.44,0.4394,0.35,0,66,43,109,43
16441,11/22/2012,4,1,11,18,1,4,0,1,0.4,0.4091,0.43,0,16,54,70,54
16442,11/22/2012,4,1,11,19,1,4,0,1,0.36,0.3788,0.76,0,13,31,44,31
16443,11/22/2012,4,1,11,20,1,4,0,1,0.34,0.3636,0.71,0,15,37,52,37
16444,11/22/2012,4,1,11,21,1,4,0,1,0.34,0.3485,0.61,0.0896,7,39,46,39
16445,11/22/2012,4,1,11,22,1,4,0,1,0.32,0.3485,0.61,0,8,36,44,36
16446,11/22/2012,4,1,11,23,1,4,0,1,0.3,0.3333,0.7,0,8,28,36,28
16447,11/23/2012,4,1,11,0,0,5,1,1,0.28,0.3182,0.65,0,0,32,32,32
16448,11/23/2012,4,1,11,1,0,5,1,1,0.28,0.303,0.81,0.0896,2,11,13,11
16449,11/23/2012,4,1,11,2,0,5,1,1,0.26,0.2879,0.75,0.0896,1,4,5,4
16450,11/23/2012,4,1,11,3,0,5,1,1,0.26,0.303,0.7,0,1,0,1,0
16451,11/23/2012,4,1,11,4,0,5,1,1,0.24,0.2576,0.75,0.1045,1,3,4,3
16452,11/23/2012,4,1,11,5,0,5,1,1,0.24,0.2879,0.81,0,0,10,10,10
16453,11/23/2012,4,1,11,6,0,5,1,1,0.24,0.2879,0.81,0,0,20,20,20
16454,11/23/2012,4,1,11,7,0,5,1,1,0.24,0.2879,0.81,0,5,72,77,72
16455,11/23/2012,4,1,11,8,0,5,1,1,0.24,0.2576,0.87,0.0896,11,83,94,83
16456,11/23/2012,4,1,11,9,0,5,1,1,0.28,0.2879,0.75,0.1045,32,80,112,80
16457,11/23/2012,4,1,11,10,0,5,1,1,0.34,0.3333,0.61,0.1642,87,114,201,114
16458,11/23/2012,4,1,11,11,0,5,1,1,0.4,0.4091,0.5,0.194,121,130,251,130
16459,11/23/2012,4,1,11,12,0,5,1,1,0.44,0.4394,0.38,0.2537,186,193,379,193
16460,11/23/2012,4,1,11,13,0,5,1,1,0.46,0.4545,0.38,0.2836,224,200,424,200
16461,11/23/2012,4,1,11,14,0,5,1,1,0.5,0.4848,0.36,0.2537,240,195,435,195
16462,11/23/2012,4,1,11,15,0,5,1,1,0.48,0.4697,0.41,0.2537,233,214,447,214
16463,11/23/2012,4,1,11,16,0,5,1,2,0.48,0.4697,0.41,0.1045,158,199,357,199
16464,11/23/2012,4,1,11,17,0,5,1,2,0.48,0.4697,0.39,0.0896,117,183,300,183
16465,11/23/2012,4,1,11,18,0,5,1,2,0.46,0.4545,0.44,0,50,158,208,158
16466,11/23/2012,4,1,11,19,0,5,1,2,0.46,0.4545,0.47,0.1642,33,121,154,121
16467,11/23/2012,4,1,11,20,0,5,1,1,0.46,0.4545,0.41,0.0896,42,100,142,100
16468,11/23/2012,4,1,11,21,0,5,1,1,0.46,0.4545,0.47,0.2537,23,75,98,75
16469,11/23/2012,4,1,11,22,0,5,1,1,0.44,0.4394,0.33,0.5224,16,63,79,63
16470,11/23/2012,4,1,11,23,0,5,1,1,0.42,0.4242,0.38,0.4478,20,47,67,47
16471,11/24/2012,4,1,11,0,0,6,0,1,0.4,0.4091,0.37,0.4179,9,33,42,33
16472,11/24/2012,4,1,11,1,0,6,0,1,0.34,0.2879,0.42,0.4925,1,19,20,19
16473,11/24/2012,4,1,11,2,0,6,0,1,0.32,0.2727,0.39,0.6119,10,22,32,22
16474,11/24/2012,4,1,11,3,0,6,0,1,0.28,0.2576,0.41,0.3582,6,5,11,5
16475,11/24/2012,4,1,11,4,0,6,0,1,0.26,0.2121,0.41,0.4478,1,2,3,2
16476,11/24/2012,4,1,11,5,0,6,0,1,0.26,0.2273,0.41,0.3284,1,2,3,2
16477,11/24/2012,4,1,11,6,0,6,0,1,0.24,0.2121,0.44,0.2836,1,9,10,9
16478,11/24/2012,4,1,11,7,0,6,0,2,0.26,0.2273,0.41,0.3284,4,21,25,21
16479,11/24/2012,4,1,11,8,0,6,0,2,0.26,0.2121,0.44,0.4627,7,55,62,55
16480,11/24/2012,4,1,11,9,0,6,0,2,0.26,0.2121,0.41,0.4478,26,96,122,96
16481,11/24/2012,4,1,11,10,0,6,0,2,0.26,0.2273,0.44,0.2985,46,96,142,96
16482,11/24/2012,4,1,11,11,0,6,0,2,0.28,0.2576,0.41,0.2985,55,131,186,131
16483,11/24/2012,4,1,11,12,0,6,0,2,0.3,0.2576,0.36,0.6119,53,146,199,146
16484,11/24/2012,4,1,11,13,0,6,0,1,0.32,0.303,0.36,0.3284,64,161,225,161
16485,11/24/2012,4,1,11,14,0,6,0,1,0.32,0.2879,0.33,0.4627,58,149,207,149
16486,11/24/2012,4,1,11,15,0,6,0,1,0.3,0.2727,0.36,0.4627,59,139,198,139
16487,11/24/2012,4,1,11,16,0,6,0,1,0.28,0.2424,0.38,0.4478,43,127,170,127
16488,11/24/2012,4,1,11,17,0,6,0,1,0.26,0.2273,0.41,0.3881,29,97,126,97
16489,11/24/2012,4,1,11,18,0,6,0,1,0.26,0.2273,0.38,0.3881,22,123,145,123
16490,11/24/2012,4,1,11,19,0,6,0,1,0.26,0.2424,0.41,0.2537,9,74,83,74
16491,11/24/2012,4,1,11,20,0,6,0,1,0.24,0.2121,0.44,0.2836,3,55,58,55
16492,11/24/2012,4,1,11,21,0,6,0,1,0.24,0.2273,0.44,0.194,9,66,75,66
16493,11/24/2012,4,1,11,22,0,6,0,1,0.24,0.2273,0.44,0.2537,7,69,76,69
16494,11/24/2012,4,1,11,23,0,6,0,1,0.24,0.2273,0.44,0.194,9,48,57,48
16495,11/25/2012,4,1,11,0,0,0,0,1,0.22,0.2121,0.47,0.2537,3,31,34,31
16496,11/25/2012,4,1,11,1,0,0,0,1,0.22,0.2273,0.44,0.194,4,32,36,32
16497,11/25/2012,4,1,11,2,0,0,0,1,0.22,0.197,0.44,0.3582,1,27,28,27
16498,11/25/2012,4,1,11,3,0,0,0,1,0.22,0.2727,0.44,0,0,8,8,8
16499,11/25/2012,4,1,11,4,0,0,0,1,0.22,0.2727,0.44,0,1,1,2,1
16500,11/25/2012,4,1,11,5,0,0,0,2,0.22,0.2273,0.47,0.1642,0,3,3,3
16501,11/25/2012,4,1,11,6,0,0,0,2,0.22,0.2424,0.47,0.1045,1,10,11,10
16502,11/25/2012,4,1,11,7,0,0,0,2,0.22,0.2424,0.51,0.1045,2,19,21,19
16503,11/25/2012,4,1,11,8,0,0,0,2,0.22,0.2273,0.51,0.194,2,32,34,32
16504,11/25/2012,4,1,11,9,0,0,0,2,0.24,0.2273,0.48,0.2239,13,83,96,83
16505,11/25/2012,4,1,11,10,0,0,0,1,0.24,0.2273,0.48,0.2537,15,124,139,124
16506,11/25/2012,4,1,11,11,0,0,0,2,0.26,0.2576,0.41,0.2239,49,155,204,155
16507,11/25/2012,4,1,11,12,0,0,0,2,0.26,0.2576,0.41,0.2239,37,165,202,165
16508,11/25/2012,4,1,11,13,0,0,0,2,0.26,0.2576,0.41,0.1642,37,158,195,158
16509,11/25/2012,4,1,11,14,0,0,0,2,0.3,0.2879,0.42,0.2537,33,170,203,170
16510,11/25/2012,4,1,11,15,0,0,0,1,0.3,0.2879,0.42,0.2537,36,209,245,209
16511,11/25/2012,4,1,11,16,0,0,0,1,0.3,0.2879,0.39,0.2239,25,203,228,203
16512,11/25/2012,4,1,11,17,0,0,0,1,0.28,0.2727,0.41,0.1642,11,170,181,170
16513,11/25/2012,4,1,11,18,0,0,0,1,0.26,0.2576,0.44,0.1642,9,132,141,132
16514,11/25/2012,4,1,11,19,0,0,0,1,0.26,0.303,0.41,0,13,114,127,114
16515,11/25/2012,4,1,11,20,0,0,0,1,0.24,0.2879,0.6,0,9,110,119,110
16516,11/25/2012,4,1,11,21,0,0,0,1,0.26,0.303,0.48,0,4,60,64,60
16517,11/25/2012,4,1,11,22,0,0,0,1,0.24,0.2879,0.6,0,3,59,62,59
16518,11/25/2012,4,1,11,23,0,0,0,1,0.22,0.2576,0.69,0.0896,1,40,41,40
16519,11/26/2012,4,1,11,0,0,1,1,1,0.22,0.2727,0.69,0,4,19,23,19
16520,11/26/2012,4,1,11,1,0,1,1,1,0.2,0.2576,0.69,0,1,9,10,9
16521,11/26/2012,4,1,11,2,0,1,1,1,0.2,0.2576,0.69,0,0,5,5,5
16522,11/26/2012,4,1,11,3,0,1,1,1,0.2,0.2576,0.69,0,1,4,5,4
16523,11/26/2012,4,1,11,4,0,1,1,1,0.22,0.2727,0.69,0,0,10,10,10
16524,11/26/2012,4,1,11,5,0,1,1,1,0.22,0.2273,0.69,0.1642,0,41,41,41
16525,11/26/2012,4,1,11,6,0,1,1,1,0.22,0.2727,0.69,0,1,123,124,123
16526,11/26/2012,4,1,11,7,0,1,1,1,0.24,0.2879,0.65,0,2,363,365,363
16527,11/26/2012,4,1,11,8,0,1,1,1,0.24,0.2879,0.65,0,9,629,638,629
16528,11/26/2012,4,1,11,9,0,1,1,1,0.28,0.303,0.56,0.0896,10,276,286,276
16529,11/26/2012,4,1,11,10,0,1,1,1,0.32,0.3485,0.49,0,20,127,147,127
16530,11/26/2012,4,1,11,11,0,1,1,1,0.4,0.4091,0.37,0.2985,18,112,130,112
16531,11/26/2012,4,1,11,12,0,1,1,1,0.42,0.4242,0.35,0.1045,22,188,210,188
16532,11/26/2012,4,1,11,13,0,1,1,1,0.42,0.4242,0.35,0.1045,20,197,217,197
16533,11/26/2012,4,1,11,14,0,1,1,1,0.42,0.4242,0.35,0,51,177,228,177
16534,11/26/2012,4,1,11,15,0,1,1,1,0.42,0.4242,0.35,0.0896,49,181,230,181
16535,11/26/2012,4,1,11,16,0,1,1,1,0.44,0.4394,0.3,0,49,297,346,297
16536,11/26/2012,4,1,11,17,0,1,1,1,0.42,0.4242,0.32,0,13,540,553,540
16537,11/26/2012,4,1,11,18,0,1,1,1,0.36,0.3485,0.5,0.1642,19,502,521,502
16538,11/26/2012,4,1,11,19,0,1,1,1,0.34,0.3636,0.53,0,16,355,371,355
16539,11/26/2012,4,1,11,20,0,1,1,1,0.34,0.3636,0.49,0,12,265,277,265
16540,11/26/2012,4,1,11,21,0,1,1,1,0.34,0.3636,0.49,0,9,172,181,172
16541,11/26/2012,4,1,11,22,0,1,1,1,0.32,0.3485,0.61,0,3,101,104,101
16542,11/26/2012,4,1,11,23,0,1,1,2,0.32,0.3333,0.66,0.1045,8,57,65,57
16543,11/27/2012,4,1,11,0,0,2,1,2,0.32,0.3333,0.66,0.0896,2,24,26,24
16544,11/27/2012,4,1,11,1,0,2,1,2,0.32,0.3333,0.7,0.1343,0,6,6,6
16545,11/27/2012,4,1,11,2,0,2,1,2,0.32,0.3182,0.7,0.1642,0,5,5,5
16546,11/27/2012,4,1,11,3,0,2,1,3,0.32,0.3333,0.7,0.1343,1,3,4,3
16547,11/27/2012,4,1,11,4,0,2,1,3,0.3,0.2879,0.81,0.194,0,5,5,5
16548,11/27/2012,4,1,11,5,0,2,1,2,0.3,0.2879,0.81,0.2239,0,31,31,31
16549,11/27/2012,4,1,11,6,0,2,1,2,0.3,0.303,0.81,0.1642,3,97,100,97
16550,11/27/2012,4,1,11,7,0,2,1,3,0.3,0.303,0.81,0.1343,4,289,293,289
16551,11/27/2012,4,1,11,8,0,2,1,3,0.32,0.3182,0.81,0.1642,6,494,500,494
16552,11/27/2012,4,1,11,9,0,2,1,2,0.32,0.3333,0.81,0.1343,11,257,268,257
16553,11/27/2012,4,1,11,10,0,2,1,3,0.32,0.3182,0.81,0.194,5,52,57,52
16554,11/27/2012,4,1,11,11,0,2,1,3,0.3,0.2727,0.87,0.2985,6,59,65,59
16555,11/27/2012,4,1,11,12,0,2,1,3,0.28,0.2576,0.87,0.3881,6,70,76,70
16556,11/27/2012,4,1,11,13,0,2,1,3,0.28,0.2727,0.87,0.2537,4,73,77,73
16557,11/27/2012,4,1,11,14,0,2,1,3,0.28,0.2576,0.87,0.3582,8,86,94,86
16558,11/27/2012,4,1,11,15,0,2,1,2,0.3,0.2727,0.75,0.2985,9,146,155,146
16559,11/27/2012,4,1,11,16,0,2,1,2,0.3,0.2727,0.75,0.2985,5,252,257,252
16560,11/27/2012,4,1,11,17,0,2,1,2,0.3,0.2727,0.75,0.3881,13,514,527,514
16561,11/27/2012,4,1,11,18,0,2,1,1,0.26,0.2273,0.81,0.3582,13,469,482,469
16562,11/27/2012,4,1,11,19,0,2,1,1,0.26,0.2576,0.73,0.2985,12,338,350,338
16563,11/27/2012,4,1,11,20,0,2,1,1,0.26,0.2273,0.75,0.3284,4,228,232,228
16564,11/27/2012,4,1,11,21,0,2,1,1,0.24,0.2121,0.81,0.2836,6,179,185,179
16565,11/27/2012,4,1,11,22,0,2,1,1,0.24,0.2424,0.81,0.1642,2,95,97,95
16566,11/27/2012,4,1,11,23,0,2,1,2,0.26,0.2424,0.81,0.2537,3,64,67,64
16567,11/28/2012,4,1,11,0,0,3,1,2,0.26,0.2424,0.75,0.2537,1,22,23,22
16568,11/28/2012,4,1,11,1,0,3,1,2,0.26,0.2576,0.75,0.2239,0,12,12,12
16569,11/28/2012,4,1,11,2,0,3,1,2,0.26,0.2576,0.75,0.2239,0,1,1,1
16570,11/28/2012,4,1,11,3,0,3,1,2,0.26,0.2576,0.7,0.2239,0,3,3,3
16571,11/28/2012,4,1,11,4,0,3,1,2,0.26,0.2576,0.7,0.194,0,4,4,4
16572,11/28/2012,4,1,11,5,0,3,1,2,0.26,0.2727,0.7,0.1343,0,39,39,39
16573,11/28/2012,4,1,11,6,0,3,1,2,0.26,0.2576,0.65,0.2239,4,132,136,132
16574,11/28/2012,4,1,11,7,0,3,1,2,0.26,0.2576,0.56,0.194,6,403,409,403
16575,11/28/2012,4,1,11,8,0,3,1,1,0.24,0.2121,0.6,0.2836,9,683,692,683
16576,11/28/2012,4,1,11,9,0,3,1,1,0.28,0.2727,0.52,0.194,13,309,322,309
16577,11/28/2012,4,1,11,10,0,3,1,1,0.3,0.3182,0.49,0.1045,17,144,161,144
16578,11/28/2012,4,1,11,11,0,3,1,1,0.32,0.3182,0.45,0.1642,19,127,146,127
16579,11/28/2012,4,1,11,12,0,3,1,1,0.34,0.303,0.42,0.3881,19,189,208,189
16580,11/28/2012,4,1,11,13,0,3,1,1,0.34,0.3333,0.42,0.194,21,193,214,193
16581,11/28/2012,4,1,11,14,0,3,1,1,0.36,0.3333,0.4,0.2985,15,161,176,161
16582,11/28/2012,4,1,11,15,0,3,1,1,0.36,0.3333,0.32,0.3284,7,172,179,172
16583,11/28/2012,4,1,11,16,0,3,1,1,0.36,0.3333,0.29,0.2537,9,316,325,316
16584,11/28/2012,4,1,11,17,0,3,1,1,0.34,0.3333,0.31,0.1343,17,546,563,546
16585,11/28/2012,4,1,11,18,0,3,1,1,0.32,0.303,0.33,0.2836,12,530,542,530
16586,11/28/2012,4,1,11,19,0,3,1,1,0.32,0.3182,0.36,0.1642,9,378,387,378
16587,11/28/2012,4,1,11,20,0,3,1,1,0.32,0.3333,0.36,0.1343,5,258,263,258
16588,11/28/2012,4,1,11,21,0,3,1,1,0.3,0.303,0.39,0.1642,4,219,223,219
16589,11/28/2012,4,1,11,22,0,3,1,1,0.28,0.2727,0.45,0.1642,6,148,154,148
16590,11/28/2012,4,1,11,23,0,3,1,1,0.26,0.2727,0.48,0.1343,5,73,78,73
16591,11/29/2012,4,1,11,0,0,4,1,1,0.24,0.2576,0.56,0.0896,4,25,29,25
16592,11/29/2012,4,1,11,1,0,4,1,1,0.22,0.2576,0.64,0.0896,1,15,16,15
16593,11/29/2012,4,1,11,2,0,4,1,1,0.22,0.2727,0.64,0,1,6,7,6
16594,11/29/2012,4,1,11,4,0,4,1,1,0.2,0.2273,0.75,0.0896,0,7,7,7
16595,11/29/2012,4,1,11,5,0,4,1,1,0.2,0.2576,0.69,0,0,42,42,42
16596,11/29/2012,4,1,11,6,0,4,1,1,0.22,0.2727,0.69,0,1,120,121,120
16597,11/29/2012,4,1,11,7,0,4,1,1,0.2,0.2576,0.64,0,8,354,362,354
16598,11/29/2012,4,1,11,8,0,4,1,1,0.2,0.2273,0.69,0.1045,15,664,679,664
16599,11/29/2012,4,1,11,9,0,4,1,1,0.24,0.2879,0.6,0,13,286,299,286
16600,11/29/2012,4,1,11,10,0,4,1,1,0.28,0.303,0.65,0.0896,25,153,178,153
16601,11/29/2012,4,1,11,11,0,4,1,1,0.36,0.3485,0.37,0.2239,13,150,163,150
16602,11/29/2012,4,1,11,12,0,4,1,1,0.36,0.3485,0.4,0.1642,11,225,236,225
16603,11/29/2012,4,1,11,13,0,4,1,1,0.38,0.3939,0.32,0.1343,15,209,224,209
16604,11/29/2012,4,1,11,14,0,4,1,1,0.36,0.3485,0.43,0.2239,13,174,187,174
16605,11/29/2012,4,1,11,15,0,4,1,1,0.36,0.3333,0.43,0.2836,19,201,220,201
16606,11/29/2012,4,1,11,16,0,4,1,1,0.36,0.3485,0.4,0.2239,24,346,370,346
16607,11/29/2012,4,1,11,17,0,4,1,1,0.34,0.3333,0.39,0.194,17,544,561,544
16608,11/29/2012,4,1,11,18,0,4,1,1,0.32,0.3182,0.49,0.1642,17,520,537,520
16609,11/29/2012,4,1,11,19,0,4,1,1,0.3,0.2879,0.52,0.194,18,326,344,326
16610,11/29/2012,4,1,11,20,0,4,1,1,0.3,0.303,0.52,0.1642,11,241,252,241
16611,11/29/2012,4,1,11,21,0,4,1,1,0.26,0.2727,0.65,0.1343,7,201,208,201
16612,11/29/2012,4,1,11,22,0,4,1,1,0.26,0.2879,0.7,0.0896,4,147,151,147
16613,11/29/2012,4,1,11,23,0,4,1,1,0.28,0.3182,0.61,0,6,124,130,124
16614,11/30/2012,4,1,11,0,0,5,1,1,0.26,0.2576,0.7,0.1642,4,48,52,48
16615,11/30/2012,4,1,11,1,0,5,1,1,0.24,0.2576,0.7,0.0896,2,17,19,17
16616,11/30/2012,4,1,11,2,0,5,1,1,0.24,0.2879,0.75,0,2,10,12,10
16617,11/30/2012,4,1,11,3,0,5,1,1,0.24,0.2879,0.75,0,0,4,4,4
16618,11/30/2012,4,1,11,4,0,5,1,1,0.22,0.2727,0.75,0,0,3,3,3
16619,11/30/2012,4,1,11,5,0,5,1,1,0.2,0.2576,0.8,0,1,39,40,39
16620,11/30/2012,4,1,11,6,0,5,1,1,0.2,0.2576,0.86,0,2,104,106,104
16621,11/30/2012,4,1,11,7,0,5,1,1,0.22,0.2727,0.8,0,6,346,352,346
16622,11/30/2012,4,1,11,8,0,5,1,2,0.22,0.2576,0.8,0.0896,20,709,729,709
16623,11/30/2012,4,1,11,9,0,5,1,1,0.24,0.2576,0.75,0.0896,17,313,330,313
16624,11/30/2012,4,1,11,10,0,5,1,2,0.3,0.3333,0.65,0,10,159,169,159
16625,11/30/2012,4,1,11,11,0,5,1,2,0.34,0.3485,0.53,0.0896,31,170,201,170
16626,11/30/2012,4,1,11,12,0,5,1,2,0.38,0.3939,0.46,0,25,243,268,243
16627,11/30/2012,4,1,11,13,0,5,1,2,0.4,0.4091,0.4,0.1642,21,241,262,241
16628,11/30/2012,4,1,11,14,0,5,1,2,0.4,0.4091,0.4,0.1045,26,225,251,225
16629,11/30/2012,4,1,11,15,0,5,1,2,0.42,0.4242,0.38,0.1045,34,262,296,262
16630,11/30/2012,4,1,11,16,0,5,1,1,0.4,0.4091,0.43,0.1343,37,368,405,368
16631,11/30/2012,4,1,11,17,0,5,1,1,0.36,0.3485,0.5,0.194,31,551,582,551
16632,11/30/2012,4,1,11,18,0,5,1,2,0.34,0.3636,0.61,0,20,489,509,489
16633,11/30/2012,4,1,11,19,0,5,1,1,0.32,0.3485,0.66,0,18,359,377,359
16634,11/30/2012,4,1,11,20,0,5,1,1,0.32,0.3485,0.66,0,12,233,245,233
16635,11/30/2012,4,1,11,21,0,5,1,1,0.3,0.3182,0.75,0.0896,14,169,183,169
16636,11/30/2012,4,1,11,22,0,5,1,1,0.3,0.3333,0.75,0,18,145,163,145
16637,11/30/2012,4,1,11,23,0,5,1,2,0.3,0.3182,0.75,0.0896,11,99,110,99
16638,12/1/2012,4,1,12,0,0,6,0,1,0.26,0.303,0.81,0,9,99,108,99
16639,12/1/2012,4,1,12,1,0,6,0,1,0.26,0.303,0.81,0,5,64,69,64
16640,12/1/2012,4,1,12,2,0,6,0,2,0.26,0.303,0.81,0,3,47,50,47
16641,12/1/2012,4,1,12,3,0,6,0,2,0.26,0.2727,0.81,0.1343,1,14,15,14
16642,12/1/2012,4,1,12,4,0,6,0,1,0.26,0.2879,0.81,0.0896,0,5,5,5
16643,12/1/2012,4,1,12,5,0,6,0,1,0.24,0.2576,0.87,0.0896,1,12,13,12
16644,12/1/2012,4,1,12,6,0,6,0,1,0.24,0.2424,0.87,0.1343,7,20,27,20
16645,12/1/2012,4,1,12,7,0,6,0,2,0.24,0.2424,0.87,0.1343,7,56,63,56
16646,12/1/2012,4,1,12,8,0,6,0,2,0.24,0.2424,0.87,0.1343,11,133,144,133
16647,12/1/2012,4,1,12,9,0,6,0,2,0.26,0.2424,0.93,0.2537,34,159,193,159
16648,12/1/2012,4,1,12,10,0,6,0,2,0.28,0.2727,0.89,0.1642,45,211,256,211
16649,12/1/2012,4,1,12,11,0,6,0,2,0.32,0.3333,0.76,0.1045,74,318,392,318
16650,12/1/2012,4,1,12,12,0,6,0,2,0.32,0.3333,0.81,0.0896,119,327,446,327
16651,12/1/2012,4,1,12,13,0,6,0,2,0.34,0.3636,0.76,0,123,386,509,386
16652,12/1/2012,4,1,12,14,0,6,0,2,0.36,0.3788,0.71,0,110,369,479,369
16653,12/1/2012,4,1,12,15,0,6,0,2,0.4,0.4091,0.62,0,113,371,484,371
16654,12/1/2012,4,1,12,16,0,6,0,2,0.38,0.3939,0.66,0,89,354,443,354
16655,12/1/2012,4,1,12,17,0,6,0,2,0.34,0.3485,0.76,0.1045,50,270,320,270
16656,12/1/2012,4,1,12,18,0,6,0,2,0.34,0.3636,0.76,0,42,255,297,255
16657,12/1/2012,4,1,12,19,0,6,0,2,0.32,0.3485,0.81,0,30,219,249,219
16658,12/1/2012,4,1,12,20,0,6,0,1,0.32,0.3485,0.81,0,28,170,198,170
16659,12/1/2012,4,1,12,21,0,6,0,2,0.3,0.3333,0.87,0,23,135,158,135
16660,12/1/2012,4,1,12,22,0,6,0,2,0.3,0.3333,0.87,0,17,130,147,130
16661,12/1/2012,4,1,12,23,0,6,0,2,0.32,0.3485,0.81,0,10,116,126,116
16662,12/2/2012,4,1,12,0,0,0,0,2,0.3,0.3182,0.87,0.0896,9,108,117,108
16663,12/2/2012,4,1,12,1,0,0,0,2,0.3,0.3182,0.87,0.0896,10,84,94,84
16664,12/2/2012,4,1,12,2,0,0,0,2,0.3,0.3333,0.87,0,2,72,74,72
16665,12/2/2012,4,1,12,3,0,0,0,2,0.26,0.303,0.93,0,4,21,25,21
16666,12/2/2012,4,1,12,4,0,0,0,2,0.26,0.303,0.93,0,1,6,7,6
16667,12/2/2012,4,1,12,5,0,0,0,2,0.26,0.303,0.93,0,1,7,8,7
16668,12/2/2012,4,1,12,6,0,0,0,2,0.24,0.2424,0.93,0.1343,1,15,16,15
16669,12/2/2012,4,1,12,7,0,0,0,2,0.24,0.2424,0.93,0.1343,5,26,31,26
16670,12/2/2012,4,1,12,8,0,0,0,2,0.26,0.2879,0.93,0.0896,12,81,93,81
16671,12/2/2012,4,1,12,9,0,0,0,2,0.28,0.2727,0.93,0.1642,37,135,172,135
16672,12/2/2012,4,1,12,10,0,0,0,2,0.3,0.3333,0.87,0,63,230,293,230
16673,12/2/2012,4,1,12,11,0,0,0,2,0.32,0.3182,0.81,0.1642,81,274,355,274
16674,12/2/2012,4,1,12,12,0,0,0,2,0.34,0.3333,0.81,0.1642,111,409,520,409
16675,12/2/2012,4,1,12,13,0,0,0,1,0.4,0.4091,0.71,0.2239,84,347,431,347
16676,12/2/2012,4,1,12,14,0,0,0,1,0.44,0.4394,0.62,0.2537,142,331,473,331
16677,12/2/2012,4,1,12,15,0,0,0,1,0.44,0.4394,0.67,0.1343,106,311,417,311
16678,12/2/2012,4,1,12,16,0,0,0,2,0.44,0.4394,0.67,0.1045,85,358,443,358
16679,12/2/2012,4,1,12,17,0,0,0,3,0.4,0.4091,0.76,0.194,59,244,303,244
16680,12/2/2012,4,1,12,18,0,0,0,2,0.44,0.4394,0.72,0.1045,25,178,203,178
16681,12/2/2012,4,1,12,19,0,0,0,2,0.4,0.4091,0.82,0.194,16,158,174,158
16682,12/2/2012,4,1,12,20,0,0,0,2,0.42,0.4242,0.82,0.194,12,142,154,142
16683,12/2/2012,4,1,12,21,0,0,0,2,0.44,0.4394,0.77,0.2239,8,91,99,91
16684,12/2/2012,4,1,12,22,0,0,0,2,0.44,0.4394,0.77,0.194,11,85,96,85
16685,12/2/2012,4,1,12,23,0,0,0,2,0.42,0.4242,0.82,0.1343,7,44,51,44
16686,12/3/2012,4,1,12,0,0,1,1,2,0.42,0.4242,0.82,0.1642,3,18,21,18
16687,12/3/2012,4,1,12,1,0,1,1,1,0.4,0.4091,0.82,0.1343,2,11,13,11
16688,12/3/2012,4,1,12,2,0,1,1,1,0.42,0.4242,0.77,0.1642,1,9,10,9
16689,12/3/2012,4,1,12,3,0,1,1,1,0.38,0.3939,0.87,0,2,6,8,6
16690,12/3/2012,4,1,12,4,0,1,1,1,0.36,0.3788,0.93,0,1,4,5,4
16691,12/3/2012,4,1,12,5,0,1,1,1,0.34,0.3485,0.93,0.0896,0,38,38,38
16692,12/3/2012,4,1,12,6,0,1,1,1,0.36,0.3788,0.93,0,2,136,138,136
16693,12/3/2012,4,1,12,7,0,1,1,2,0.34,0.3636,0.93,0,9,387,396,387
16694,12/3/2012,4,1,12,8,0,1,1,1,0.36,0.3788,0.93,0,19,712,731,712
16695,12/3/2012,4,1,12,9,0,1,1,1,0.4,0.4091,0.87,0.0896,19,289,308,289
16696,12/3/2012,4,1,12,10,0,1,1,1,0.44,0.4394,0.77,0.1343,31,105,136,105
16697,12/3/2012,4,1,12,11,0,1,1,1,0.48,0.4697,0.77,0.1343,51,182,233,182
16698,12/3/2012,4,1,12,12,0,1,1,1,0.52,0.5,0.68,0.1642,40,228,268,228
16699,12/3/2012,4,1,12,13,0,1,1,1,0.58,0.5455,0.56,0.0896,81,240,321,240
16700,12/3/2012,4,1,12,14,0,1,1,1,0.6,0.6212,0.53,0,51,209,260,209
16701,12/3/2012,4,1,12,15,0,1,1,1,0.6,0.6212,0.56,0,58,210,268,210
16702,12/3/2012,4,1,12,16,0,1,1,1,0.6,0.6212,0.53,0.1343,45,397,442,397
16703,12/3/2012,4,1,12,17,0,1,1,1,0.52,0.5,0.63,0.1045,43,665,708,665
16704,12/3/2012,4,1,12,18,0,1,1,1,0.5,0.4848,0.68,0.0896,26,666,692,666
16705,12/3/2012,4,1,12,19,0,1,1,1,0.5,0.4848,0.68,0.0896,27,444,471,444
16706,12/3/2012,4,1,12,20,0,1,1,2,0.46,0.4545,0.77,0,16,284,300,284
16707,12/3/2012,4,1,12,21,0,1,1,1,0.44,0.4394,0.82,0.194,14,207,221,207
16708,12/3/2012,4,1,12,22,0,1,1,1,0.42,0.4242,0.82,0.1045,5,139,144,139
16709,12/3/2012,4,1,12,23,0,1,1,1,0.42,0.4242,0.82,0.1045,9,93,102,93
16710,12/4/2012,4,1,12,0,0,2,1,1,0.42,0.4242,0.88,0.1045,6,49,55,49
16711,12/4/2012,4,1,12,1,0,2,1,1,0.42,0.4242,0.82,0.1045,3,22,25,22
16712,12/4/2012,4,1,12,2,0,2,1,1,0.42,0.4242,0.88,0.0896,3,5,8,5
16713,12/4/2012,4,1,12,3,0,2,1,2,0.4,0.4091,0.87,0.1343,1,3,4,3
16714,12/4/2012,4,1,12,4,0,2,1,2,0.4,0.4091,0.87,0.1343,0,7,7,7
16715,12/4/2012,4,1,12,5,0,2,1,2,0.44,0.4394,0.88,0,1,45,46,45
16716,12/4/2012,4,1,12,6,0,2,1,2,0.36,0.3788,0.93,0,3,150,153,150
16717,12/4/2012,4,1,12,7,0,2,1,1,0.42,0.4242,0.88,0.1343,7,495,502,495
16718,12/4/2012,4,1,12,8,0,2,1,2,0.44,0.4394,0.88,0.1642,21,700,721,700
16719,12/4/2012,4,1,12,9,0,2,1,1,0.46,0.4545,0.82,0.1045,19,317,336,317
16720,12/4/2012,4,1,12,10,0,2,1,1,0.46,0.4545,0.82,0.194,26,130,156,130
16721,12/4/2012,4,1,12,11,0,2,1,1,0.48,0.4697,0.77,0.194,24,183,207,183
16722,12/4/2012,4,1,12,12,0,2,1,1,0.52,0.5,0.68,0.194,39,273,312,273
16723,12/4/2012,4,1,12,13,0,2,1,2,0.54,0.5152,0.64,0.1642,39,233,272,233
16724,12/4/2012,4,1,12,14,0,2,1,2,0.58,0.5455,0.56,0.2239,39,231,270,231
16725,12/4/2012,4,1,12,15,0,2,1,2,0.6,0.6212,0.49,0.2537,56,244,300,244
16726,12/4/2012,4,1,12,16,0,2,1,1,0.58,0.5455,0.49,0.2836,44,391,435,391
16727,12/4/2012,4,1,12,17,0,2,1,1,0.52,0.5,0.59,0.2239,43,700,743,700
16728,12/4/2012,4,1,12,18,0,2,1,1,0.5,0.4848,0.63,0.2239,38,693,731,693
16729,12/4/2012,4,1,12,19,0,2,1,1,0.48,0.4697,0.67,0.2239,46,414,460,414
16730,12/4/2012,4,1,12,20,0,2,1,2,0.5,0.4848,0.63,0.2239,34,272,306,272
16731,12/4/2012,4,1,12,21,0,2,1,2,0.5,0.4848,0.63,0.2537,28,252,280,252
16732,12/4/2012,4,1,12,22,0,2,1,2,0.5,0.4848,0.63,0.2985,26,155,181,155
16733,12/4/2012,4,1,12,23,0,2,1,1,0.48,0.4697,0.67,0.2537,5,91,96,91
16734,12/5/2012,4,1,12,0,0,3,1,1,0.5,0.4848,0.59,0.2836,6,31,37,31
16735,12/5/2012,4,1,12,1,0,3,1,1,0.52,0.5,0.55,0.3284,0,11,11,11
16736,12/5/2012,4,1,12,2,0,3,1,1,0.46,0.4545,0.67,0.1642,2,7,9,7
16737,12/5/2012,4,1,12,3,0,3,1,1,0.48,0.4697,0.67,0.1343,0,7,7,7
16738,12/5/2012,4,1,12,4,0,3,1,1,0.5,0.4848,0.63,0.4478,1,9,10,9
16739,12/5/2012,4,1,12,5,0,3,1,1,0.5,0.4848,0.59,0.2836,1,48,49,48
16740,12/5/2012,4,1,12,6,0,3,1,3,0.48,0.4697,0.55,0.3881,5,119,124,119
16741,12/5/2012,4,1,12,7,0,3,1,3,0.46,0.4545,0.59,0.2985,9,389,398,389
16742,12/5/2012,4,1,12,8,0,3,1,2,0.44,0.4394,0.58,0.2836,22,737,759,737
16743,12/5/2012,4,1,12,9,0,3,1,2,0.44,0.4394,0.51,0.2239,26,362,388,362
16744,12/5/2012,4,1,12,10,0,3,1,2,0.44,0.4394,0.47,0.3582,14,127,141,127
16745,12/5/2012,4,1,12,11,0,3,1,1,0.44,0.4394,0.44,0.2836,11,161,172,161
16746,12/5/2012,4,1,12,12,0,3,1,1,0.44,0.4394,0.41,0.2836,24,208,232,208
16747,12/5/2012,4,1,12,13,0,3,1,1,0.46,0.4545,0.41,0.2836,14,200,214,200
16748,12/5/2012,4,1,12,14,0,3,1,1,0.48,0.4697,0.33,0.4925,39,179,218,179
16749,12/5/2012,4,1,12,15,0,3,1,1,0.48,0.4697,0.33,0.2836,20,265,285,265
16750,12/5/2012,4,1,12,16,0,3,1,1,0.46,0.4545,0.33,0.2836,23,354,377,354
16751,12/5/2012,4,1,12,17,0,3,1,1,0.44,0.4394,0.35,0.2836,29,576,605,576
16752,12/5/2012,4,1,12,18,0,3,1,1,0.42,0.4242,0.35,0.4478,29,580,609,580
16753,12/5/2012,4,1,12,19,0,3,1,1,0.38,0.3939,0.43,0.3582,14,400,414,400
16754,12/5/2012,4,1,12,20,0,3,1,1,0.34,0.303,0.46,0.3881,19,274,293,274
16755,12/5/2012,4,1,12,21,0,3,1,1,0.34,0.303,0.46,0.4179,14,184,198,184
16756,12/5/2012,4,1,12,22,0,3,1,1,0.32,0.2879,0.45,0.3881,4,101,105,101
16757,12/5/2012,4,1,12,23,0,3,1,1,0.3,0.2727,0.49,0.3881,5,69,74,69
16758,12/6/2012,4,1,12,0,0,4,1,1,0.26,0.2424,0.48,0.2836,1,43,44,43
16759,12/6/2012,4,1,12,1,0,4,1,1,0.26,0.2424,0.48,0.2836,0,16,16,16
16760,12/6/2012,4,1,12,2,0,4,1,1,0.24,0.2121,0.52,0.2836,0,9,9,9
16761,12/6/2012,4,1,12,3,0,4,1,1,0.22,0.2273,0.55,0.194,0,2,2,2
16762,12/6/2012,4,1,12,4,0,4,1,1,0.22,0.2121,0.55,0.2985,1,8,9,8
16763,12/6/2012,4,1,12,5,0,4,1,1,0.22,0.2121,0.55,0.2836,0,32,32,32
16764,12/6/2012,4,1,12,6,0,4,1,1,0.22,0.2121,0.55,0.2985,2,122,124,122
16765,12/6/2012,4,1,12,7,0,4,1,1,0.22,0.2121,0.51,0.2985,8,381,389,381
16766,12/6/2012,4,1,12,8,0,4,1,1,0.22,0.2121,0.51,0.2985,13,646,659,646
16767,12/6/2012,4,1,12,9,0,4,1,1,0.24,0.2273,0.48,0.194,19,257,276,257
16768,12/6/2012,4,1,12,10,0,4,1,1,0.24,0.2273,0.52,0.194,23,122,145,122
16769,12/6/2012,4,1,12,11,0,4,1,1,0.26,0.2576,0.48,0.1642,16,162,178,162
16770,12/6/2012,4,1,12,12,0,4,1,1,0.28,0.3182,0.41,0,29,206,235,206
16771,12/6/2012,4,1,12,13,0,4,1,1,0.3,0.3333,0.39,0,33,212,245,212
16772,12/6/2012,4,1,12,14,0,4,1,1,0.3,0.3182,0.42,0.0896,37,175,212,175
16773,12/6/2012,4,1,12,15,0,4,1,1,0.32,0.3485,0.39,0,38,232,270,232
16774,12/6/2012,4,1,12,16,0,4,1,1,0.32,0.3485,0.42,0,39,292,331,292
16775,12/6/2012,4,1,12,17,0,4,1,1,0.3,0.3182,0.45,0.1045,31,586,617,586
16776,12/6/2012,4,1,12,18,0,4,1,1,0.28,0.2727,0.45,0.1642,23,542,565,542
16777,12/6/2012,4,1,12,19,0,4,1,1,0.26,0.2576,0.6,0.194,13,360,373,360
16778,12/6/2012,4,1,12,20,0,4,1,2,0.24,0.2576,0.6,0.1045,5,222,227,222
16779,12/6/2012,4,1,12,21,0,4,1,2,0.24,0.2424,0.6,0.1343,7,184,191,184
16780,12/6/2012,4,1,12,22,0,4,1,1,0.24,0.2424,0.65,0.1642,2,131,133,131
16781,12/6/2012,4,1,12,23,0,4,1,1,0.24,0.2424,0.65,0.1642,0,93,93,93
16782,12/7/2012,4,1,12,0,0,5,1,1,0.24,0.2576,0.7,0.1045,3,45,48,45
16783,12/7/2012,4,1,12,1,0,5,1,2,0.24,0.2273,0.7,0.194,2,26,28,26
16784,12/7/2012,4,1,12,2,0,5,1,2,0.26,0.2727,0.7,0.1343,0,11,11,11
16785,12/7/2012,4,1,12,3,0,5,1,2,0.26,0.2576,0.81,0.194,0,5,5,5
16786,12/7/2012,4,1,12,4,0,5,1,1,0.26,0.2727,0.75,0.1045,0,10,10,10
16787,12/7/2012,4,1,12,5,0,5,1,2,0.26,0.2727,0.81,0.1045,1,25,26,25
16788,12/7/2012,4,1,12,6,0,5,1,2,0.28,0.2727,0.75,0.1642,0,84,84,84
16789,12/7/2012,4,1,12,7,0,5,1,3,0.28,0.2727,0.81,0.1642,3,212,215,212
16790,12/7/2012,4,1,12,8,0,5,1,2,0.3,0.2879,0.75,0.194,11,430,441,430
16791,12/7/2012,4,1,12,9,0,5,1,2,0.3,0.303,0.81,0.1343,10,291,301,291
16792,12/7/2012,4,1,12,10,0,5,1,2,0.32,0.3182,0.76,0.1642,16,150,166,150
16793,12/7/2012,4,1,12,11,0,5,1,2,0.32,0.3182,0.76,0.194,20,183,203,183
16794,12/7/2012,4,1,12,12,0,5,1,2,0.34,0.3333,0.71,0.194,36,204,240,204
16795,12/7/2012,4,1,12,13,0,5,1,2,0.36,0.3485,0.66,0.1343,23,197,220,197
16796,12/7/2012,4,1,12,14,0,5,1,2,0.36,0.3485,0.71,0.1642,40,175,215,175
16797,12/7/2012,4,1,12,15,0,5,1,2,0.36,0.3485,0.71,0.1642,34,269,303,269
16798,12/7/2012,4,1,12,16,0,5,1,1,0.36,0.3485,0.76,0.1343,39,336,375,336
16799,12/7/2012,4,1,12,17,0,5,1,2,0.38,0.3939,0.66,0,29,539,568,539
16800,12/7/2012,4,1,12,18,0,5,1,2,0.38,0.3939,0.71,0.1045,25,473,498,473
16801,12/7/2012,4,1,12,19,0,5,1,2,0.38,0.3939,0.76,0,15,337,352,337
16802,12/7/2012,4,1,12,20,0,5,1,3,0.38,0.3939,0.76,0.1045,12,229,241,229
16803,12/7/2012,4,1,12,21,0,5,1,2,0.36,0.3636,0.93,0.1045,9,162,171,162
16804,12/7/2012,4,1,12,22,0,5,1,2,0.36,0.3636,0.93,0.0896,15,150,165,150
16805,12/7/2012,4,1,12,23,0,5,1,2,0.36,0.3636,0.93,0.0896,6,116,122,116
16806,12/8/2012,4,1,12,0,0,6,0,2,0.36,0.3636,0.93,0.0896,5,98,103,98
16807,12/8/2012,4,1,12,1,0,6,0,2,0.36,0.3485,0.93,0.1343,16,84,100,84
16808,12/8/2012,4,1,12,2,0,6,0,2,0.36,0.3485,0.93,0.1343,3,67,70,67
16809,12/8/2012,4,1,12,3,0,6,0,2,0.36,0.3636,0.93,0.1045,6,23,29,23
16810,12/8/2012,4,1,12,4,0,6,0,2,0.36,0.3788,0.93,0,3,9,12,9
16811,12/8/2012,4,1,12,5,0,6,0,2,0.36,0.3636,0.93,0.1045,2,4,6,4
16812,12/8/2012,4,1,12,6,0,6,0,2,0.36,0.3636,0.93,0.1045,1,19,20,19
16813,12/8/2012,4,1,12,7,0,6,0,2,0.36,0.3636,1,0.0896,3,36,39,36
16814,12/8/2012,4,1,12,8,0,6,0,2,0.38,0.3939,0.94,0.0896,5,106,111,106
16815,12/8/2012,4,1,12,9,0,6,0,2,0.38,0.3939,0.94,0,17,153,170,153
16816,12/8/2012,4,1,12,10,0,6,0,2,0.4,0.4091,0.87,0.1343,43,244,287,244
16817,12/8/2012,4,1,12,11,0,6,0,2,0.4,0.4091,0.87,0.1045,63,341,404,341
16818,12/8/2012,4,1,12,12,0,6,0,2,0.4,0.4091,0.87,0.2239,122,364,486,364
16819,12/8/2012,4,1,12,13,0,6,0,2,0.4,0.4091,0.87,0.1642,148,399,547,399
16820,12/8/2012,4,1,12,14,0,6,0,2,0.4,0.4091,0.87,0.2836,164,378,542,378
16821,12/8/2012,4,1,12,15,0,6,0,1,0.42,0.4242,0.82,0.1642,167,374,541,374
16822,12/8/2012,4,1,12,16,0,6,0,1,0.42,0.4242,0.82,0.1642,139,368,507,368
16823,12/8/2012,4,1,12,17,0,6,0,1,0.38,0.3939,0.87,0.1343,77,268,345,268
16824,12/8/2012,4,1,12,18,0,6,0,1,0.4,0.4091,0.87,0.1045,40,264,304,264
16825,12/8/2012,4,1,12,19,0,6,0,1,0.4,0.4091,0.87,0,34,212,246,212
16826,12/8/2012,4,1,12,20,0,6,0,2,0.36,0.3788,1,0,20,162,182,162
16827,12/8/2012,4,1,12,21,0,6,0,2,0.36,0.3788,1,0,34,175,209,175
16828,12/8/2012,4,1,12,22,0,6,0,2,0.38,0.3939,0.94,0.1045,23,137,160,137
16829,12/8/2012,4,1,12,23,0,6,0,2,0.4,0.4091,0.94,0,18,144,162,144
16830,12/9/2012,4,1,12,0,0,0,0,2,0.4,0.4091,0.87,0.1343,15,103,118,103
16831,12/9/2012,4,1,12,1,0,0,0,2,0.4,0.4091,0.87,0.1045,17,85,102,85
16832,12/9/2012,4,1,12,2,0,0,0,2,0.4,0.4091,0.87,0.1045,8,70,78,70
16833,12/9/2012,4,1,12,3,0,0,0,2,0.4,0.4091,0.87,0.1045,14,34,48,34
16834,12/9/2012,4,1,12,4,0,0,0,2,0.4,0.4091,0.94,0.1045,1,11,12,11
16835,12/9/2012,4,1,12,5,0,0,0,2,0.4,0.4091,0.87,0.1045,0,8,8,8
16836,12/9/2012,4,1,12,6,0,0,0,3,0.4,0.4091,0.94,0.1045,0,6,6,6
16837,12/9/2012,4,1,12,7,0,0,0,3,0.4,0.4091,0.87,0.2239,1,22,23,22
16838,12/9/2012,4,1,12,8,0,0,0,3,0.4,0.4091,0.87,0.1642,1,68,69,68
16839,12/9/2012,4,1,12,9,0,0,0,2,0.4,0.4091,0.87,0.2537,9,94,103,94
16840,12/9/2012,4,1,12,10,0,0,0,2,0.4,0.4091,0.87,0.2836,39,180,219,180
16841,12/9/2012,4,1,12,11,0,0,0,2,0.4,0.4091,0.87,0.2985,40,210,250,210
16842,12/9/2012,4,1,12,12,0,0,0,2,0.4,0.4091,0.82,0.2985,60,255,315,255
16843,12/9/2012,4,1,12,13,0,0,0,2,0.38,0.3939,0.87,0.2836,65,220,285,220
16844,12/9/2012,4,1,12,14,0,0,0,2,0.38,0.3939,0.87,0.194,42,190,232,190
16845,12/9/2012,4,1,12,15,0,0,0,3,0.36,0.3485,0.93,0.1642,25,200,225,200
16846,12/9/2012,4,1,12,16,0,0,0,3,0.36,0.3485,0.93,0.1642,33,220,253,220
16847,12/9/2012,4,1,12,17,0,0,0,3,0.36,0.3485,0.93,0.1343,20,209,229,209
16848,12/9/2012,4,1,12,18,0,0,0,3,0.36,0.3636,0.93,0.0896,17,181,198,181
16849,12/9/2012,4,1,12,19,0,0,0,3,0.38,0.3939,0.94,0.0896,12,110,122,110
16850,12/9/2012,4,1,12,20,0,0,0,3,0.36,0.3636,1,0.0896,6,102,108,102
16851,12/9/2012,4,1,12,21,0,0,0,2,0.36,0.3636,1,0.1045,10,86,96,86
16852,12/9/2012,4,1,12,22,0,0,0,3,0.36,0.3636,0.93,0.1045,3,75,78,75
16853,12/9/2012,4,1,12,23,0,0,0,3,0.36,0.3636,1,0.0896,3,48,51,48
16854,12/10/2012,4,1,12,0,0,1,1,3,0.36,0.3636,1,0.0896,0,20,20,20
16855,12/10/2012,4,1,12,1,0,1,1,2,0.36,0.3788,1,0,0,4,4,4
16856,12/10/2012,4,1,12,2,0,1,1,2,0.38,0.3939,0.94,0.1045,2,3,5,3
16857,12/10/2012,4,1,12,3,0,1,1,2,0.38,0.3939,0.94,0.1045,0,4,4,4
16858,12/10/2012,4,1,12,4,0,1,1,2,0.38,0.3939,0.94,0.1045,3,9,12,9
16859,12/10/2012,4,1,12,5,0,1,1,2,0.38,0.3939,0.94,0.1045,0,27,27,27
16860,12/10/2012,4,1,12,6,0,1,1,2,0.38,0.3939,0.94,0.1642,2,121,123,121
16861,12/10/2012,4,1,12,7,0,1,1,2,0.38,0.3939,0.94,0.2537,3,291,294,291
16862,12/10/2012,4,1,12,8,0,1,1,2,0.42,0.4242,1,0.2537,9,575,584,575
16863,12/10/2012,4,1,12,9,0,1,1,2,0.42,0.4242,1,0.2239,11,273,284,273
16864,12/10/2012,4,1,12,10,0,1,1,2,0.44,0.4394,0.94,0.2239,12,121,133,121
16865,12/10/2012,4,1,12,11,0,1,1,3,0.46,0.4545,0.94,0.2239,8,126,134,126
16866,12/10/2012,4,1,12,12,0,1,1,3,0.44,0.4394,1,0.2239,23,150,173,150
16867,12/10/2012,4,1,12,13,0,1,1,3,0.44,0.4394,1,0.2239,30,190,220,190
16868,12/10/2012,4,1,12,14,0,1,1,2,0.5,0.4848,0.94,0.2239,31,179,210,179
16869,12/10/2012,4,1,12,15,0,1,1,2,0.5,0.4848,0.87,0.1642,29,207,236,207
16870,12/10/2012,4,1,12,16,0,1,1,2,0.5,0.4848,0.88,0.1045,37,308,345,308
16871,12/10/2012,4,1,12,17,0,1,1,2,0.48,0.4697,0.82,0.2836,38,578,616,578
16872,12/10/2012,4,1,12,18,0,1,1,2,0.46,0.4545,0.88,0.2836,20,544,564,544
16873,12/10/2012,4,1,12,19,0,1,1,1,0.52,0.5,0.77,0.2836,18,409,427,409
16874,12/10/2012,4,1,12,20,0,1,1,1,0.46,0.4545,0.88,0.2537,13,287,300,287
16875,12/10/2012,4,1,12,21,0,1,1,2,0.46,0.4545,0.94,0.194,21,224,245,224
16876,12/10/2012,4,1,12,22,0,1,1,2,0.5,0.4848,0.82,0.2239,11,115,126,115
16877,12/10/2012,4,1,12,23,0,1,1,1,0.46,0.4545,0.88,0.2537,8,76,84,76
16878,12/11/2012,4,1,12,0,0,2,1,3,0.46,0.4545,0.77,0.4627,2,29,31,29
16879,12/11/2012,4,1,12,1,0,2,1,1,0.42,0.4242,0.71,0.4478,1,7,8,7
16880,12/11/2012,4,1,12,2,0,2,1,2,0.4,0.4091,0.66,0.3284,0,1,1,1
16881,12/11/2012,4,1,12,3,0,2,1,3,0.36,0.3333,0.76,0.2836,0,3,3,3
16882,12/11/2012,4,1,12,4,0,2,1,2,0.34,0.3182,0.76,0.2836,0,8,8,8
16883,12/11/2012,4,1,12,5,0,2,1,3,0.34,0.303,0.71,0.3284,1,40,41,40
16884,12/11/2012,4,1,12,6,0,2,1,2,0.34,0.303,0.71,0.2985,0,118,118,118
16885,12/11/2012,4,1,12,7,0,2,1,1,0.34,0.303,0.66,0.4179,8,372,380,372
16886,12/11/2012,4,1,12,8,0,2,1,2,0.34,0.303,0.61,0.2985,16,708,724,708
16887,12/11/2012,4,1,12,9,0,2,1,1,0.34,0.303,0.61,0.3881,12,322,334,322
16888,12/11/2012,4,1,12,10,0,2,1,1,0.36,0.3333,0.57,0.3284,12,142,154,142
16889,12/11/2012,4,1,12,11,0,2,1,2,0.36,0.3333,0.53,0.3582,28,145,173,145
16890,12/11/2012,4,1,12,12,0,2,1,2,0.36,0.3182,0.53,0.4478,13,213,226,213
16891,12/11/2012,4,1,12,13,0,2,1,2,0.38,0.3939,0.5,0.2239,28,226,254,226
16892,12/11/2012,4,1,12,14,0,2,1,2,0.38,0.3939,0.5,0.2239,19,185,204,185
16893,12/11/2012,4,1,12,15,0,2,1,2,0.38,0.3939,0.5,0.2239,20,250,270,250
16894,12/11/2012,4,1,12,16,0,2,1,2,0.38,0.3939,0.5,0.2239,24,334,358,334
16895,12/11/2012,4,1,12,17,0,2,1,1,0.32,0.303,0.53,0.2239,21,580,601,580
16896,12/11/2012,4,1,12,18,0,2,1,1,0.32,0.303,0.53,0.2239,23,523,546,523
16897,12/11/2012,4,1,12,19,0,2,1,1,0.32,0.303,0.53,0.2239,21,412,433,412
16898,12/11/2012,4,1,12,20,0,2,1,1,0.32,0.303,0.53,0.2239,9,248,257,248
16899,12/11/2012,4,1,12,21,0,2,1,1,0.32,0.3182,0.53,0.194,14,193,207,193
16900,12/11/2012,4,1,12,22,0,2,1,1,0.3,0.2879,0.56,0.2239,6,100,106,100
16901,12/11/2012,4,1,12,23,0,2,1,1,0.3,0.2879,0.52,0.2239,4,60,64,60
16902,12/12/2012,4,1,12,0,0,3,1,1,0.3,0.303,0.52,0.1642,1,33,34,33
16903,12/12/2012,4,1,12,1,0,3,1,1,0.28,0.2727,0.61,0.2239,3,18,21,18
16904,12/12/2012,4,1,12,2,0,3,1,1,0.28,0.2727,0.56,0.1642,5,4,9,4
16905,12/12/2012,4,1,12,3,0,3,1,1,0.26,0.2727,0.6,0.1343,3,7,10,7
16906,12/12/2012,4,1,12,4,0,3,1,1,0.26,0.303,0.6,0,0,4,4,4
16907,12/12/2012,4,1,12,5,0,3,1,1,0.26,0.2576,0.6,0.194,0,37,37,37
16908,12/12/2012,4,1,12,6,0,3,1,2,0.26,0.2424,0.6,0.2537,2,126,128,126
16909,12/12/2012,4,1,12,7,0,3,1,2,0.26,0.2576,0.6,0.194,3,366,369,366
16910,12/12/2012,4,1,12,8,0,3,1,2,0.26,0.2576,0.65,0.1642,18,670,688,670
16911,12/12/2012,4,1,12,9,0,3,1,2,0.28,0.2879,0.61,0.1343,13,272,285,272
16912,12/12/2012,4,1,12,10,0,3,1,2,0.3,0.303,0.56,0.1642,20,116,136,116
16913,12/12/2012,4,1,12,11,0,3,1,2,0.32,0.303,0.49,0.2239,24,148,172,148
16914,12/12/2012,4,1,12,12,0,3,1,2,0.34,0.3636,0.42,0,14,218,232,218
16915,12/12/2012,4,1,12,13,0,3,1,2,0.34,0.3636,0.42,0,18,220,238,220
16916,12/12/2012,4,1,12,14,0,3,1,2,0.34,0.3636,0.46,0,34,191,225,191
16917,12/12/2012,4,1,12,15,0,3,1,2,0.34,0.3485,0.46,0.1045,21,207,228,207
16918,12/12/2012,4,1,12,16,0,3,1,2,0.34,0.3333,0.46,0.1343,19,310,329,310
16919,12/12/2012,4,1,12,17,0,3,1,2,0.32,0.303,0.53,0.2239,21,540,561,540
16920,12/12/2012,4,1,12,18,0,3,1,2,0.32,0.303,0.49,0.2239,25,515,540,515
16921,12/12/2012,4,1,12,19,0,3,1,2,0.3,0.2879,0.56,0.2239,18,384,402,384
16922,12/12/2012,4,1,12,20,0,3,1,1,0.3,0.2879,0.52,0.2836,25,243,268,243
16923,12/12/2012,4,1,12,21,0,3,1,2,0.3,0.2879,0.52,0.2537,16,186,202,186
16924,12/12/2012,4,1,12,22,0,3,1,2,0.3,0.2879,0.52,0.2239,4,118,122,118
16925,12/12/2012,4,1,12,23,0,3,1,2,0.28,0.2727,0.56,0.2239,3,76,79,76
16926,12/13/2012,4,1,12,0,0,4,1,2,0.28,0.2727,0.52,0.2239,1,31,32,31
16927,12/13/2012,4,1,12,1,0,4,1,2,0.28,0.2576,0.52,0.2836,4,19,23,19
16928,12/13/2012,4,1,12,2,0,4,1,2,0.26,0.2424,0.56,0.2537,3,5,8,5
16929,12/13/2012,4,1,12,3,0,4,1,2,0.26,0.2424,0.56,0.2836,0,2,2,2
16930,12/13/2012,4,1,12,4,0,4,1,2,0.26,0.2576,0.56,0.194,0,8,8,8
16931,12/13/2012,4,1,12,5,0,4,1,2,0.26,0.2576,0.56,0.1642,2,31,33,31
16932,12/13/2012,4,1,12,6,0,4,1,1,0.26,0.2424,0.56,0.2537,2,112,114,112
16933,12/13/2012,4,1,12,7,0,4,1,1,0.24,0.2273,0.6,0.2239,5,380,385,380
16934,12/13/2012,4,1,12,8,0,4,1,1,0.24,0.2273,0.6,0.194,24,655,679,655
16935,12/13/2012,4,1,12,9,0,4,1,1,0.28,0.2727,0.52,0.2537,25,300,325,300
16936,12/13/2012,4,1,12,10,0,4,1,1,0.32,0.303,0.45,0.2836,28,139,167,139
16937,12/13/2012,4,1,12,11,0,4,1,1,0.34,0.3182,0.42,0.2537,25,164,189,164
16938,12/13/2012,4,1,12,12,0,4,1,1,0.36,0.3333,0.4,0.2537,30,252,282,252
16939,12/13/2012,4,1,12,13,0,4,1,1,0.36,0.3485,0.34,0.194,41,230,271,230
16940,12/13/2012,4,1,12,14,0,4,1,1,0.36,0.3485,0.34,0.1642,31,211,242,211
16941,12/13/2012,4,1,12,15,0,4,1,1,0.36,0.3485,0.34,0.1343,40,240,280,240
16942,12/13/2012,4,1,12,16,0,4,1,1,0.34,0.3485,0.39,0.1045,50,356,406,356
16943,12/13/2012,4,1,12,17,0,4,1,1,0.32,0.3333,0.42,0.1045,43,507,550,507
16944,12/13/2012,4,1,12,18,0,4,1,1,0.32,0.3333,0.42,0.1045,20,446,466,446
16945,12/13/2012,4,1,12,19,0,4,1,1,0.3,0.303,0.45,0.1642,20,328,348,328
16946,12/13/2012,4,1,12,20,0,4,1,1,0.3,0.3333,0.45,0,6,235,241,235
16947,12/13/2012,4,1,12,21,0,4,1,1,0.28,0.3182,0.48,0,13,200,213,200
16948,12/13/2012,4,1,12,22,0,4,1,1,0.26,0.2879,0.6,0.0896,7,141,148,141
16949,12/13/2012,4,1,12,23,0,4,1,1,0.26,0.303,0.6,0,5,115,120,115
16950,12/14/2012,4,1,12,0,0,5,1,1,0.22,0.2576,0.64,0.0896,4,43,47,43
16951,12/14/2012,4,1,12,1,0,5,1,1,0.22,0.2576,0.69,0.0896,0,26,26,26
16952,12/14/2012,4,1,12,2,0,5,1,1,0.22,0.2727,0.69,0,3,6,9,6
16953,12/14/2012,4,1,12,3,0,5,1,1,0.2,0.2273,0.69,0.1045,0,12,12,12
16954,12/14/2012,4,1,12,4,0,5,1,1,0.2,0.2273,0.75,0.0896,1,9,10,9
16955,12/14/2012,4,1,12,5,0,5,1,1,0.2,0.2273,0.69,0.1045,0,34,34,34
16956,12/14/2012,4,1,12,6,0,5,1,1,0.16,0.1818,0.8,0.1045,1,112,113,112
16957,12/14/2012,4,1,12,7,0,5,1,1,0.2,0.2121,0.72,0.1045,3,305,308,305
16958,12/14/2012,4,1,12,8,0,5,1,1,0.2,0.2273,0.69,0.0896,13,623,636,623
16959,12/14/2012,4,1,12,9,0,5,1,1,0.24,0.2424,0.75,0.1343,13,330,343,330
16960,12/14/2012,4,1,12,10,0,5,1,1,0.26,0.2576,0.81,0.194,28,162,190,162
16961,12/14/2012,4,1,12,11,0,5,1,1,0.32,0.303,0.65,0.194,31,180,211,180
16962,12/14/2012,4,1,12,12,0,5,1,1,0.36,0.3485,0.5,0.194,29,244,273,244
16963,12/14/2012,4,1,12,13,0,5,1,1,0.36,0.3485,0.5,0.2239,39,274,313,274
16964,12/14/2012,4,1,12,14,0,5,1,1,0.4,0.4091,0.43,0.194,48,251,299,251
16965,12/14/2012,4,1,12,15,0,5,1,1,0.4,0.4091,0.47,0.1642,57,252,309,252
16966,12/14/2012,4,1,12,16,0,5,1,1,0.38,0.3939,0.54,0.194,45,372,417,372
16967,12/14/2012,4,1,12,17,0,5,1,1,0.34,0.3333,0.57,0.1642,40,582,622,582
16968,12/14/2012,4,1,12,18,0,5,1,1,0.36,0.3485,0.46,0.1343,23,432,455,432
16969,12/14/2012,4,1,12,19,0,5,1,1,0.34,0.3485,0.53,0.0896,17,302,319,302
16970,12/14/2012,4,1,12,20,0,5,1,1,0.32,0.3333,0.61,0.1343,12,209,221,209
16971,12/14/2012,4,1,12,21,0,5,1,1,0.3,0.303,0.75,0.1642,7,165,172,165
16972,12/14/2012,4,1,12,22,0,5,1,1,0.28,0.2879,0.75,0.1045,4,134,138,134
16973,12/14/2012,4,1,12,23,0,5,1,1,0.28,0.303,0.75,0.0896,11,123,134,123
16974,12/15/2012,4,1,12,0,0,6,0,1,0.3,0.3333,0.7,0,4,90,94,90
16975,12/15/2012,4,1,12,1,0,6,0,2,0.26,0.2879,0.81,0.0896,9,86,95,86
16976,12/15/2012,4,1,12,2,0,6,0,1,0.26,0.303,0.81,0,6,63,69,63
16977,12/15/2012,4,1,12,3,0,6,0,2,0.24,0.2879,0.81,0,5,18,23,18
16978,12/15/2012,4,1,12,4,0,6,0,2,0.24,0.2576,0.87,0.1045,1,5,6,5
16979,12/15/2012,4,1,12,5,0,6,0,2,0.26,0.303,0.75,0,0,3,3,3
16980,12/15/2012,4,1,12,6,0,6,0,2,0.24,0.2879,0.75,0,0,11,11,11
16981,12/15/2012,4,1,12,7,0,6,0,2,0.24,0.2576,0.75,0.0896,1,47,48,47
16982,12/15/2012,4,1,12,8,0,6,0,2,0.26,0.2879,0.75,0.0896,8,111,119,111
16983,12/15/2012,4,1,12,9,0,6,0,1,0.26,0.2727,0.75,0.1045,17,203,220,203
16984,12/15/2012,4,1,12,10,0,6,0,1,0.32,0.3182,0.61,0.1642,23,250,273,250
16985,12/15/2012,4,1,12,11,0,6,0,1,0.34,0.3485,0.61,0.0896,66,327,393,327
16986,12/15/2012,4,1,12,12,0,6,0,1,0.38,0.3939,0.5,0.0896,89,364,453,364
16987,12/15/2012,4,1,12,13,0,6,0,1,0.38,0.3939,0.54,0.2537,88,368,456,368
16988,12/15/2012,4,1,12,14,0,6,0,1,0.4,0.4091,0.5,0.1642,92,334,426,334
16989,12/15/2012,4,1,12,15,0,6,0,1,0.42,0.4242,0.47,0,95,352,447,352
16990,12/15/2012,4,1,12,16,0,6,0,1,0.4,0.4091,0.5,0.1343,85,328,413,328
16991,12/15/2012,4,1,12,17,0,6,0,1,0.4,0.4091,0.5,0.2239,35,274,309,274
16992,12/15/2012,4,1,12,18,0,6,0,1,0.38,0.3939,0.58,0.1642,40,232,272,232
16993,12/15/2012,4,1,12,19,0,6,0,1,0.36,0.3485,0.62,0.1343,32,225,257,225
16994,12/15/2012,4,1,12,20,0,6,0,2,0.36,0.3485,0.57,0.194,23,178,201,178
16995,12/15/2012,4,1,12,21,0,6,0,1,0.36,0.3485,0.62,0.1343,15,169,184,169
16996,12/15/2012,4,1,12,22,0,6,0,1,0.36,0.3485,0.62,0.194,22,134,156,134
16997,12/15/2012,4,1,12,23,0,6,0,2,0.36,0.3485,0.62,0.1343,11,108,119,108
16998,12/16/2012,4,1,12,0,0,0,0,2,0.36,0.3788,0.62,0,8,102,110,102
16999,12/16/2012,4,1,12,1,0,0,0,3,0.34,0.3485,0.76,0.1045,14,82,96,82
17000,12/16/2012,4,1,12,2,0,0,0,2,0.34,0.3485,0.87,0.0896,8,79,87,79
17001,12/16/2012,4,1,12,3,0,0,0,2,0.34,0.3333,0.87,0.194,1,37,38,37
17002,12/16/2012,4,1,12,4,0,0,0,2,0.34,0.3636,0.87,0,1,10,11,10
17003,12/16/2012,4,1,12,5,0,0,0,2,0.34,0.3636,0.87,0,0,9,9,9
17004,12/16/2012,4,1,12,6,0,0,0,2,0.34,0.3636,0.87,0,0,6,6,6
17005,12/16/2012,4,1,12,7,0,0,0,2,0.34,0.3485,0.87,0.0896,5,22,27,22
17006,12/16/2012,4,1,12,8,0,0,0,2,0.36,0.3485,0.87,0.1343,12,76,88,76
17007,12/16/2012,4,1,12,9,0,0,0,2,0.36,0.3485,0.87,0.1343,19,113,132,113
17008,12/16/2012,4,1,12,10,0,0,0,2,0.36,0.3485,0.87,0.1343,42,215,257,215
17009,12/16/2012,4,1,12,11,0,0,0,2,0.36,0.3485,0.87,0.1343,47,248,295,248
17010,12/16/2012,4,1,12,12,0,0,0,2,0.38,0.3939,0.82,0.194,67,350,417,350
17011,12/16/2012,4,1,12,13,0,0,0,2,0.38,0.3939,0.76,0.194,67,289,356,289
17012,12/16/2012,4,1,12,14,0,0,0,2,0.38,0.3939,0.76,0.1343,50,260,310,260
17013,12/16/2012,4,1,12,15,0,0,0,2,0.38,0.3939,0.82,0.1045,46,292,338,292
17014,12/16/2012,4,1,12,16,0,0,0,2,0.38,0.3939,0.82,0.1045,66,334,400,334
17015,12/16/2012,4,1,12,17,0,0,0,2,0.38,0.3939,0.82,0.1045,29,214,243,214
17016,12/16/2012,4,1,12,18,0,0,0,3,0.38,0.3939,0.82,0.1045,8,99,107,99
17017,12/16/2012,4,1,12,19,0,0,0,1,0.36,0.3485,0.93,0.1343,10,99,109,99
17018,12/16/2012,4,1,12,20,0,0,0,2,0.38,0.3939,0.82,0,14,108,122,108
17019,12/16/2012,4,1,12,21,0,0,0,2,0.36,0.3788,0.93,0,14,92,106,92
17020,12/16/2012,4,1,12,22,0,0,0,2,0.4,0.4091,0.82,0.194,6,83,89,83
17021,12/16/2012,4,1,12,23,0,0,0,2,0.36,0.3485,0.93,0.1343,4,29,33,29
17022,12/17/2012,4,1,12,0,0,1,1,2,0.38,0.3939,0.87,0,2,26,28,26
17023,12/17/2012,4,1,12,1,0,1,1,2,0.38,0.3939,0.87,0.1045,1,14,15,14
17024,12/17/2012,4,1,12,2,0,1,1,2,0.38,0.3939,0.94,0,1,4,5,4
17025,12/17/2012,4,1,12,3,0,1,1,2,0.36,0.3788,0.93,0,0,3,3,3
17026,12/17/2012,4,1,12,4,0,1,1,3,0.36,0.3788,1,0,2,3,5,3
17027,12/17/2012,4,1,12,5,0,1,1,2,0.38,0.3939,0.87,0,0,24,24,24
17028,12/17/2012,4,1,12,6,0,1,1,2,0.36,0.3485,0.93,0.1343,1,107,108,107
17029,12/17/2012,4,1,12,7,0,1,1,2,0.36,0.3485,0.93,0.1343,5,314,319,314
17030,12/17/2012,4,1,12,8,0,1,1,2,0.38,0.3939,0.87,0.1045,10,582,592,582
17031,12/17/2012,4,1,12,9,0,1,1,2,0.4,0.4091,0.87,0,11,271,282,271
17032,12/17/2012,4,1,12,10,0,1,1,2,0.38,0.3939,0.87,0.0896,15,120,135,120
17033,12/17/2012,4,1,12,11,0,1,1,2,0.4,0.4091,0.87,0.0896,22,148,170,148
17034,12/17/2012,4,1,12,12,0,1,1,2,0.4,0.4091,0.87,0,21,211,232,211
17035,12/17/2012,4,1,12,13,0,1,1,2,0.4,0.4091,0.87,0.1343,16,194,210,194
17036,12/17/2012,4,1,12,14,0,1,1,2,0.4,0.4091,0.87,0.0896,12,169,181,169
17037,12/17/2012,4,1,12,15,0,1,1,2,0.42,0.4242,0.88,0,15,196,211,196
17038,12/17/2012,4,1,12,16,0,1,1,3,0.4,0.4091,0.94,0.2537,15,287,302,287
17039,12/17/2012,4,1,12,17,0,1,1,2,0.4,0.4091,0.94,0.2537,17,478,495,478
17040,12/17/2012,4,1,12,18,0,1,1,2,0.4,0.4091,0.94,0.0896,14,493,507,493
17041,12/17/2012,4,1,12,19,0,1,1,2,0.42,0.4242,0.88,0.1343,7,333,340,333
17042,12/17/2012,4,1,12,20,0,1,1,2,0.42,0.4242,0.94,0.2537,8,192,200,192
17043,12/17/2012,4,1,12,21,0,1,1,2,0.42,0.4242,0.94,0.1343,6,114,120,114
17044,12/17/2012,4,1,12,22,0,1,1,2,0.42,0.4242,0.94,0.1343,5,49,54,49
17045,12/17/2012,4,1,12,23,0,1,1,3,0.42,0.4242,0.94,0.2239,6,41,47,41
17046,12/18/2012,4,1,12,0,0,2,1,2,0.44,0.4394,0.94,0.1343,0,18,18,18
17047,12/18/2012,4,1,12,1,0,2,1,2,0.44,0.4394,0.94,0.1343,0,15,15,15
17048,12/18/2012,4,1,12,2,0,2,1,2,0.44,0.4394,0.88,0.2239,2,5,7,5
17049,12/18/2012,4,1,12,3,0,2,1,1,0.42,0.4242,0.88,0.194,0,5,5,5
17050,12/18/2012,4,1,12,4,0,2,1,1,0.42,0.4242,0.82,0.1642,3,5,8,5
17051,12/18/2012,4,1,12,5,0,2,1,1,0.38,0.3939,0.87,0.0896,0,36,36,36
17052,12/18/2012,4,1,12,6,0,2,1,1,0.36,0.3485,0.93,0.1642,1,117,118,117
17053,12/18/2012,4,1,12,7,0,2,1,1,0.36,0.3485,0.93,0.1343,4,351,355,351
17054,12/18/2012,4,1,12,8,0,2,1,1,0.38,0.3939,0.94,0,10,652,662,652
17055,12/18/2012,4,1,12,9,0,2,1,1,0.4,0.4091,0.87,0.0896,19,307,326,307
17056,12/18/2012,4,1,12,10,0,2,1,1,0.44,0.4394,0.77,0.0896,22,162,184,162
17057,12/18/2012,4,1,12,11,0,2,1,1,0.48,0.4697,0.63,0.2239,58,211,269,211
17058,12/18/2012,4,1,12,12,0,2,1,3,0.48,0.4697,0.48,0.2537,49,264,313,264
17059,12/18/2012,4,1,12,13,0,2,1,1,0.5,0.4848,0.42,0.2836,51,235,286,235
17060,12/18/2012,4,1,12,14,0,2,1,1,0.46,0.4545,0.47,0.4478,56,191,247,191
17061,12/18/2012,4,1,12,15,0,2,1,1,0.46,0.4545,0.44,0.4925,28,218,246,218
17062,12/18/2012,4,1,12,16,0,2,1,1,0.44,0.4394,0.41,0.4627,40,323,363,323
17063,12/18/2012,4,1,12,17,0,2,1,1,0.4,0.4091,0.47,0.4478,39,533,572,533
17064,12/18/2012,4,1,12,18,0,2,1,1,0.38,0.3939,0.46,0.3284,13,512,525,512
17065,12/18/2012,4,1,12,19,0,2,1,1,0.38,0.3939,0.46,0.3881,19,334,353,334
17066,12/18/2012,4,1,12,20,0,2,1,1,0.36,0.3333,0.5,0.2537,4,264,268,264
17067,12/18/2012,4,1,12,21,0,2,1,1,0.36,0.3485,0.5,0.2239,9,159,168,159
17068,12/18/2012,4,1,12,22,0,2,1,1,0.34,0.3333,0.49,0,5,127,132,127
17069,12/18/2012,4,1,12,23,0,2,1,1,0.34,0.3485,0.49,0.0896,1,80,81,80
17070,12/19/2012,4,1,12,0,0,3,1,1,0.3,0.3182,0.61,0,6,35,41,35
17071,12/19/2012,4,1,12,1,0,3,1,1,0.3,0.3182,0.65,0.0896,1,14,15,14
17072,12/19/2012,4,1,12,2,0,3,1,1,0.28,0.303,0.65,0.0896,1,2,3,2
17073,12/19/2012,4,1,12,3,0,3,1,1,0.26,0.2727,0.75,0.1343,0,5,5,5
17074,12/19/2012,4,1,12,4,0,3,1,1,0.24,0.2424,0.75,0.1343,1,6,7,6
17075,12/19/2012,4,1,12,5,0,3,1,1,0.26,0.2879,0.75,0.0896,2,29,31,29
17076,12/19/2012,4,1,12,6,0,3,1,1,0.24,0.2576,0.75,0.0896,3,109,112,109
17077,12/19/2012,4,1,12,7,0,3,1,1,0.26,0.2727,0.75,0.1343,3,360,363,360
17078,12/19/2012,4,1,12,8,0,3,1,1,0.24,0.2576,0.87,0.1045,13,665,678,665
17079,12/19/2012,4,1,12,9,0,3,1,1,0.28,0.2879,0.75,0.1045,8,309,317,309
17080,12/19/2012,4,1,12,10,0,3,1,1,0.32,0.3333,0.7,0.1045,17,147,164,147
17081,12/19/2012,4,1,12,11,0,3,1,1,0.4,0.4091,0.54,0.2239,31,169,200,169
17082,12/19/2012,4,1,12,12,0,3,1,1,0.4,0.4091,0.54,0.2836,33,203,236,203
17083,12/19/2012,4,1,12,13,0,3,1,1,0.42,0.4242,0.5,0.194,30,183,213,183
17084,12/19/2012,4,1,12,14,0,3,1,1,0.42,0.4242,0.5,0.194,33,185,218,185
17085,12/19/2012,4,1,12,15,0,3,1,1,0.42,0.4242,0.5,0.2836,28,209,237,209
17086,12/19/2012,4,1,12,16,0,3,1,1,0.42,0.4242,0.5,0.3582,37,297,334,297
17087,12/19/2012,4,1,12,17,0,3,1,1,0.4,0.4091,0.5,0.3881,26,536,562,536
17088,12/19/2012,4,1,12,18,0,3,1,1,0.38,0.3939,0.5,0.3582,23,546,569,546
17089,12/19/2012,4,1,12,19,0,3,1,1,0.38,0.3939,0.5,0.3881,7,329,336,329
17090,12/19/2012,4,1,12,20,0,3,1,1,0.36,0.3485,0.57,0.2239,10,231,241,231
17091,12/19/2012,4,1,12,21,0,3,1,1,0.34,0.3182,0.61,0.2239,4,164,168,164
17092,12/19/2012,4,1,12,22,0,3,1,1,0.34,0.3485,0.61,0.0896,12,117,129,117
17093,12/19/2012,4,1,12,23,0,3,1,1,0.32,0.3333,0.66,0.1343,4,84,88,84
17094,12/20/2012,4,1,12,0,0,4,1,1,0.32,0.3333,0.61,0.1343,2,40,42,40
17095,12/20/2012,4,1,12,1,0,4,1,1,0.32,0.3485,0.66,0,1,19,20,19
17096,12/20/2012,4,1,12,2,0,4,1,1,0.32,0.3485,0.66,0,2,6,8,6
17097,12/20/2012,4,1,12,3,0,4,1,2,0.3,0.3182,0.7,0.0896,1,3,4,3
17098,12/20/2012,4,1,12,4,0,4,1,2,0.3,0.3182,0.7,0.0896,0,6,6,6
17099,12/20/2012,4,1,12,5,0,4,1,2,0.3,0.3182,0.7,0.1045,0,35,35,35
17100,12/20/2012,4,1,12,6,0,4,1,2,0.3,0.3333,0.65,0,4,114,118,114
17101,12/20/2012,4,1,12,7,0,4,1,2,0.3,0.3333,0.7,0,4,346,350,346
17102,12/20/2012,4,1,12,8,0,4,1,2,0.3,0.3333,0.7,0,14,585,599,585
17103,12/20/2012,4,1,12,9,0,4,1,2,0.3,0.3333,0.7,0,14,303,317,303
17104,12/20/2012,4,1,12,10,0,4,1,2,0.32,0.3333,0.66,0,23,138,161,138
17105,12/20/2012,4,1,12,11,0,4,1,2,0.34,0.3182,0.57,0.2239,22,168,190,168
17106,12/20/2012,4,1,12,12,0,4,1,2,0.36,0.3485,0.53,0.1642,31,181,212,181
17107,12/20/2012,4,1,12,13,0,4,1,2,0.36,0.3485,0.57,0.194,46,171,217,171
17108,12/20/2012,4,1,12,14,0,4,1,2,0.36,0.3485,0.53,0.194,43,171,214,171
17109,12/20/2012,4,1,12,15,0,4,1,2,0.34,0.3333,0.57,0.194,33,216,249,216
17110,12/20/2012,4,1,12,16,0,4,1,2,0.34,0.303,0.53,0.3284,21,281,302,281
17111,12/20/2012,4,1,12,17,0,4,1,2,0.34,0.3333,0.66,0.194,25,450,475,450
17112,12/20/2012,4,1,12,18,0,4,1,2,0.34,0.3333,0.71,0.194,22,359,381,359
17113,12/20/2012,4,1,12,19,0,4,1,3,0.34,0.3182,0.71,0.2537,3,115,118,115
17114,12/20/2012,4,1,12,20,0,4,1,3,0.34,0.3333,0.76,0.1642,1,49,50,49
17115,12/20/2012,4,1,12,21,0,4,1,3,0.34,0.3333,0.76,0.1642,1,25,26,25
17116,12/20/2012,4,1,12,22,0,4,1,3,0.34,0.3333,0.87,0.194,1,20,21,20
17117,12/20/2012,4,1,12,23,0,4,1,3,0.4,0.4091,0.82,0.2985,0,13,13,13
17118,12/21/2012,1,1,12,0,0,5,1,3,0.42,0.4242,0.88,0.2985,0,17,17,17
17119,12/21/2012,1,1,12,1,0,5,1,3,0.44,0.4394,0.88,0.3881,2,7,9,7
17120,12/21/2012,1,1,12,2,0,5,1,3,0.46,0.4545,0.94,0.3881,0,3,3,3
17121,12/21/2012,1,1,12,3,0,5,1,3,0.46,0.4545,0.94,0.3881,0,3,3,3
17122,12/21/2012,1,1,12,4,0,5,1,2,0.36,0.3182,0.71,0.4925,1,5,6,5
17123,12/21/2012,1,1,12,5,0,5,1,2,0.34,0.303,0.76,0.4179,0,13,13,13
17124,12/21/2012,1,1,12,6,0,5,1,2,0.34,0.2879,0.57,0.5821,4,76,80,76
17125,12/21/2012,1,1,12,7,0,5,1,2,0.32,0.3182,0.57,0.194,3,205,208,205
17126,12/21/2012,1,1,12,8,0,5,1,2,0.32,0.303,0.57,0.2836,8,464,472,464
17127,12/21/2012,1,1,12,9,0,5,1,2,0.32,0.2727,0.45,0.5522,2,265,267,265
17128,12/21/2012,1,1,12,10,0,5,1,1,0.32,0.2879,0.42,0.4627,8,146,154,146
17129,12/21/2012,1,1,12,11,0,5,1,2,0.32,0.2879,0.42,0.4179,12,150,162,150
17130,12/21/2012,1,1,12,12,0,5,1,2,0.32,0.2879,0.39,0.3582,25,199,224,199
17131,12/21/2012,1,1,12,13,0,5,1,2,0.32,0.2879,0.39,0.4179,26,214,240,214
17132,12/21/2012,1,1,12,14,0,5,1,2,0.32,0.2879,0.39,0.4478,20,199,219,199
17133,12/21/2012,1,1,12,15,0,5,1,2,0.3,0.2727,0.42,0.3881,29,234,263,234
17134,12/21/2012,1,1,12,16,0,5,1,2,0.3,0.2727,0.39,0.3284,28,253,281,253
17135,12/21/2012,1,1,12,17,0,5,1,2,0.26,0.2273,0.56,0.3284,24,297,321,297
17136,12/21/2012,1,1,12,18,0,5,1,2,0.26,0.2273,0.56,0.2985,7,236,243,236
17137,12/21/2012,1,1,12,19,0,5,1,1,0.28,0.2576,0.45,0.2985,5,148,153,148
17138,12/21/2012,1,1,12,20,0,5,1,1,0.28,0.2727,0.41,0.2537,8,104,112,104
17139,12/21/2012,1,1,12,21,0,5,1,1,0.26,0.2273,0.41,0.4179,2,68,70,68
17140,12/21/2012,1,1,12,22,0,5,1,1,0.26,0.2273,0.44,0.2985,6,57,63,57
17141,12/21/2012,1,1,12,23,0,5,1,1,0.26,0.2424,0.44,0.2836,1,39,40,39
17142,12/22/2012,1,1,12,0,0,6,0,1,0.26,0.2121,0.44,0.5821,1,30,31,30
17143,12/22/2012,1,1,12,1,0,6,0,1,0.26,0.2121,0.44,0.4478,1,34,35,34
17144,12/22/2012,1,1,12,2,0,6,0,1,0.26,0.2121,0.44,0.5224,0,23,23,23
17145,12/22/2012,1,1,12,3,0,6,0,1,0.26,0.2121,0.48,0.4478,0,7,7,7
17146,12/22/2012,1,1,12,4,0,6,0,1,0.26,0.2576,0.48,0.194,3,2,5,2
17147,12/22/2012,1,1,12,5,0,6,0,1,0.26,0.2273,0.48,0.4179,0,5,5,5
17148,12/22/2012,1,1,12,6,0,6,0,1,0.26,0.2273,0.44,0.4179,0,13,13,13
17149,12/22/2012,1,1,12,7,0,6,0,1,0.26,0.2273,0.44,0.4179,2,18,20,18
17150,12/22/2012,1,1,12,8,0,6,0,1,0.26,0.2121,0.44,0.6119,0,29,29,29
17151,12/22/2012,1,1,12,9,0,6,0,1,0.26,0.2273,0.48,0.3881,13,77,90,77
17152,12/22/2012,1,1,12,10,0,6,0,1,0.26,0.2273,0.48,0.3284,13,105,118,105
17153,12/22/2012,1,1,12,11,0,6,0,1,0.28,0.2576,0.41,0.3582,29,130,159,130
17154,12/22/2012,1,1,12,12,0,6,0,1,0.3,0.2576,0.36,0.6567,18,128,146,128
17155,12/22/2012,1,1,12,13,0,6,0,1,0.32,0.2879,0.36,0.4478,23,135,158,135
17156,12/22/2012,1,1,12,14,0,6,0,1,0.32,0.2879,0.36,0.4627,20,141,161,141
17157,12/22/2012,1,1,12,15,0,6,0,1,0.32,0.2727,0.33,0.5821,14,139,153,139
17158,12/22/2012,1,1,12,16,0,6,0,1,0.3,0.2727,0.39,0.4478,23,124,147,124
17159,12/22/2012,1,1,12,17,0,6,0,1,0.28,0.2576,0.41,0.2985,15,99,114,99
17160,12/22/2012,1,1,12,18,0,6,0,1,0.26,0.2121,0.44,0.4627,7,75,82,75
17161,12/22/2012,1,1,12,19,0,6,0,1,0.24,0.2121,0.48,0.3582,9,51,60,51
17162,12/22/2012,1,1,12,20,0,6,0,1,0.24,0.2424,0.48,0.1642,6,55,61,55
17163,12/22/2012,1,1,12,21,0,6,0,1,0.22,0.2121,0.51,0.2836,4,49,53,49
17164,12/22/2012,1,1,12,22,0,6,0,1,0.22,0.2121,0.51,0.2836,1,38,39,38
17165,12/22/2012,1,1,12,23,0,6,0,1,0.22,0.2273,0.51,0.194,3,37,40,37
17166,12/23/2012,1,1,12,0,0,0,0,1,0.22,0.2121,0.47,0.2836,3,24,27,24
17167,12/23/2012,1,1,12,1,0,0,0,1,0.22,0.2273,0.47,0.194,1,19,20,19
17168,12/23/2012,1,1,12,2,0,0,0,1,0.2,0.2121,0.51,0.1642,1,17,18,17
17169,12/23/2012,1,1,12,3,0,0,0,1,0.2,0.2121,0.51,0.1343,0,9,9,9
17170,12/23/2012,1,1,12,4,0,0,0,1,0.2,0.2121,0.47,0.1343,1,3,4,3
17171,12/23/2012,1,1,12,5,0,0,0,1,0.2,0.2576,0.51,0,0,6,6,6
17172,12/23/2012,1,1,12,6,0,0,0,1,0.16,0.197,0.64,0.0896,4,5,9,5
17173,12/23/2012,1,1,12,7,0,0,0,1,0.16,0.197,0.64,0.0896,3,16,19,16
17174,12/23/2012,1,1,12,8,0,0,0,1,0.14,0.1667,0.69,0.1045,5,43,48,43
17175,12/23/2012,1,1,12,9,0,0,0,1,0.2,0.2273,0.59,0.1045,7,49,56,49
17176,12/23/2012,1,1,12,10,0,0,0,1,0.22,0.2273,0.64,0.194,26,67,93,67
17177,12/23/2012,1,1,12,11,0,0,0,1,0.24,0.2273,0.52,0.194,48,104,152,104
17178,12/23/2012,1,1,12,12,0,0,0,1,0.3,0.2879,0.42,0.194,52,144,196,144
17179,12/23/2012,1,1,12,13,0,0,0,1,0.32,0.303,0.39,0.2239,63,123,186,123
17180,12/23/2012,1,1,12,14,0,0,0,1,0.34,0.303,0.31,0.2985,57,118,175,118
17181,12/23/2012,1,1,12,15,0,0,0,1,0.34,0.3333,0.34,0.1343,39,98,137,98
17182,12/23/2012,1,1,12,16,0,0,0,1,0.34,0.3333,0.34,0.194,53,137,190,137
17183,12/23/2012,1,1,12,17,0,0,0,1,0.32,0.3182,0.49,0.194,21,93,114,93
17184,12/23/2012,1,1,12,18,0,0,0,1,0.3,0.303,0.45,0.1642,8,85,93,85
17185,12/23/2012,1,1,12,19,0,0,0,1,0.3,0.3333,0.42,0,4,54,58,54
17186,12/23/2012,1,1,12,20,0,0,0,1,0.26,0.303,0.65,0,0,52,52,52
17187,12/23/2012,1,1,12,21,0,0,0,1,0.24,0.2879,0.7,0,4,38,42,38
17188,12/23/2012,1,1,12,22,0,0,0,1,0.24,0.2576,0.6,0.1045,5,53,58,53
17189,12/23/2012,1,1,12,23,0,0,0,1,0.24,0.2879,0.6,0,3,22,25,22
17190,12/24/2012,1,1,12,0,0,1,1,1,0.22,0.2727,0.69,0,0,12,12,12
17191,12/24/2012,1,1,12,1,0,1,1,1,0.22,0.2727,0.69,0,0,11,11,11
17192,12/24/2012,1,1,12,2,0,1,1,1,0.2,0.2576,0.75,0,0,5,5,5
17193,12/24/2012,1,1,12,3,0,1,1,1,0.2,0.2576,0.75,0,1,2,3,2
17194,12/24/2012,1,1,12,5,0,1,1,1,0.18,0.197,0.8,0.1343,0,9,9,9
17195,12/24/2012,1,1,12,6,0,1,1,1,0.2,0.2576,0.75,0,1,16,17,16
17196,12/24/2012,1,1,12,7,0,1,1,1,0.2,0.2576,0.69,0,3,27,30,27
17197,12/24/2012,1,1,12,8,0,1,1,1,0.22,0.2727,0.69,0,4,62,66,62
17198,12/24/2012,1,1,12,9,0,1,1,2,0.24,0.2576,0.65,0.1045,17,68,85,68
17199,12/24/2012,1,1,12,10,0,1,1,2,0.26,0.303,0.65,0,21,82,103,82
17200,12/24/2012,1,1,12,11,0,1,1,2,0.26,0.2576,0.6,0.1642,20,104,124,104
17201,12/24/2012,1,1,12,12,0,1,1,2,0.28,0.303,0.56,0.0896,22,113,135,113
17202,12/24/2012,1,1,12,13,0,1,1,3,0.24,0.2576,0.81,0.1045,16,54,70,54
17203,12/24/2012,1,1,12,14,0,1,1,3,0.24,0.2576,0.87,0.1045,13,33,46,33
17204,12/24/2012,1,1,12,15,0,1,1,3,0.24,0.2273,0.87,0.2239,6,27,33,27
17205,12/24/2012,1,1,12,16,0,1,1,3,0.24,0.2273,0.87,0.2239,6,27,33,27
17206,12/24/2012,1,1,12,17,0,1,1,3,0.24,0.2424,0.93,0.1642,7,19,26,19
17207,12/24/2012,1,1,12,18,0,1,1,3,0.24,0.2576,0.93,0.1045,6,20,26,20
17208,12/24/2012,1,1,12,19,0,1,1,2,0.24,0.2424,0.93,0.1343,4,14,18,14
17209,12/24/2012,1,1,12,20,0,1,1,3,0.24,0.2424,0.93,0.1343,6,17,23,17
17210,12/24/2012,1,1,12,21,0,1,1,3,0.24,0.2576,0.93,0.0896,13,9,22,9
17211,12/24/2012,1,1,12,22,0,1,1,2,0.24,0.2879,0.93,0,7,5,12,5
17212,12/24/2012,1,1,12,23,0,1,1,3,0.24,0.2879,0.93,0,1,10,11,10
17213,12/25/2012,1,1,12,0,1,2,0,3,0.24,0.2576,0.93,0.0896,3,10,13,10
17214,12/25/2012,1,1,12,1,1,2,0,2,0.26,0.2576,0.87,0.1642,0,13,13,13
17215,12/25/2012,1,1,12,2,1,2,0,2,0.26,0.2576,0.87,0.1642,0,7,7,7
17216,12/25/2012,1,1,12,4,1,2,0,2,0.24,0.2576,0.87,0.0896,0,1,1,1
17217,12/25/2012,1,1,12,5,1,2,0,2,0.22,0.2273,0.93,0.1343,2,1,3,1
17218,12/25/2012,1,1,12,6,1,2,0,2,0.22,0.2273,0.93,0.1343,1,6,7,6
17219,12/25/2012,1,1,12,7,1,2,0,2,0.22,0.2273,0.93,0.1642,0,6,6,6
17220,12/25/2012,1,1,12,8,1,2,0,2,0.24,0.2879,0.87,0,1,10,11,10
17221,12/25/2012,1,1,12,9,1,2,0,2,0.24,0.2576,0.87,0,7,21,28,21
17222,12/25/2012,1,1,12,10,1,2,0,1,0.28,0.3182,0.81,0,11,21,32,21
17223,12/25/2012,1,1,12,11,1,2,0,1,0.3,0.3182,0.75,0.0896,43,43,86,43
17224,12/25/2012,1,1,12,12,1,2,0,1,0.32,0.3333,0.76,0.0896,62,52,114,52
17225,12/25/2012,1,1,12,13,1,2,0,1,0.4,0.4091,0.5,0.3284,75,46,121,46
17226,12/25/2012,1,1,12,14,1,2,0,1,0.38,0.3939,0.46,0.2985,58,68,126,68
17227,12/25/2012,1,1,12,15,1,2,0,1,0.36,0.3333,0.5,0.2537,51,56,107,56
17228,12/25/2012,1,1,12,16,1,2,0,2,0.36,0.3333,0.5,0.2537,48,38,86,38
17229,12/25/2012,1,1,12,17,1,2,0,2,0.32,0.303,0.57,0.2537,16,34,50,34
17230,12/25/2012,1,1,12,18,1,2,0,2,0.32,0.303,0.66,0.2537,20,23,43,23
17231,12/25/2012,1,1,12,19,1,2,0,2,0.32,0.303,0.66,0.2239,16,20,36,20
17232,12/25/2012,1,1,12,20,1,2,0,2,0.32,0.303,0.66,0.2836,11,29,40,29
17233,12/25/2012,1,1,12,21,1,2,0,2,0.3,0.2879,0.65,0.194,8,26,34,26
17234,12/25/2012,1,1,12,22,1,2,0,2,0.3,0.303,0.7,0.1642,3,16,19,16
17235,12/25/2012,1,1,12,23,1,2,0,2,0.28,0.2727,0.65,0.2537,4,26,30,26
17236,12/26/2012,1,1,12,0,0,3,1,2,0.28,0.2727,0.65,0.2537,1,8,9,8
17237,12/26/2012,1,1,12,1,0,3,1,2,0.26,0.2273,0.65,0.2985,0,7,7,7
17238,12/26/2012,1,1,12,2,0,3,1,2,0.26,0.2273,0.65,0.2985,0,1,1,1
17239,12/26/2012,1,1,12,3,0,3,1,2,0.24,0.2121,0.7,0.3582,0,2,2,2
17240,12/26/2012,1,1,12,4,0,3,1,1,0.22,0.197,0.69,0.3582,0,2,2,2
17241,12/26/2012,1,1,12,5,0,3,1,2,0.22,0.2121,0.69,0.2836,0,11,11,11
17242,12/26/2012,1,1,12,6,0,3,1,2,0.22,0.2121,0.69,0.2239,0,36,36,36
17243,12/26/2012,1,1,12,7,0,3,1,3,0.2,0.1818,0.86,0.3284,0,26,26,26
17244,12/26/2012,1,1,12,8,0,3,1,3,0.2,0.1818,0.86,0.3284,0,31,31,31
17245,12/26/2012,1,1,12,9,0,3,1,3,0.2,0.1818,0.86,0.3284,1,22,23,22
17246,12/26/2012,1,1,12,10,0,3,1,3,0.2,0.1818,0.86,0.2985,0,8,8,8
17247,12/26/2012,1,1,12,11,0,3,1,3,0.2,0.1667,0.86,0.4627,0,10,10,10
17248,12/26/2012,1,1,12,12,0,3,1,3,0.22,0.197,0.87,0.3284,0,10,10,10
17249,12/26/2012,1,1,12,13,0,3,1,3,0.22,0.197,0.87,0.3284,0,15,15,15
17250,12/26/2012,1,1,12,14,0,3,1,3,0.22,0.2121,0.93,0.2537,0,20,20,20
17251,12/26/2012,1,1,12,15,0,3,1,3,0.26,0.2273,0.87,0.3582,0,13,13,13
17252,12/26/2012,1,1,12,16,0,3,1,3,0.26,0.2273,0.87,0.3582,0,13,13,13
17253,12/26/2012,1,1,12,17,0,3,1,3,0.26,0.2273,0.93,0.3582,2,51,53,51
17254,12/26/2012,1,1,12,18,0,3,1,3,0.28,0.2576,0.93,0.2985,1,42,43,42
17255,12/26/2012,1,1,12,19,0,3,1,3,0.3,0.2879,0.87,0.194,2,33,35,33
17256,12/26/2012,1,1,12,20,0,3,1,3,0.32,0.303,0.93,0.2537,0,32,32,32
17257,12/26/2012,1,1,12,21,0,3,1,2,0.3,0.2727,0.87,0.2985,0,20,20,20
17258,12/26/2012,1,1,12,22,0,3,1,3,0.24,0.197,0.93,0.4478,0,11,11,11
17259,12/26/2012,1,1,12,23,0,3,1,3,0.26,0.2273,0.87,0.2985,2,8,10,8
17260,12/27/2012,1,1,12,0,0,4,1,3,0.26,0.2273,0.87,0.2985,0,3,3,3
17261,12/27/2012,1,1,12,1,0,4,1,3,0.24,0.197,0.93,0.4478,0,5,5,5
17262,12/27/2012,1,1,12,2,0,4,1,2,0.24,0.197,0.87,0.4478,0,2,2,2
17263,12/27/2012,1,1,12,3,0,4,1,2,0.24,0.2273,0.87,0.2239,0,1,1,1
17264,12/27/2012,1,1,12,4,0,4,1,2,0.24,0.2121,0.87,0.3284,0,3,3,3
17265,12/27/2012,1,1,12,5,0,4,1,1,0.24,0.2424,0.75,0.1642,1,10,11,10
17266,12/27/2012,1,1,12,6,0,4,1,1,0.24,0.197,0.7,0.4925,0,45,45,45
17267,12/27/2012,1,1,12,7,0,4,1,1,0.24,0.2273,0.7,0.2239,0,90,90,90
17268,12/27/2012,1,1,12,8,0,4,1,1,0.26,0.2273,0.65,0.3582,2,206,208,206
17269,12/27/2012,1,1,12,9,0,4,1,1,0.26,0.2121,0.6,0.4925,6,127,133,127
17270,12/27/2012,1,1,12,10,0,4,1,1,0.28,0.2273,0.56,0.5224,8,67,75,67
17271,12/27/2012,1,1,12,11,0,4,1,2,0.28,0.2424,0.56,0.4478,23,80,103,80
17272,12/27/2012,1,1,12,12,0,4,1,1,0.3,0.2727,0.49,0.4627,22,87,109,87
17273,12/27/2012,1,1,12,13,0,4,1,1,0.3,0.2727,0.49,0.4627,19,99,118,99
17274,12/27/2012,1,1,12,14,0,4,1,2,0.26,0.2121,0.56,0.5224,25,94,119,94
17275,12/27/2012,1,1,12,15,0,4,1,2,0.26,0.2121,0.56,0.4478,31,89,120,89
17276,12/27/2012,1,1,12,16,0,4,1,2,0.26,0.2424,0.52,0.2836,23,151,174,151
17277,12/27/2012,1,1,12,17,0,4,1,2,0.26,0.2424,0.52,0.2836,30,227,257,227
17278,12/27/2012,1,1,12,18,0,4,1,2,0.24,0.2273,0.6,0.2537,9,188,197,188
17279,12/27/2012,1,1,12,19,0,4,1,1,0.24,0.2121,0.6,0.2836,11,106,117,106
17280,12/27/2012,1,1,12,20,0,4,1,1,0.24,0.2424,0.6,0.1642,12,79,91,79
17281,12/27/2012,1,1,12,21,0,4,1,2,0.24,0.2273,0.6,0.2537,12,51,63,51
17282,12/27/2012,1,1,12,22,0,4,1,2,0.24,0.2121,0.6,0.2836,11,33,44,33
17283,12/27/2012,1,1,12,23,0,4,1,2,0.24,0.2273,0.6,0.2537,2,24,26,24
17284,12/28/2012,1,1,12,0,0,5,1,2,0.24,0.2424,0.6,0.1642,3,22,25,22
17285,12/28/2012,1,1,12,1,0,5,1,1,0.24,0.2273,0.6,0.194,0,9,9,9
17286,12/28/2012,1,1,12,2,0,5,1,1,0.24,0.2273,0.6,0.2537,0,5,5,5
17287,12/28/2012,1,1,12,3,0,5,1,2,0.24,0.2424,0.6,0.1642,0,2,2,2
17288,12/28/2012,1,1,12,4,0,5,1,2,0.24,0.2576,0.6,0.1045,0,4,4,4
17289,12/28/2012,1,1,12,5,0,5,1,2,0.24,0.2576,0.6,0.0896,0,15,15,15
17290,12/28/2012,1,1,12,6,0,5,1,1,0.22,0.2121,0.64,0.2836,2,49,51,49
17291,12/28/2012,1,1,12,7,0,5,1,1,0.22,0.2273,0.64,0.1642,1,111,112,111
17292,12/28/2012,1,1,12,8,0,5,1,2,0.24,0.2424,0.6,0.1343,1,238,239,238
17293,12/28/2012,1,1,12,9,0,5,1,2,0.24,0.2121,0.6,0.2836,18,173,191,173
17294,12/28/2012,1,1,12,10,0,5,1,2,0.26,0.2424,0.56,0.2537,77,85,162,85
17295,12/28/2012,1,1,12,11,0,5,1,2,0.28,0.2727,0.52,0.2239,71,107,178,107
17296,12/28/2012,1,1,12,12,0,5,1,2,0.3,0.303,0.49,0.1343,72,150,222,150
17297,12/28/2012,1,1,12,13,0,5,1,2,0.3,0.303,0.49,0.1343,76,146,222,146
17298,12/28/2012,1,1,12,14,0,5,1,2,0.3,0.303,0.49,0.1343,84,177,261,177
17299,12/28/2012,1,1,12,15,0,5,1,2,0.3,0.3182,0.49,0,74,151,225,151
17300,12/28/2012,1,1,12,16,0,5,1,1,0.3,0.303,0.49,0.1343,42,208,250,208
17301,12/28/2012,1,1,12,17,0,5,1,1,0.24,0.2424,0.6,0.1343,43,228,271,228
17302,12/28/2012,1,1,12,18,0,5,1,1,0.24,0.2424,0.6,0.1343,16,197,213,197
17303,12/28/2012,1,1,12,19,0,5,1,2,0.24,0.2273,0.65,0.194,15,113,128,113
17304,12/28/2012,1,1,12,20,0,5,1,2,0.24,0.2576,0.65,0.1045,14,83,97,83
17305,12/28/2012,1,1,12,21,0,5,1,2,0.24,0.2424,0.7,0.1343,17,75,92,75
17306,12/28/2012,1,1,12,22,0,5,1,2,0.24,0.2576,0.7,0.0896,13,49,62,49
17307,12/28/2012,1,1,12,23,0,5,1,2,0.24,0.2576,0.65,0.0896,5,54,59,54
17308,12/29/2012,1,1,12,0,0,6,0,2,0.24,0.2424,0.7,0,1,25,26,25
17309,12/29/2012,1,1,12,1,0,6,0,2,0.24,0.2424,0.75,0.0896,6,31,37,31
17310,12/29/2012,1,1,12,2,0,6,0,2,0.24,0.2424,0.7,0,1,18,19,18
17311,12/29/2012,1,1,12,3,0,6,0,2,0.24,0.2424,0.75,0,1,5,6,5
17312,12/29/2012,1,1,12,4,0,6,0,2,0.24,0.2424,0.75,0.0896,0,3,3,3
17313,12/29/2012,1,1,12,5,0,6,0,2,0.24,0.2424,0.75,0.0896,0,3,3,3
17314,12/29/2012,1,1,12,6,0,6,0,2,0.26,0.2424,0.7,0.1045,0,7,7,7
17315,12/29/2012,1,1,12,7,0,6,0,2,0.26,0.2424,0.7,0.1343,1,17,18,17
17316,12/29/2012,1,1,12,8,0,6,0,2,0.26,0.2424,0.81,0,9,35,44,35
17317,12/29/2012,1,1,12,9,0,6,0,2,0.26,0.2424,0.81,0,16,33,49,33
17318,12/29/2012,1,1,12,10,0,6,0,3,0.26,0.2424,0.81,0.1343,6,35,41,35
17319,12/29/2012,1,1,12,11,0,6,0,3,0.2,0.2424,0.93,0.0896,7,38,45,38
17320,12/29/2012,1,1,12,12,0,6,0,3,0.2,0.2424,1,0,5,43,48,43
17321,12/29/2012,1,1,12,13,0,6,0,3,0.2,0.2424,1,0,13,71,84,71
17322,12/29/2012,1,1,12,14,0,6,0,2,0.24,0.2424,0.87,0.0896,10,88,98,88
17323,12/29/2012,1,1,12,15,0,6,0,2,0.24,0.2424,0.87,0,19,110,129,110
17324,12/29/2012,1,1,12,16,0,6,0,1,0.3,0.2424,0.75,0.1045,22,125,147,125
17325,12/29/2012,1,1,12,17,0,6,0,1,0.26,0.2424,0.79,0.1045,18,100,118,100
17326,12/29/2012,1,1,12,18,0,6,0,1,0.3,0.2424,0.7,0.194,8,102,110,102
17327,12/29/2012,1,1,12,19,0,6,0,2,0.3,0.2424,0.61,0.2537,7,90,97,90
17328,12/29/2012,1,1,12,20,0,6,0,2,0.3,0.2424,0.56,0.5522,2,64,66,64
17329,12/29/2012,1,1,12,21,0,6,0,2,0.28,0.2424,0.56,0.4925,4,56,60,56
17330,12/29/2012,1,1,12,22,0,6,0,2,0.26,0.2424,0.6,0.4627,3,51,54,51
17331,12/29/2012,1,1,12,23,0,6,0,2,0.26,0.2424,0.6,0,0,32,32,32
17332,12/30/2012,1,1,12,0,0,0,0,2,0.26,0.2576,0.6,0.1642,0,41,41,41
17333,12/30/2012,1,1,12,1,0,0,0,2,0.26,0.2273,0.56,0.4179,1,27,28,27
17334,12/30/2012,1,1,12,2,0,0,0,2,0.26,0.2424,0.56,0.2836,0,19,19,19
17335,12/30/2012,1,1,12,3,0,0,0,2,0.26,0.2273,0.56,0.4179,1,14,15,14
17336,12/30/2012,1,1,12,4,0,0,0,2,0.26,0.2576,0.56,0.2239,0,7,7,7
17337,12/30/2012,1,1,12,5,0,0,0,2,0.26,0.2273,0.48,0.2985,0,2,2,2
17338,12/30/2012,1,1,12,6,0,0,0,2,0.24,0.197,0.52,0.4179,1,7,8,7
17339,12/30/2012,1,1,12,7,0,0,0,1,0.24,0.2121,0.56,0.3582,0,13,13,13
17340,12/30/2012,1,1,12,8,0,0,0,1,0.24,0.197,0.52,0.4627,1,32,33,32
17341,12/30/2012,1,1,12,9,0,0,0,1,0.24,0.2121,0.52,0.3881,9,65,74,65
17342,12/30/2012,1,1,12,10,0,0,0,1,0.26,0.2121,0.41,0.5821,31,91,122,91
17343,12/30/2012,1,1,12,11,0,0,0,1,0.26,0.2273,0.41,0.4179,33,103,136,103
17344,12/30/2012,1,1,12,12,0,0,0,1,0.28,0.2273,0.36,0.5821,47,97,144,97
17345,12/30/2012,1,1,12,13,0,0,0,1,0.3,0.2576,0.36,0.6567,49,120,169,120
17346,12/30/2012,1,1,12,14,0,0,0,1,0.3,0.2727,0.36,0.4627,39,121,160,121
17347,12/30/2012,1,1,12,15,0,0,0,1,0.28,0.2576,0.38,0.3284,37,101,138,101
17348,12/30/2012,1,1,12,16,0,0,0,1,0.28,0.2424,0.38,0.4179,31,102,133,102
17349,12/30/2012,1,1,12,17,0,0,0,1,0.26,0.2273,0.41,0.3284,26,97,123,97
17350,12/30/2012,1,1,12,18,0,0,0,2,0.24,0.2121,0.44,0.2985,12,113,125,113
17351,12/30/2012,1,1,12,19,0,0,0,1,0.34,0.3636,0.61,0,16,86,102,86
17352,12/30/2012,1,1,12,20,0,0,0,1,0.22,0.197,0.47,0.3284,9,63,72,63
17353,12/30/2012,1,1,12,21,0,0,0,1,0.2,0.2121,0.51,0.1642,5,42,47,42
17354,12/30/2012,1,1,12,22,0,0,0,1,0.2,0.197,0.55,0.194,6,30,36,30
17355,12/30/2012,1,1,12,23,0,0,0,1,0.2,0.197,0.51,0.2239,10,39,49,39
17356,12/31/2012,1,1,12,0,0,1,1,1,0.18,0.1818,0.55,0.194,4,30,34,30
17357,12/31/2012,1,1,12,1,0,1,1,1,0.18,0.1818,0.55,0.194,6,13,19,13
17358,12/31/2012,1,1,12,2,0,1,1,1,0.16,0.1667,0.59,0.1642,3,8,11,8
17359,12/31/2012,1,1,12,3,0,1,1,1,0.16,0.1818,0.59,0.1045,0,1,1,1
17360,12/31/2012,1,1,12,4,0,1,1,1,0.14,0.1667,0.69,0.1045,0,3,3,3
17361,12/31/2012,1,1,12,5,0,1,1,1,0.16,0.1515,0.64,0.194,0,9,9,9
17362,12/31/2012,1,1,12,6,0,1,1,1,0.16,0.1667,0.64,0.1642,0,40,40,40
17363,12/31/2012,1,1,12,7,0,1,1,1,0.16,0.1818,0.64,0.1343,2,83,85,83
17364,12/31/2012,1,1,12,8,0,1,1,1,0.14,0.1515,0.69,0.1343,9,187,196,187
17365,12/31/2012,1,1,12,9,0,1,1,2,0.18,0.2121,0.64,0.1045,13,144,157,144
17366,12/31/2012,1,1,12,10,0,1,1,2,0.2,0.2121,0.69,0.1343,33,87,120,87
17367,12/31/2012,1,1,12,11,0,1,1,2,0.22,0.2273,0.6,0.194,43,114,157,114
17368,12/31/2012,1,1,12,12,0,1,1,2,0.24,0.2273,0.56,0.194,52,172,224,172
17369,12/31/2012,1,1,12,13,0,1,1,2,0.26,0.2576,0.44,0.1642,38,165,203,165
17370,12/31/2012,1,1,12,14,0,1,1,2,0.28,0.2727,0.45,0.2239,62,185,247,185
17371,12/31/2012,1,1,12,15,0,1,1,2,0.28,0.2879,0.45,0.1343,69,246,315,246
17372,12/31/2012,1,1,12,16,0,1,1,2,0.26,0.2576,0.48,0.194,30,184,214,184
17373,12/31/2012,1,1,12,17,0,1,1,2,0.26,0.2879,0.48,0.0896,14,150,164,150
17374,12/31/2012,1,1,12,18,0,1,1,2,0.26,0.2727,0.48,0.1343,10,112,122,112
17375,12/31/2012,1,1,12,19,0,1,1,2,0.26,0.2576,0.6,0.1642,11,108,119,108
17376,12/31/2012,1,1,12,20,0,1,1,2,0.26,0.2576,0.6,0.1642,8,81,89,81
17377,12/31/2012,1,1,12,21,0,1,1,1,0.26,0.2576,0.6,0.1642,7,83,90,83
17378,12/31/2012,1,1,12,22,0,1,1,1,0.26,0.2727,0.56,0.1343,13,48,61,48
17379,12/31/2012,1,1,12,23,0,1,1,1,0.26,0.2727,0.65,0.1343,12,37,49,37
